Analista_de_Pesquisa_de_Mercado	Analista de Pesquisa de Mercado
Analista_de_marketing	Analista de marketing
Apresentador_de_televisão	Apresentador de televisão
Artista_performático	Artista performático
Artista_visual	Artista visual
Assistente_de_Bordo	Assistente de Bordo
Assistente_de_Gerente_Geral	Assistente de Gerente Geral
Assistente_de_Logística	Assistente de Logística
Assistente_de_Projetos	Assistente de Projetos
Avaliador_imobiliário	Avaliador imobiliário
Cantor_de_ópera	Cantor de ópera
Chefe_de_Desenvolvimento_de_Negócios	Chefe de Desenvolvimento de Negócios
Cinematográfico	Cinematográfico
Conselho_corporativo	Conselho corporativo
Coordenador_de_RH	Coordenador de RH
Copiadora	Copiadora
Desenvolvedor_de_aplicativos	Desenvolvedor de aplicativos
Director_Geral	Director Geral
Diretor_de_Desenvolvimento_de_Negócios	Diretor de Desenvolvimento de Negócios
Diretor_de_elenco	Diretor de elenco
Dono_do_restaurante	Dono do restaurante
Engenharia_elétrica	Engenharia elétrica
Engenheiro_Químico	Engenheiro Químico
Engenheiro_agrônomo	Engenheiro agrônomo
Engenheiro_de_Manufatura	Engenheiro de Manufatura
Engenheiro_de_Obras	Engenheiro de Obras
Engenheiro_de_Processo	Engenheiro de Processo
Engenheiro_de_Suporte_Técnico	Engenheiro de Suporte Técnico
Engenheiro_de_design_mecanico	Engenheiro de design mecanico
Engenheiro_de_sistemas	Engenheiro de sistemas
Engenheiro_de_testes	Engenheiro de testes
Escritório_de_Desenvolvimento_de_Negócios	Escritório de Desenvolvimento de Negócios
Especialista_em_Aquisição_de_Talentos	Especialista em Aquisição de Talentos
Especialista_em_Recrutamento	Especialista em Recrutamento
Especialista_em_Relações_Públicas	Especialista em Relações Públicas
Especialista_em_TI	Especialista em TI
Fotografo_profissional	Fotografo profissional
Física_familiar	Física familiar
Gerente_de_Desenvolvimento_de_Negócios	Gerente de Desenvolvimento de Negócios
Gerente_de_Relações_Públicas	Gerente de Relações Públicas
Gerente_de_limpeza	Gerente de limpeza
Gerente_de_talentos	Gerente de talentos
Gerente_de_tráfego	Gerente de tráfego
Gerente_principal_do_escritório	Gerente principal do escritório
Gestor_de_RH	Gestor de RH
Governanta_executiva	Governanta executiva
Investigador_criminal	Investigador criminal
Licença_prática_de_enfermeira	Licença prática de enfermeira
Liderança_da_equipe	Liderança da equipe
Linha_de_Produção	Linha de Produção
Mixador_de_som	Mixador de som
Mordomo_chefe	Mordomo chefe
O_vice-ministro	O vice-ministro
Parceiro_de_capital	Parceiro de capital
Piloto_comercial	Piloto comercial
Professor_de_Inglês	Professor de Inglês
Professor_primário	Professor primário
Recrutamento_Executivo	Recrutamento Executivo
Repórter	Repórter
Salva-vidas	Salva-vidas
Secretário_de_correio	Secretário de correio
Soldado	Soldado
Superintendente_de_Construção	Superintendente de Construção
Supervisor_de_logística	Supervisor de logística
Trabalhador_de_serviço_de_comida	Trabalhador de serviço de comida
Treinador_de_tênis	Treinador de tênis
Vendedor_de_varejo	Vendedor de varejo
Visualizar	Visualizar
acionista	acionista
acionista_gerente	acionista gerente
acompanhante	acompanhante
acupunturista_licenciado	acupunturista licenciado
administrador_de_contas_a_pagar	administrador de contas a pagar
administrador_de_crédito	administrador de crédito
administrador_de_câmbio	administrador de câmbio
administrador_de_datacenter	administrador de datacenter
administrador_de_helpdesk	administrador de helpdesk
administrador_de_imóveis_residenciais	administrador de imóveis residenciais
administrador_de_internet	administrador de internet
administrador_de_logística	administrador de logística
administrador_de_pessoal	administrador de pessoal
administrador_de_rede	administrador de rede
administrador_de_rede_do_sistema	administrador de rede do sistema
administrador_de_rede_local	administrador de rede local
administrador_de_segurança	administrador de segurança
administrador_de_segurança_da_informação	administrador de segurança da informação
administrador_de_segurança_de_dados	administrador de segurança de dados
administrador_de_segurança_de_rede	administrador de segurança de rede
administrador_de_service_desk	administrador de service desk
administrador_de_sistema_microsoft	administrador de sistema microsoft
administrador_de_área_de_trabalho	administrador de área de trabalho
administrador_do_servidor	administrador do servidor
administrador_do_sistema	administrador do sistema
administrador_fiscal	administrador fiscal
advogada-chefe_adjunta	advogada-chefe adjunta
advogado	advogado
advogado_assistente	advogado assistente
advogado_assistente_da_corporação	advogado assistente da corporação
advogado_comercial	advogado comercial
advogado_contencioso	advogado contencioso
advogado_corporativo	advogado corporativo
advogado_criminalista	advogado criminalista
advogado_da_empresa	advogado da empresa
advogado_da_equipe	advogado da equipe
advogado_de_contrato	advogado de contrato
advogado_de_família	advogado de família
advogado_de_julgamento	advogado de julgamento
advogado_de_pesquisa	advogado de pesquisa
advogado_de_propriedade_intelectual	advogado de propriedade intelectual
advogado_de_sinistros	advogado de sinistros
advogado_do_cliente	advogado do cliente
advogado_do_grupo	advogado do grupo
advogado_do_tribunal	advogado do tribunal
advogado_especial	advogado especial
advogado_experimental	advogado experimental
advogado_externo	advogado externo
advogado_fiscal	advogado fiscal
advogado_gerente	advogado gerente
advogado_imobiliário	advogado imobiliário
advogado_internacional	advogado internacional
advogado_principal	advogado principal
advogado_trabalhista_e_trabalhista	advogado trabalhista e trabalhista
agente_comercial	agente comercial
agente_de_aluguel	agente de aluguel
agente_de_atendimento	agente de atendimento
agente_de_compradores	agente de compradores
agente_de_crédito_imobiliário	agente de crédito imobiliário
agente_de_crédito_residencial	agente de crédito residencial
agente_de_logística	agente de logística
agente_de_polícia	agente de polícia
agente_de_receita	agente de receita
agente_de_receita_interna	agente de receita interna
agente_de_referência	agente de referência
agente_de_reservas	agente de reservas
agente_de_seguros	agente de seguros
agente_de_seguros_comerciais	agente de seguros comerciais
agente_de_seguros_licenciado	agente de seguros licenciado
agente_de_título	agente de título
agente_de_vendas_licenciado	agente de vendas licenciado
agente_de_viagens_corporativas	agente de viagens corporativas
agente_especial	agente especial
agente_especial_de_supervisão	agente especial de supervisão
agente_exclusivo	agente exclusivo
agente_federal	agente federal
agente_hipotecário	agente hipotecário
ajudante_de_garçom	ajudante de garçom
ajustador_de_reivindicações_de_propriedade	ajustador de reivindicações de propriedade
ajustador_de_sinistros	ajustador de sinistros
alfabetizadora	alfabetizadora
analista_administrativo	analista administrativo
analista_comercial	analista comercial
analista_de_avaliação	analista de avaliação
analista_de_ações	analista de ações
analista_de_banco_corporativo	analista de banco corporativo
analista_de_banco_de_investimento	analista de banco de investimento
analista_de_banco_privado	analista de banco privado
analista_de_capital_de_risco	analista de capital de risco
analista_de_carteira	analista de carteira
analista_de_centro_de_atendimento	analista de centro de atendimento
analista_de_centro_de_operações_de_rede	analista de centro de operações de rede
analista_de_centro_de_suporte	analista de centro de suporte
analista_de_classificação	analista de classificação
analista_de_commodities	analista de commodities
analista_de_conteúdo	analista de conteúdo
analista_de_crédito	analista de crédito
analista_de_crédito_corporativo	analista de crédito corporativo
analista_de_dados_de_mercado	analista de dados de mercado
analista_de_datacenter	analista de datacenter
analista_de_desempenho_de_investimentos	analista de desempenho de investimentos
analista_de_desenvolvimento_corporativo	analista de desenvolvimento corporativo
analista_de_desenvolvimento_de_software	analista de desenvolvimento de software
analista_de_estresse	analista de estresse
analista_de_financiamento	analista de financiamento
analista_de_finanças_corporativas	analista de finanças corporativas
analista_de_finanças_estruturadas	analista de finanças estruturadas
analista_de_fundos	analista de fundos
analista_de_fundos_mútuos	analista de fundos mútuos
analista_de_helpdesk	analista de helpdesk
analista_de_importação	analista de importação
analista_de_importação_e_exportação	analista de importação e exportação
analista_de_inteligência_de_mercado	analista de inteligência de mercado
analista_de_investimentos	analista de investimentos
analista_de_logística	analista de logística
analista_de_marca	analista de marca
analista_de_marketing_de_produto	analista de marketing de produto
analista_de_mercado_de_capitais	analista de mercado de capitais
analista_de_mercado_financeiro	analista de mercado financeiro
analista_de_negócios	analista de negócios
analista_de_operações_de_rede	analista de operações de rede
analista_de_pesquisa_de_ações	analista de pesquisa de ações
analista_de_planejamento_estratégico	analista de planejamento estratégico
analista_de_política	analista de política
analista_de_private_equity	analista de private equity
analista_de_programação	analista de programação
analista_de_recrutamento	analista de recrutamento
analista_de_rede	analista de rede
analista_de_renda_fixa	analista de renda fixa
analista_de_rh	analista de rh
analista_de_segurança	analista de segurança
analista_de_segurança_da_informação	analista de segurança da informação
analista_de_segurança_de_rede	analista de segurança de rede
analista_de_sistema_assistente	analista de sistema assistente
analista_de_sistema_consultivo	analista de sistema consultivo
analista_de_sistema_de_informação	analista de sistema de informação
analista_de_sistema_de_informação_pessoal	analista de sistema de informação pessoal
analista_de_sistema_operacional	analista de sistema operacional
analista_de_sistemas	analista de sistemas
analista_de_sistemas_de_informação_de_rh	analista de sistemas de informação de rh
analista_de_software	analista de software
analista_de_suporte	analista de suporte
analista_de_suporte_ao_cliente	analista de suporte ao cliente
analista_de_suporte_contencioso	analista de suporte contencioso
analista_de_suporte_de_campo	analista de suporte de campo
analista_de_suporte_de_desktop	analista de suporte de desktop
analista_de_suporte_de_rede	analista de suporte de rede
analista_de_suporte_de_segunda_linha	analista de suporte de segunda linha
analista_de_suporte_de_software	analista de suporte de software
analista_de_suporte_de_tecnologia	analista de suporte de tecnologia
analista_de_suporte_informático	analista de suporte informático
analista_de_suporte_técnico	analista de suporte técnico
analista_de_tecnologia	analista de tecnologia
analista_de_testes_de_automação	analista de testes de automação
analista_de_transações	analista de transações
analista_de_verão_de_banco_de_investimento	analista de verão de banco de investimento
analista_financeiro	analista financeiro
analista_financeiro_alavancado	analista financeiro alavancado
analista_financeiro_credenciado	analista financeiro credenciado
analista_fiscal	analista fiscal
analista_imobiliário	analista imobiliário
anestesista_da_equipe	anestesista da equipe
animador	animador
animador_de_computador	animador de computador
animador_de_personagens	animador de personagens
animador_de_personagens_3d	animador de personagens 3d
animador_flash	animador flash
animador_técnico	animador técnico
apresentador	apresentador
apresentador_de_programa_matinal	apresentador de programa matinal
apresentador_de_rádio	apresentador de rádio
apresentador_de_talk_show	apresentador de talk show
aromatizador	aromatizador
arquiteto	arquiteto
arquiteto_assistente	arquiteto assistente
arquiteto_de_design	arquiteto de design
arquiteto_de_rede	arquiteto de rede
arquiteto_de_tecnologia	arquiteto de tecnologia
arquiteto_graduado	arquiteto graduado
arquiteto_intermediário	arquiteto intermediário
arquiteto_java	arquiteto java
arquiteto_paisagista	arquiteto paisagista
arquiteto_paisagista_principal	arquiteto paisagista principal
arquiteto_técnico	arquiteto técnico
arquivista_assistente	arquivista assistente
arquivista_de_projetos	arquivista de projetos
arteterapeuta	arteterapeuta
artista	artista
artista_3d	artista 3d
artista_conceitual	artista conceitual
artista_convidado	artista convidado
artista_criativo	artista criativo
artista_de_animação	artista de animação
artista_de_chamas	artista de chamas
artista_de_desenvolvimento_visual	artista de desenvolvimento visual
artista_de_design_gráfico	artista de design gráfico
artista_de_efeitos_visuais	artista de efeitos visuais
artista_de_estúdio	artista de estúdio
artista_de_gravação	artista de gravação
artista_de_jogos	artista de jogos
artista_de_layout	artista de layout
artista_de_personagem	artista de personagem
artista_de_produção	artista de produção
artista_de_produção_gráfica	artista de produção gráfica
artista_de_texturas	artista de texturas
artista_do_meio_ambiente_3d	artista do meio ambiente 3d
artista_em_residência	artista em residência
artista_gráfico	artista gráfico
artista_gráfico_de_computador	artista gráfico de computador
artista_plástico	artista plástico
artista_profissional	artista profissional
artista_residente	artista residente
artista_técnico	artista técnico
artífice	artífice
assessor_de_imprensa	assessor de imprensa
assistente_de_animação	assistente de animação
assistente_de_arquitetura	assistente de arquitetura
assistente_de_arquivos	assistente de arquivos
assistente_de_artigos	assistente de artigos
assistente_de_banco_privado	assistente de banco privado
assistente_de_banqueiro_privado	assistente de banqueiro privado
assistente_de_canil	assistente de canil
assistente_de_conferência	assistente de conferência
assistente_de_construção	assistente de construção
assistente_de_contabilidade	assistente de contabilidade
assistente_de_contencioso	assistente de contencioso
assistente_de_corretor	assistente de corretor
assistente_de_cozinha	assistente de cozinha
assistente_de_cozinheiro	assistente de cozinheiro
assistente_de_cuidados_com_animais	assistente de cuidados com animais
assistente_de_câmera	assistente de câmera
assistente_de_defensor_público	assistente de defensor público
assistente_de_depósito	assistente de depósito
assistente_de_desenho_técnico	assistente de desenho técnico
assistente_de_desenvolvimento_de_negócios_vp	assistente de desenvolvimento de negócios vp
assistente_de_desenvolvimento_de_produto	assistente de desenvolvimento de produto
assistente_de_design	assistente de design
assistente_de_design_gráfico	assistente de design gráfico
assistente_de_designer	assistente de designer
assistente_de_direção_de_alimentação	assistente de direção de alimentação
assistente_de_direção_de_enfermagem	assistente de direção de enfermagem
assistente_de_direção_de_farmácia	assistente de direção de farmácia
assistente_de_direção_de_limpeza	assistente de direção de limpeza
assistente_de_direção_de_segurança	assistente de direção de segurança
assistente_de_educação_especial	assistente de educação especial
assistente_de_elenco	assistente de elenco
assistente_de_empréstimo_comercial	assistente de empréstimo comercial
assistente_de_enfermagem	assistente de enfermagem
assistente_de_engenharia_municipal	assistente de engenharia municipal
assistente_de_fotógrafos	assistente de fotógrafos
assistente_de_front_office	assistente de front office
assistente_de_frontend_manager	assistente de frontend manager
assistente_de_galeria	assistente de galeria
assistente_de_gerente	assistente de gerente
assistente_de_gerente_de_alimentos_e_bebidas	assistente de gerente de alimentos e bebidas
assistente_de_gerente_de_banco	assistente de gerente de banco
assistente_de_gerente_de_bar	assistente de gerente de bar
assistente_de_gerente_de_carteira	assistente de gerente de carteira
assistente_de_gerente_de_conteúdo	assistente de gerente de conteúdo
assistente_de_gerente_de_fundos	assistente de gerente de fundos
assistente_de_gerente_de_investimentos	assistente de gerente de investimentos
assistente_de_gerente_de_localização	assistente de gerente de localização
assistente_de_gerente_de_marca	assistente de gerente de marca
assistente_de_gerente_de_mercado	assistente de gerente de mercado
assistente_de_gerente_de_outlet	assistente de gerente de outlet
assistente_de_gerente_de_receita	assistente de gerente de receita
assistente_de_gerente_de_recepção	assistente de gerente de recepção
assistente_de_gerente_de_reservas	assistente de gerente de reservas
assistente_de_gerente_jurídico	assistente de gerente jurídico
assistente_de_gerente_noturno	assistente de gerente noturno
assistente_de_importação	assistente de importação
assistente_de_instrução	assistente de instrução
assistente_de_marketing_comercial	assistente de marketing comercial
assistente_de_moda	assistente de moda
assistente_de_negociação	assistente de negociação
assistente_de_pesquisa	assistente de pesquisa
assistente_de_planejamento	assistente de planejamento
assistente_de_planejamento_de_eventos	assistente de planejamento de eventos
assistente_de_produção_de_set	assistente de produção de set
assistente_de_provador	assistente de provador
assistente_de_pré-escola	assistente de pré-escola
assistente_de_publicações	assistente de publicações
assistente_de_pós-produção	assistente de pós-produção
assistente_de_recrutamento	assistente de recrutamento
assistente_de_recrutamento_de_rh	assistente de recrutamento de rh
assistente_de_relacionamento	assistente de relacionamento
assistente_de_relacionamento_com_a_comunidade	assistente de relacionamento com a comunidade
assistente_de_relações_com_a_mídia	assistente de relações com a mídia
assistente_de_relações_públicas	assistente de relações públicas
assistente_de_sala_de_aula	assistente de sala de aula
assistente_de_saúde	assistente de saúde
assistente_de_serviços_financeiros	assistente de serviços financeiros
assistente_de_subscrição	assistente de subscrição
assistente_de_telecomunicações	assistente de telecomunicações
assistente_de_transmissão	assistente de transmissão
assistente_de_vendas_local	assistente de vendas local
assistente_de_vendas_varejo	assistente de vendas varejo
assistente_do_conselho_geral	assistente do conselho geral
assistente_do_diretor	assistente do diretor
assistente_editorial	assistente editorial
assistente_judicial	assistente judicial
assistente_jurídico_corporativo	assistente jurídico corporativo
assistente_pessoal_do_gerente_geral	assistente pessoal do gerente geral
assistente_pessoal_jurídico	assistente pessoal jurídico
assistente_psicológico	assistente psicológico
assistente_social	assistente social
assistente_social_clínica_licenciada	assistente social clínica licenciada
assistente_social_clínico	assistente social clínico
assistente_técnico	assistente técnico
assistente_técnico_de_futebol	assistente técnico de futebol
assistente_veterinário	assistente veterinário
assistente_vp	assistente vp
associado	associado
associado_comercial	associado comercial
associado_de_armazém	associado de armazém
associado_de_arquitetura	associado de arquitetura
associado_de_avaliação	associado de avaliação
associado_de_ações	associado de ações
associado_de_banco_de_investimento	associado de banco de investimento
associado_de_coleções	associado de coleções
associado_de_comunicação_corporativa	associado de comunicação corporativa
associado_de_contabilidade	associado de contabilidade
associado_de_desenvolvimento_corporativo	associado de desenvolvimento corporativo
associado_de_desenvolvimento_de_negócios	associado de desenvolvimento de negócios
associado_de_galeria	associado de galeria
associado_de_gerenciamento_de_risco	associado de gerenciamento de risco
associado_de_hipoteca	associado de hipoteca
associado_de_litígio	associado de litígio
associado_de_logística	associado de logística
associado_de_loja_de_presentes	associado de loja de presentes
associado_de_marketing_e_comunicação	associado de marketing e comunicação
associado_de_mídia	associado de mídia
associado_de_pesquisa_de_patrimônio	associado de pesquisa de patrimônio
associado_de_portfólio	associado de portfólio
associado_de_pós-graduação	associado de pós-graduação
associado_de_recrutamento	associado de recrutamento
associado_de_reivindicações	associado de reivindicações
associado_de_relacionamento_com_o_cliente	associado de relacionamento com o cliente
associado_de_relações_com_investidores	associado de relações com investidores
associado_de_rh	associado de rh
associado_de_serviços_ao_hóspede	associado de serviços ao hóspede
associado_de_serviços_para_membros	associado de serviços para membros
associado_de_tesouraria	associado de tesouraria
associado_de_transmissão	associado de transmissão
associado_de_transportadora_rural	associado de transportadora rural
associado_de_varejo	associado de varejo
associado_do_walmart	associado do walmart
associado_estrangeiro	associado estrangeiro
associado_fiscal	associado fiscal
associado_imobiliário	associado imobiliário
associado_legal	associado legal
associado_temporário	associado temporário
atacadista_interno	atacadista interno
atendente_de_atendimento	atendente de atendimento
atendente_de_balcão	atendente de balcão
atendente_de_bar	atendente de bar
atendente_de_expedição_e_recebimento	atendente de expedição e recebimento
atendimento_ao_cliente_caixa	atendimento ao cliente caixa
atleta_profissional	atleta profissional
ator_profissional	ator profissional
auditor	auditor
auditor_fiscal	auditor fiscal
auditor_noturno	auditor noturno
auxiliar_de_catering	auxiliar de catering
auxiliar_de_confeiteiro	auxiliar de confeiteiro
auxiliar_de_cozinha	auxiliar de cozinha
auxiliar_de_creche	auxiliar de creche
auxiliar_de_dentista_registrado	auxiliar de dentista registrado
auxiliar_de_enfermagem_certificado	auxiliar de enfermagem certificado
auxiliar_de_engenharia_mecânica	auxiliar de engenharia mecânica
auxiliar_de_ensino_especial	auxiliar de ensino especial
auxiliar_de_limpeza	auxiliar de limpeza
auxiliar_de_produção_de_escritório	auxiliar de produção de escritório
auxiliar_de_professores	auxiliar de professores
avaliador_imobiliário_certificado	avaliador imobiliário certificado
avaliador_residencial_certificado	avaliador residencial certificado
aviador	aviador
babá	babá
babá_de_animais	babá de animais
baixista	baixista
balconista	balconista
balconista_de_cobrança	balconista de cobrança
balconista_de_comida	balconista de comida
balconista_de_frutos_do_mar	balconista de frutos do mar
balconista_de_padaria	balconista de padaria
balconista_de_produção	balconista de produção
bancário	bancário
banqueiro_comercial	banqueiro comercial
banqueiro_de_relacionamento	banqueiro de relacionamento
banqueiro_hipotecário	banqueiro hipotecário
banqueiro_hipotecário_privado	banqueiro hipotecário privado
banqueiro_preferido	banqueiro preferido
banqueiro_universal	banqueiro universal
barbeiro	barbeiro
barman	barman
barman_chefe	barman chefe
batedor_de_localização	batedor de localização
baterista	baterista
bibliotecário	bibliotecário
bibliotecário_chefe	bibliotecário chefe
bibliotecário_corporativo	bibliotecário corporativo
bibliotecário_de_mídia	bibliotecário de mídia
bibliotecário_de_pesquisa	bibliotecário de pesquisa
bibliotecário_de_serviços_públicos	bibliotecário de serviços públicos
bibliotecário_universitário	bibliotecário universitário
bilheteiro	bilheteiro
blogueiro	blogueiro
bombeiro	bombeiro
cabeleireiro	cabeleireiro
cabeleireiro_e_maquiador	cabeleireiro e maquiador
caixa	caixa
caixa_de_banco	caixa de banco
campeão_de_produto	campeão de produto
candidato_a_mba	candidato a mba
cantor	cantor
cantor_profissional	cantor profissional
capataz	capataz
capataz_de_construção	capataz de construção
capataz_de_trabalho	capataz de trabalho
capataz_do_local	capataz do local
capataz_do_projeto	capataz do projeto
capitão	capitão
capitão_da_companhia_aérea	capitão da companhia aérea
capitão_da_polícia	capitão da polícia
capitão_de_treinamento	capitão de treinamento
capitão_do_banquete	capitão do banquete
capitão_dos_bombeiros	capitão dos bombeiros
cardiologista	cardiologista
carregador	carregador
carteiro_da_cidade	carteiro da cidade
catalogador	catalogador
chaveiro	chaveiro
chef_corporativo	chef corporativo
chef_de_banquete	chef de banquete
chef_de_catering	chef de catering
chef_de_festa	chef de festa
chef_de_linha	chef de linha
chef_de_restaurante	chef de restaurante
chef_executivo_corporativo	chef executivo corporativo
chef_particular	chef particular
chef_pessoal	chef pessoal
chefe	chefe
chefe_de_arrecadação	chefe de arrecadação
chefe_de_assuntos_jurídicos	chefe de assuntos jurídicos
chefe_de_banco_corporativo	chefe de banco corporativo
chefe_de_banco_privado	chefe de banco privado
chefe_de_batalhão	chefe de batalhão
chefe_de_bombeiros_assistente	chefe de bombeiros assistente
chefe_de_caixa	chefe de caixa
chefe_de_conteúdo	chefe de conteúdo
chefe_de_cozinha	chefe de cozinha
chefe_de_cópia	chefe de cópia
chefe_de_desenvolvimento_estratégico	chefe de desenvolvimento estratégico
chefe_de_desenvolvimento_web	chefe de desenvolvimento web
chefe_de_distribuição	chefe de distribuição
chefe_de_financiamento_de_projetos	chefe de financiamento de projetos
chefe_de_finanças_corporativas	chefe de finanças corporativas
chefe_de_finanças_estruturadas	chefe de finanças estruturadas
chefe_de_gestão_de_ativos	chefe de gestão de ativos
chefe_de_gestão_de_clientes	chefe de gestão de clientes
chefe_de_gestão_de_patrimônio	chefe de gestão de patrimônio
chefe_de_gestão_de_talentos	chefe de gestão de talentos
chefe_de_grupo_de_rh	chefe de grupo de rh
chefe_de_imoveis	chefe de imoveis
chefe_de_instituições_financeiras	chefe de instituições financeiras
chefe_de_investimento	chefe de investimento
chefe_de_logística	chefe de logística
chefe_de_middle_office	chefe de middle office
chefe_de_mídia_digital	chefe de mídia digital
chefe_de_negociação	chefe de negociação
chefe_de_odontologia	chefe de odontologia
chefe_de_operações_de_rede	chefe de operações de rede
chefe_de_pesquisa_de_patrimônio	chefe de pesquisa de patrimônio
chefe_de_politica	chefe de politica
chefe_de_polícia	chefe de polícia
chefe_de_publicação	chefe de publicação
chefe_de_publicidade	chefe de publicidade
chefe_de_pós-produção	chefe de pós-produção
chefe_de_recrutamento	chefe de recrutamento
chefe_de_recursos	chefe de recursos
chefe_de_relações_públicas	chefe de relações públicas
chefe_de_rh	chefe de rh
chefe_de_seguro	chefe de seguro
chefe_de_telecomunicações	chefe de telecomunicações
chefe_de_vendas_e_negociação	chefe de vendas e negociação
chefe_do_departamento_de_design	chefe do departamento de design
chefe_do_departamento_de_logística	chefe do departamento de logística
chefe_do_departamento_de_relações_públicas	chefe do departamento de relações públicas
chefe_do_departamento_jurídico	chefe do departamento jurídico
chefe_do_grupo_de_mídia	chefe do grupo de mídia
chefe_do_juridico	chefe do juridico
chefe_dos_bombeiros	chefe dos bombeiros
chefe_dos_correios	chefe dos correios
chefe_executivo	chefe executivo
chefe_jurídico_e_secretário_da_empresa	chefe jurídico e secretário da empresa
chefe_residente	chefe residente
chumbo_de_chão	chumbo de chão
chumbo_de_envio	chumbo de envio
cientista_ambiental	cientista ambiental
cientista_de_alimentos	cientista de alimentos
cientista_de_pesquisa_e_desenvolvimento	cientista de pesquisa e desenvolvimento
cineasta	cineasta
cinegrafista	cinegrafista
cirurgião	cirurgião
cirurgião_bucomaxilofacial	cirurgião bucomaxilofacial
cirurgião_veterinário	cirurgião veterinário
classificador	classificador
clínico_geral	clínico geral
co-apresentador_do_programa_matinal	co-apresentador do programa matinal
co-piloto	co-piloto
colaborador_de_desenvolvimento_de_produto	colaborador de desenvolvimento de produto
colega_de_cardiologia	colega de cardiologia
colunista	colunista
comerciante	comerciante
comerciante_de_capital_próprio	comerciante de capital próprio
comerciante_de_derivativos	comerciante de derivativos
comerciante_de_futuros	comerciante de futuros
comerciante_de_moeda	comerciante de moeda
comerciante_de_opções	comerciante de opções
comerciante_de_opções_de_ações	comerciante de opções de ações
comerciante_de_renda_fixa	comerciante de renda fixa
comerciante_de_varejo	comerciante de varejo
comerciante_de_vendas	comerciante de vendas
comerciante_de_vendas_de_ações	comerciante de vendas de ações
comerciante_online	comerciante online
comerciante_principal	comerciante principal
comerciante_proprietário	comerciante proprietário
comissária_de_bordo_corporativa	comissária de bordo corporativa
comissário_de_bordo	comissário de bordo
compositor	compositor
compositor_de_filmes	compositor de filmes
compositor_de_musica	compositor de musica
comprador_de_transmissão	comprador de transmissão
comunicação_estratégica	comunicação estratégica
condutor	condutor
confeiteiro	confeiteiro
confeiteiro_executivo	confeiteiro executivo
conferencista	conferencista
conselheiro	conselheiro
conselheiro_clínico	conselheiro clínico
conselheiro_de_acampamento	conselheiro de acampamento
conselheiro_de_acampamento_de_verão	conselheiro de acampamento de verão
conselheiro_de_divulgação	conselheiro de divulgação
conselheiro_de_saúde_mental	conselheiro de saúde mental
conselheiro_de_saúde_mental_licenciado	conselheiro de saúde mental licenciado
conselheiro_de_viagem	conselheiro de viagem
conselheiro_do_ensino_fundamental	conselheiro do ensino fundamental
conselheiro_educacional	conselheiro educacional
conselheiro_familiar	conselheiro familiar
conselheiro_fiscal_mestre	conselheiro fiscal mestre
conselheiro_profissional_clínico_licenciado	conselheiro profissional clínico licenciado
conselheiro_profissional_licenciado	conselheiro profissional licenciado
conselho	conselho
conselho_administrativo	conselho administrativo
conselho_da_equipe	conselho da equipe
conselho_regional	conselho regional
conselho_regulatório	conselho regulatório
construtor	construtor
consultor	consultor
consultor_bancário_pessoal	consultor bancário pessoal
consultor_contencioso	consultor contencioso
consultor_de_TI	consultor de TI
consultor_de_angariação_de_fundos	consultor de angariação de fundos
consultor_de_aquisição_de_talentos	consultor de aquisição de talentos
consultor_de_arte	consultor de arte
consultor_de_automação	consultor de automação
consultor_de_automação_de_testes	consultor de automação de testes
consultor_de_beleza	consultor de beleza
consultor_de_bronzeamento	consultor de bronzeamento
consultor_de_busca_de_executivos	consultor de busca de executivos
consultor_de_casa_nova	consultor de casa nova
consultor_de_casamento	consultor de casamento
consultor_de_colocação	consultor de colocação
consultor_de_comunicação	consultor de comunicação
consultor_de_crédito_habitação	consultor de crédito habitação
consultor_de_decoração	consultor de decoração
consultor_de_desenvolvimento_de_liderança	consultor de desenvolvimento de liderança
consultor_de_desenvolvimento_de_negócios	consultor de desenvolvimento de negócios
consultor_de_desenvolvimento_de_negócios_internacionais	consultor de desenvolvimento de negócios internacionais
consultor_de_desenvolvimento_organizacional	consultor de desenvolvimento organizacional
consultor_de_design_de_produto	consultor de design de produto
consultor_de_design_de_rede	consultor de design de rede
consultor_de_design_gráfico	consultor de design gráfico
consultor_de_engenharia_de_rede	consultor de engenharia de rede
consultor_de_engenharia_mecânica	consultor de engenharia mecânica
consultor_de_estilo	consultor de estilo
consultor_de_estratégia	consultor de estratégia
consultor_de_estudos_no_exterior	consultor de estudos no exterior
consultor_de_eventos	consultor de eventos
consultor_de_fitness	consultor de fitness
consultor_de_gerenciamento	consultor de gerenciamento
consultor_de_gestão_de_talentos	consultor de gestão de talentos
consultor_de_gestão_empresarial	consultor de gestão empresarial
consultor_de_hipoteca	consultor de hipoteca
consultor_de_idiomas	consultor de idiomas
consultor_de_logística	consultor de logística
consultor_de_marketing	consultor de marketing
consultor_de_marketing_de_mídia_social	consultor de marketing de mídia social
consultor_de_marketing_e_relações_públicas	consultor de marketing e relações públicas
consultor_de_moda	consultor de moda
consultor_de_música	consultor de música
consultor_de_negócios	consultor de negócios
consultor_de_negócios_estratégicos	consultor de negócios estratégicos
consultor_de_perfuração	consultor de perfuração
consultor_de_pesquisa	consultor de pesquisa
consultor_de_pessoal	consultor de pessoal
consultor_de_processos	consultor de processos
consultor_de_recrutamento	consultor de recrutamento
consultor_de_recrutamento_permanente	consultor de recrutamento permanente
consultor_de_rede	consultor de rede
consultor_de_rede_de_dados	consultor de rede de dados
consultor_de_relações_públicas	consultor de relações públicas
consultor_de_relações_públicas_e_comunicação	consultor de relações públicas e comunicação
consultor_de_rh	consultor de rh
consultor_de_saúde_mental	consultor de saúde mental
consultor_de_segurança_de_rede	consultor de segurança de rede
consultor_de_seguros	consultor de seguros
consultor_de_software	consultor de software
consultor_de_subscrição	consultor de subscrição
consultor_de_sócios	consultor de sócios
consultor_de_telecomunicações	consultor de telecomunicações
consultor_de_vendas_casa_nova	consultor de vendas casa nova
consultor_de_vendas_de_casa_nova	consultor de vendas de casa nova
consultor_de_viagens_internacionais	consultor de viagens internacionais
consultor_editorial	consultor editorial
consultor_fiscal	consultor fiscal
consultor_imobiliário	consultor imobiliário
consultor_imobiliário_comercial	consultor imobiliário comercial
consultor_java	consultor java
consultor_jurídico	consultor jurídico
consultor_jurídico_chefe	consultor jurídico chefe
consultor_jurídico_corporativo	consultor jurídico corporativo
consultor_jurídico_de_recrutamento	consultor jurídico de recrutamento
consultor_jurídico_estrangeiro	consultor jurídico estrangeiro
consultor_marinho	consultor marinho
consultor_sem_fio	consultor sem fio
consultor_tributário_corporativo	consultor tributário corporativo
consultório_particular	consultório particular
contabilista_de_folha_de_pagamento	contabilista de folha de pagamento
contador	contador
contador_de_clientes	contador de clientes
contador_de_folha_de_pagamento	contador de folha de pagamento
contador_de_funcionários	contador de funcionários
contador_imobiliário	contador imobiliário
contador_intermediário	contador intermediário
contador_principal	contador principal
contador_profissional	contador profissional
contador_público_Certificado	contador público Certificado
contador_temporário	contador temporário
contratante	contratante
contrato_desenvolvedor_java	contrato desenvolvedor java
contrato_desenvolvedor_web	contrato desenvolvedor web
contribuinte	contribuinte
controlador_de_logística	controlador de logística
controlador_de_produto	controlador de produto
controlador_de_risco	controlador de risco
controlador_de_transmissão	controlador de transmissão
coordenador_comercial	coordenador comercial
coordenador_da_convenção	coordenador da convenção
coordenador_da_galeria	coordenador da galeria
coordenador_de_Logistica	coordenador de Logistica
coordenador_de_arrecadação	coordenador de arrecadação
coordenador_de_atletismo	coordenador de atletismo
coordenador_de_automação	coordenador de automação
coordenador_de_banquetes	coordenador de banquetes
coordenador_de_casamento	coordenador de casamento
coordenador_de_catering	coordenador de catering
coordenador_de_comunicação	coordenador de comunicação
coordenador_de_comunicação_corporativa	coordenador de comunicação corporativa
coordenador_de_congressos_e_eventos	coordenador de congressos e eventos
coordenador_de_desenvolvimento_de_fundos	coordenador de desenvolvimento de fundos
coordenador_de_design_gráfico	coordenador de design gráfico
coordenador_de_emergência	coordenador de emergência
coordenador_de_empréstimo	coordenador de empréstimo
coordenador_de_envio_e_recebimento	coordenador de envio e recebimento
coordenador_de_estágio	coordenador de estágio
coordenador_de_fitness	coordenador de fitness
coordenador_de_folha_de_pagamento_e_benefícios	coordenador de folha de pagamento e benefícios
coordenador_de_helpdesk	coordenador de helpdesk
coordenador_de_hipoteca	coordenador de hipoteca
coordenador_de_hospitalidade	coordenador de hospitalidade
coordenador_de_importação	coordenador de importação
coordenador_de_importação_e_exportação	coordenador de importação e exportação
coordenador_de_logística_internacional	coordenador de logística internacional
coordenador_de_marketing_comercial	coordenador de marketing comercial
coordenador_de_marketing_na_internet	coordenador de marketing na internet
coordenador_de_melhoria_de_desempenho	coordenador de melhoria de desempenho
coordenador_de_parcerias	coordenador de parcerias
coordenador_de_pesquisa	coordenador de pesquisa
coordenador_de_pesquisa_clínica	coordenador de pesquisa clínica
coordenador_de_pesquisa_clínica_certificado	coordenador de pesquisa clínica certificado
coordenador_de_política	coordenador de política
coordenador_de_preços	coordenador de preços
coordenador_de_produção	coordenador de produção
coordenador_de_produção_de_impressão	coordenador de produção de impressão
coordenador_de_produção_publicitária	coordenador de produção publicitária
coordenador_de_projeto	coordenador de projeto
coordenador_de_pré-impressão	coordenador de pré-impressão
coordenador_de_publicação	coordenador de publicação
coordenador_de_publicidade	coordenador de publicidade
coordenador_de_pós-produção	coordenador de pós-produção
coordenador_de_recrutamento_de_rh	coordenador de recrutamento de rh
coordenador_de_relacionamento_com_doadores	coordenador de relacionamento com doadores
coordenador_de_relações_com_hóspedes	coordenador de relações com hóspedes
coordenador_de_relações_públicas	coordenador de relações públicas
coordenador_de_remuneração_e_benefícios	coordenador de remuneração e benefícios
coordenador_de_reservas	coordenador de reservas
coordenador_de_reservas_de_grupos	coordenador de reservas de grupos
coordenador_de_salão	coordenador de salão
coordenador_de_serviço_de_campo	coordenador de serviço de campo
coordenador_de_serviços_de_conferência	coordenador de serviços de conferência
coordenador_de_serviços_de_marketing	coordenador de serviços de marketing
coordenador_de_suporte_técnico	coordenador de suporte técnico
coordenador_de_telecomunicações	coordenador de telecomunicações
coordenador_de_tradução	coordenador de tradução
coordenador_de_transição	coordenador de transição
coordenador_de_transmissão	coordenador de transmissão
coordenador_de_turismo	coordenador de turismo
coordenador_do_departamento_de_arte	coordenador do departamento de arte
coordenador_do_evento	coordenador do evento
coordenador_do_programa_acadêmico	coordenador do programa acadêmico
coordenador_do_programa_de_pós-graduação	coordenador do programa de pós-graduação
coordenador_editorial	coordenador editorial
coordenador_esportivo	coordenador esportivo
coordenador_jurídico	coordenador jurídico
coordenadora_de_atendimento_ao_hóspede	coordenadora de atendimento ao hóspede
coordenadora_de_comunicação_interna	coordenadora de comunicação interna
coordenadora_de_marketing_e_comunicação	coordenadora de marketing e comunicação
coordenadora_de_moda	coordenadora de moda
coordenadora_de_relações_públicas_e_comunicação	coordenadora de relações públicas e comunicação
coreógrafo	coreógrafo
corpo_docente_em_tempo_integral	corpo docente em tempo integral
corporal	corporal
correspondente_nacional	correspondente nacional
correspondente_principal	correspondente principal
corretor	corretor
corretor_afiliado	corretor afiliado
corretor_de_derivativos	corretor de derivativos
corretor_de_derivativos_de_ações	corretor de derivativos de ações
corretor_de_frete	corretor de frete
corretor_de_futuros	corretor de futuros
corretor_de_hipoteca_licenciado	corretor de hipoteca licenciado
corretor_de_imóveis	corretor de imóveis
corretor_de_imóveis_associado	corretor de imóveis associado
corretor_de_imóveis_associado_licenciado	corretor de imóveis associado licenciado
corretor_de_imóveis_comercial	corretor de imóveis comercial
corretor_de_imóveis_licenciado	corretor de imóveis licenciado
corretor_de_imóveis_profissional	corretor de imóveis profissional
corretor_de_imóveis_residencial	corretor de imóveis residencial
corretor_de_imóveis_vendedor	corretor de imóveis vendedor
corretor_de_navios	corretor de navios
corretor_de_piso	corretor de piso
corretor_de_resseguros	corretor de resseguros
corretor_de_seguros_comercial	corretor de seguros comercial
corretor_de_vendas	corretor de vendas
corretor_designado	corretor designado
corretor_financeiro	corretor financeiro
corretor_gerente	corretor gerente
corretor_hipotecário	corretor hipotecário
cosmetologista	cosmetologista
cozinheiro	cozinheiro
cozinheiro_de_linha	cozinheiro de linha
creche	creche
credor_hipotecário	credor hipotecário
criador	criador
crítico_de_arte	crítico de arte
curador	curador
curador_de_exposições	curador de exposições
curador-chefe	curador-chefe
câmera_de_iluminação	câmera de iluminação
cômoda	cômoda
dançarino_principal	dançarino principal
dançarino_profissional	dançarino profissional
decorador_de_cenários	decorador de cenários
dentista_geral	dentista geral
departamento_de_importação	departamento de importação
desenhista	desenhista
desenhista_civil	desenhista civil
desenhista_de_encanamento	desenhista de encanamento
desenhista_mecânico	desenhista mecânico
desenhista_técnico	desenhista técnico
desenvolvedor	desenvolvedor
desenvolvedor_android	desenvolvedor android
desenvolvedor_criativo	desenvolvedor criativo
desenvolvedor_da_equipe	desenvolvedor da equipe
desenvolvedor_de_Java	desenvolvedor de Java
desenvolvedor_de_aplicativos_ios	desenvolvedor de aplicativos ios
desenvolvedor_de_aplicativos_java	desenvolvedor de aplicativos java
desenvolvedor_de_aplicativos_móveis	desenvolvedor de aplicativos móveis
desenvolvedor_de_aplicativos_web	desenvolvedor de aplicativos web
desenvolvedor_de_automação	desenvolvedor de automação
desenvolvedor_de_back-end	desenvolvedor de back-end
desenvolvedor_de_banco_de_dados	desenvolvedor de banco de dados
desenvolvedor_de_conceito	desenvolvedor de conceito
desenvolvedor_de_conteúdo	desenvolvedor de conteúdo
desenvolvedor_de_código_aberto	desenvolvedor de código aberto
desenvolvedor_de_ferramentas	desenvolvedor de ferramentas
desenvolvedor_de_hardware	desenvolvedor de hardware
desenvolvedor_de_interface_do_usuário_da_web	desenvolvedor de interface do usuário da web
desenvolvedor_de_negócios	desenvolvedor de negócios
desenvolvedor_de_produtos	desenvolvedor de produtos
desenvolvedor_de_software	desenvolvedor de software
desenvolvedor_de_soluções	desenvolvedor de soluções
desenvolvedor_do_lado_do_cliente	desenvolvedor do lado do cliente
desenvolvedor_html5	desenvolvedor html5
desenvolvedor_interativo	desenvolvedor interativo
desenvolvedor_j2ee	desenvolvedor j2ee
desenvolvedor_java/j2ee	desenvolvedor java/j2ee
desenvolvedor_web_java	desenvolvedor web java
desenvolvedor_web_php	desenvolvedor web php
designer_analógico	designer analógico
designer_chefe	designer chefe
designer_civil	designer civil
designer_de_acessórios	designer de acessórios
designer_de_arquitetura	designer de arquitetura
designer_de_calçados	designer de calçados
designer_de_comunicação	designer de comunicação
designer_de_conceito	designer de conceito
designer_de_eventos	designer de eventos
designer_de_hardware	designer de hardware
designer_de_impressão	designer de impressão
designer_de_interface_do_usuário	designer de interface do usuário
designer_de_interiores	designer de interiores
designer_de_jogos	designer de jogos
designer_de_layout	designer de layout
designer_de_malhas	designer de malhas
designer_de_marca	designer de marca
designer_de_moda	designer de moda
designer_de_moda_feminina	designer de moda feminina
designer_de_moda_masculina	designer de moda masculina
designer_de_mídia_digital	designer de mídia digital
designer_de_personagens	designer de personagens
designer_de_produto	designer de produto
designer_de_publicações	designer de publicações
designer_de_publicidade	designer de publicidade
designer_de_rede	designer de rede
designer_de_roupas	designer de roupas
designer_de_serviço	designer de serviço
designer_de_transmissão	designer de transmissão
designer_digital	designer digital
designer_eletrônico	designer eletrônico
designer_floral	designer floral
designer_físico	designer físico
designer_gráfico_ambiental	designer gráfico ambiental
designer_gráfico_criativo	designer gráfico criativo
designer_mecânico	designer mecânico
designer_multimídia	designer multimídia
designer_têxtil	designer têxtil
designer_visual	designer visual
despachante_de_emergência	despachante de emergência
detetive_policial	detetive policial
diagnosticador_educacional	diagnosticador educacional
diretor	diretor
diretor_adjunto_de_admissões_de_graduação	diretor adjunto de admissões de graduação
diretor_adjunto_de_comunicação	diretor adjunto de comunicação
diretor_adjunto_do_fundo_anual	diretor adjunto do fundo anual
diretor_artistico	diretor artistico
diretor_comercial	diretor comercial
diretor_criativo_principal	diretor criativo principal
diretor_da_agência	diretor da agência
diretor_da_banda	diretor da banda
diretor_da_pré-escola	diretor da pré-escola
diretor_de_Estudos	diretor de Estudos
diretor_de_admissões	diretor de admissões
diretor_de_adoração	diretor de adoração
diretor_de_alimentação	diretor de alimentação
diretor_de_alimentos_e_bebidas	diretor de alimentos e bebidas
diretor_de_andar	diretor de andar
diretor_de_animação	diretor de animação
diretor_de_aquisição_de_talentos	diretor de aquisição de talentos
diretor_de_arrecadação	diretor de arrecadação
diretor_de_arte	diretor de arte
diretor_de_arte_executivo	diretor de arte executivo
diretor_de_arte_interativo	diretor de arte interativo
diretor_de_arte_principal	diretor de arte principal
diretor_de_assuntos_jurídicos	diretor de assuntos jurídicos
diretor_de_atendimento_ao_cliente	diretor de atendimento ao cliente
diretor_de_banco_corporativo	diretor de banco corporativo
diretor_de_busca_de_executivos	diretor de busca de executivos
diretor_de_capital_humano	diretor de capital humano
diretor_de_coleções	diretor de coleções
diretor_de_contas	diretor de contas
diretor_de_contas_digitais	diretor de contas digitais
diretor_de_contencioso	diretor de contencioso
diretor_de_crédito	diretor de crédito
diretor_de_cópia	diretor de cópia
diretor_de_desenvolvimento_de_audiência	diretor de desenvolvimento de audiência
diretor_de_desenvolvimento_de_fundos	diretor de desenvolvimento de fundos
diretor_de_desenvolvimento_de_hardware	diretor de desenvolvimento de hardware
diretor_de_desenvolvimento_de_negócios	diretor de desenvolvimento de negócios
diretor_de_desenvolvimento_de_talentos	diretor de desenvolvimento de talentos
diretor_de_desenvolvimento_e_relações_públicas	diretor de desenvolvimento e relações públicas
diretor_de_desenvolvimento_estratégico	diretor de desenvolvimento estratégico
diretor_de_design_e_desenvolvimento	diretor de design e desenvolvimento
diretor_de_doações_planejadas	diretor de doações planejadas
diretor_de_educação	diretor de educação
diretor_de_educação_médica	diretor de educação médica
diretor_de_empréstimos	diretor de empréstimos
diretor_de_engenharia_elétrica	diretor de engenharia elétrica
diretor_de_esportes	diretor de esportes
diretor_de_estratégia_e_operações	diretor de estratégia e operações
diretor_de_eventos	diretor de eventos
diretor_de_eventos_especiais	diretor de eventos especiais
diretor_de_eventos_privados	diretor de eventos privados
diretor_de_filme	diretor de filme
diretor_de_finanças_estruturadas	diretor de finanças estruturadas
diretor_de_fisioterapia	diretor de fisioterapia
diretor_de_fitness	diretor de fitness
diretor_de_fotografia	diretor de fotografia
diretor_de_gestão_de_matrículas	diretor de gestão de matrículas
diretor_de_impostos	diretor de impostos
diretor_de_inteligência_de_mercado	diretor de inteligência de mercado
diretor_de_investigações	diretor de investigações
diretor_de_investimentos	diretor de investimentos
diretor_de_logística	diretor de logística
diretor_de_marketing_e_comunicação	diretor de marketing e comunicação
diretor_de_matricula	diretor de matricula
diretor_de_mídia	diretor de mídia
diretor_de_mídia_do_grupo	diretor de mídia do grupo
diretor_de_mídias_sociais	diretor de mídias sociais
diretor_de_notícias	diretor de notícias
diretor_de_notícias_assistente	diretor de notícias assistente
diretor_de_operações	diretor de operações
diretor_de_operações_comerciais	diretor de operações comerciais
diretor_de_operações_de_produção	diretor de operações de produção
diretor_de_operações_de_rede	diretor de operações de rede
diretor_de_operações_de_transmissão	diretor de operações de transmissão
diretor_de_operações_de_voo	diretor de operações de voo
diretor_de_parcerias_corporativas	diretor de parcerias corporativas
diretor_de_pesquisa_de_capital	diretor de pesquisa de capital
diretor_de_pessoal	diretor de pessoal
diretor_de_planejamento_do_grupo	diretor de planejamento do grupo
diretor_de_política	diretor de política
diretor_de_portfólio	diretor de portfólio
diretor_de_produção_de_transmissão	diretor de produção de transmissão
diretor_de_produção_de_vídeo	diretor de produção de vídeo
diretor_de_pré-construção	diretor de pré-construção
diretor_de_publicação	diretor de publicação
diretor_de_pós-produção	diretor de pós-produção
diretor_de_radiologia	diretor de radiologia
diretor_de_realocação	diretor de realocação
diretor_de_relações_com_a_mídia	diretor de relações com a mídia
diretor_de_relações_corporativas_e_fundações	diretor de relações corporativas e fundações
diretor_de_relações_públicas	diretor de relações públicas
diretor_de_renda_fixa	diretor de renda fixa
diretor_de_risco	diretor de risco
diretor_de_serviços_de_imagem	diretor de serviços de imagem
diretor_de_serviços_de_mídia	diretor de serviços de mídia
diretor_de_serviços_especiais	diretor de serviços especiais
diretor_de_serviços_familiares	diretor de serviços familiares
diretor_de_serviços_gastronômicos	diretor de serviços gastronômicos
diretor_de_serviços_para_sócios	diretor de serviços para sócios
diretor_de_subscrição	diretor de subscrição
diretor_de_talentos	diretor de talentos
diretor_de_teatro	diretor de teatro
diretor_de_televisão	diretor de televisão
diretor_de_treinamento_pessoal	diretor de treinamento pessoal
diretor_de_turismo	diretor de turismo
diretor_de_vendas_de_catering	diretor de vendas de catering
diretor_de_vendas_de_lazer	diretor de vendas de lazer
diretor_de_vendas_e_marketing	diretor de vendas e marketing
diretor_de_vendas_institucionais	diretor de vendas institucionais
diretor_do_centro_de_operações_de_rede	diretor do centro de operações de rede
diretor_do_ensino_fundamental	diretor do ensino fundamental
diretor_do_hospital	diretor do hospital
diretor_do_jogo	diretor do jogo
diretor_editorial	diretor editorial
diretor_eficácia_organizacional	diretor eficácia organizacional
diretor_elementar	diretor elementar
diretor_executivo	diretor executivo
diretor_executivo_de_criação	diretor executivo de criação
diretor_jurídico_e_de_compliance	diretor jurídico e de compliance
diretor_musical	diretor musical
diretor_médico	diretor médico
diretor_médico_executivo	diretor médico executivo
diretor_operacional	diretor operacional
diretor_regional_de_prevenção_de_perdas	diretor regional de prevenção de perdas
diretor_técnico_de_arte	diretor técnico de arte
diretor_técnico_de_personagens	diretor técnico de personagens
diretor-gerente	diretor-gerente
documentarista	documentarista
dono_de_salão	dono de salão
editor	editor
editor_assistente	editor assistente
editor_chefe	editor chefe
editor_comissionado	editor comissionado
editor_consultor	editor consultor
editor_da_cidade	editor da cidade
editor_da_web	editor da web
editor_de_computador	editor de computador
editor_de_design	editor de design
editor_de_esportes	editor de esportes
editor_de_estilo_de_vida	editor de estilo de vida
editor_de_filme	editor de filme
editor_de_filmes_e_vídeos	editor de filmes e vídeos
editor_de_foto	editor de foto
editor_de_projeto	editor de projeto
editor_de_publicação	editor de publicação
editor_de_pós-produção	editor de pós-produção
editor_de_tarefas	editor de tarefas
editor_de_viagens	editor de viagens
editor_de_vídeo	editor de vídeo
editor_de_vídeo_assistente	editor de vídeo assistente
editor_do_grupo	editor do grupo
editor_jurídico	editor jurídico
editor_metro	editor metro
editor_ávido	editor ávido
editor-chefe_adjunto	editor-chefe adjunto
educador_especial	educador especial
educadora_de_infância	educadora de infância
embaixador_de_admissões	embaixador de admissões
empacotador	empacotador
empreiteiro_geral	empreiteiro geral
empresa_de_software	empresa de software
empréstimo_mais_perto	empréstimo mais perto
endodontista	endodontista
enfermeira	enfermeira
enfermeira_adulto	enfermeira adulto
enfermeira_cirúrgica	enfermeira cirúrgica
enfermeira_da_equipe	enfermeira da equipe
enfermeira_de_cuidados_intensivos	enfermeira de cuidados intensivos
enfermeira_de_ligação	enfermeira de ligação
enfermeira_de_prática_avançada	enfermeira de prática avançada
enfermeira_de_saude_publica	enfermeira de saude publica
enfermeira_de_saúde_domiciliar	enfermeira de saúde domiciliar
enfermeira_de_viagem	enfermeira de viagem
enfermeira_dental	enfermeira dental
enfermeira_distrital	enfermeira distrital
enfermeira_do_trabalho	enfermeira do trabalho
enfermeira_escolar	enfermeira escolar
enfermeira_pediátrica	enfermeira pediátrica
enfermeira_psiquiátrica_de_saúde_mental	enfermeira psiquiátrica de saúde mental
engenheiro_aerodinâmico	engenheiro aerodinâmico
engenheiro_aeronáutico	engenheiro aeronáutico
engenheiro_ambiental	engenheiro ambiental
engenheiro_assistente_de_projeto	engenheiro assistente de projeto
engenheiro_assistente_de_projetos	engenheiro assistente de projetos
engenheiro_bsc	engenheiro bsc
engenheiro_chefe_de_software	engenheiro chefe de software
engenheiro_civil	engenheiro civil
engenheiro_civil_graduado	engenheiro civil graduado
engenheiro_civil_local	engenheiro civil local
engenheiro_civil_principal	engenheiro civil principal
engenheiro_clínico	engenheiro clínico
engenheiro_consultor	engenheiro consultor
engenheiro_da_estação	engenheiro da estação
engenheiro_de_alimentos	engenheiro de alimentos
engenheiro_de_aplicação	engenheiro de aplicação
engenheiro_de_aplicação_pessoal	engenheiro de aplicação pessoal
engenheiro_de_aplicações_corporativas	engenheiro de aplicações corporativas
engenheiro_de_aquecimento_e_ar_condicionado	engenheiro de aquecimento e ar condicionado
engenheiro_de_automação	engenheiro de automação
engenheiro_de_automação_de_garantia_de_qualidade	engenheiro de automação de garantia de qualidade
engenheiro_de_automação_de_processos	engenheiro de automação de processos
engenheiro_de_automação_de_projetos	engenheiro de automação de projetos
engenheiro_de_calibração	engenheiro de calibração
engenheiro_de_campo	engenheiro de campo
engenheiro_de_campo_geral	engenheiro de campo geral
engenheiro_de_campo_wireline	engenheiro de campo wireline
engenheiro_de_certificação	engenheiro de certificação
engenheiro_de_circuito	engenheiro de circuito
engenheiro_de_comutação	engenheiro de comutação
engenheiro_de_conclusão	engenheiro de conclusão
engenheiro_de_controle_de_processos	engenheiro de controle de processos
engenheiro_de_desempenho_de_rede	engenheiro de desempenho de rede
engenheiro_de_desempenho_do_sistema	engenheiro de desempenho do sistema
engenheiro_de_desenvolvimento_de_hardware	engenheiro de desenvolvimento de hardware
engenheiro_de_desenvolvimento_de_software	engenheiro de desenvolvimento de software
engenheiro_de_desenvolvimento_de_software_em_teste	engenheiro de desenvolvimento de software em teste
engenheiro_de_desenvolvimento_eletrônico	engenheiro de desenvolvimento eletrônico
engenheiro_de_desenvolvimento_mecânico	engenheiro de desenvolvimento mecânico
engenheiro_de_desenvolvimento_web	engenheiro de desenvolvimento web
engenheiro_de_design_analógico	engenheiro de design analógico
engenheiro_de_design_de_equipe	engenheiro de design de equipe
engenheiro_de_design_digital	engenheiro de design digital
engenheiro_de_design_e_desenvolvimento_de_produtos	engenheiro de design e desenvolvimento de produtos
engenheiro_de_desktop	engenheiro de desktop
engenheiro_de_diagnóstico	engenheiro de diagnóstico
engenheiro_de_drenagem	engenheiro de drenagem
engenheiro_de_escritório_técnico	engenheiro de escritório técnico
engenheiro_de_estresse	engenheiro de estresse
engenheiro_de_firewall	engenheiro de firewall
engenheiro_de_garantia_de_qualidade_de_software	engenheiro de garantia de qualidade de software
engenheiro_de_gravação	engenheiro de gravação
engenheiro_de_hardware	engenheiro de hardware
engenheiro_de_hardware_da_equipe	engenheiro de hardware da equipe
engenheiro_de_hardware_de_computador	engenheiro de hardware de computador
engenheiro_de_hardware_principal	engenheiro de hardware principal
engenheiro_de_helpdesk	engenheiro de helpdesk
engenheiro_de_implantação	engenheiro de implantação
engenheiro_de_implementação	engenheiro de implementação
engenheiro_de_infraestrutura_de_rede	engenheiro de infraestrutura de rede
engenheiro_de_inovação	engenheiro de inovação
engenheiro_de_integração_de_rede	engenheiro de integração de rede
engenheiro_de_integridade_de_sinal	engenheiro de integridade de sinal
engenheiro_de_interface_do_usuário	engenheiro de interface do usuário
engenheiro_de_lançamento	engenheiro de lançamento
engenheiro_de_layout	engenheiro de layout
engenheiro_de_liberação_de_design	engenheiro de liberação de design
engenheiro_de_logística	engenheiro de logística
engenheiro_de_manufatura	engenheiro de manufatura
engenheiro_de_minas	engenheiro de minas
engenheiro_de_máquinas	engenheiro de máquinas
engenheiro_de_nave_espacial	engenheiro de nave espacial
engenheiro_de_núcleo	engenheiro de núcleo
engenheiro_de_operações_de_campo	engenheiro de operações de campo
engenheiro_de_operações_de_rede	engenheiro de operações de rede
engenheiro_de_pacotes	engenheiro de pacotes
engenheiro_de_pavimentação	engenheiro de pavimentação
engenheiro_de_pesquisa_e_desenvolvimento	engenheiro de pesquisa e desenvolvimento
engenheiro_de_pesquisa_pessoal	engenheiro de pesquisa pessoal
engenheiro_de_pilha_completa	engenheiro de pilha completa
engenheiro_de_ponte	engenheiro de ponte
engenheiro_de_poço	engenheiro de poço
engenheiro_de_processo_de_planta	engenheiro de processo de planta
engenheiro_de_produção	engenheiro de produção
engenheiro_de_projeto	engenheiro de projeto
engenheiro_de_projeto_de_firmware	engenheiro de projeto de firmware
engenheiro_de_projeto_de_processo	engenheiro de projeto de processo
engenheiro_de_projeto_de_sinal_misto	engenheiro de projeto de sinal misto
engenheiro_de_projeto_de_sistema	engenheiro de projeto de sistema
engenheiro_de_projeto_e_desenvolvimento	engenheiro de projeto e desenvolvimento
engenheiro_de_projeto_físico	engenheiro de projeto físico
engenheiro_de_projeto_principal	engenheiro de projeto principal
engenheiro_de_projetos	engenheiro de projetos
engenheiro_de_projetos_de_telecomunicações	engenheiro de projetos de telecomunicações
engenheiro_de_projetos_eletrônicos	engenheiro de projetos eletrônicos
engenheiro_de_projetos_mecânicos	engenheiro de projetos mecânicos
engenheiro_de_propriedade_intelectual	engenheiro de propriedade intelectual
engenheiro_de_propulsão	engenheiro de propulsão
engenheiro_de_rede	engenheiro de rede
engenheiro_de_rede_cisco	engenheiro de rede cisco
engenheiro_de_rede_de_computadores	engenheiro de rede de computadores
engenheiro_de_rede_de_dados	engenheiro de rede de dados
engenheiro_de_rede_empresarial	engenheiro de rede empresarial
engenheiro_de_rede_sem_fio	engenheiro de rede sem fio
engenheiro_de_rede_voip	engenheiro de rede voip
engenheiro_de_reparo	engenheiro de reparo
engenheiro_de_rádio	engenheiro de rádio
engenheiro_de_segurança	engenheiro de segurança
engenheiro_de_segurança_da_informação	engenheiro de segurança da informação
engenheiro_de_segurança_de_rede	engenheiro de segurança de rede
engenheiro_de_segurança_principal	engenheiro de segurança principal
engenheiro_de_serviços_de_construção	engenheiro de serviços de construção
engenheiro_de_seção	engenheiro de seção
engenheiro_de_simulação	engenheiro de simulação
engenheiro_de_sistema_avançado	engenheiro de sistema avançado
engenheiro_de_sistema_de_controle	engenheiro de sistema de controle
engenheiro_de_sistema_de_suporte_empresarial	engenheiro de sistema de suporte empresarial
engenheiro_de_sistema_eletrônico	engenheiro de sistema eletrônico
engenheiro_de_sistema_regional	engenheiro de sistema regional
engenheiro_de_sistemas	engenheiro de sistemas
engenheiro_de_sistemas_de_telecomunicações	engenheiro de sistemas de telecomunicações
engenheiro_de_sistemas_embarcados	engenheiro de sistemas embarcados
engenheiro_de_sistemas_mecânicos	engenheiro de sistemas mecânicos
engenheiro_de_sistemas_microsoft	engenheiro de sistemas microsoft
engenheiro_de_software	engenheiro de software
engenheiro_de_software_distinto	engenheiro de software distinto
engenheiro_de_software_java	engenheiro de software java
engenheiro_de_som	engenheiro de som
engenheiro_de_suporte_ao_sistema	engenheiro de suporte ao sistema
engenheiro_de_suporte_de_desktop	engenheiro de suporte de desktop
engenheiro_de_suporte_de_hardware	engenheiro de suporte de hardware
engenheiro_de_suporte_de_rede	engenheiro de suporte de rede
engenheiro_de_suporte_remoto	engenheiro de suporte remoto
engenheiro_de_suporte_técnico_ao_cliente	engenheiro de suporte técnico ao cliente
engenheiro_de_suporte_técnico_da_equipe	engenheiro de suporte técnico da equipe
engenheiro_de_suporte_técnico_de_vendas	engenheiro de suporte técnico de vendas
engenheiro_de_telecomunicações	engenheiro de telecomunicações
engenheiro_de_telefonia	engenheiro de telefonia
engenheiro_de_teste	engenheiro de teste
engenheiro_de_teste_de_direção	engenheiro de teste de direção
engenheiro_de_teste_de_voo	engenheiro de teste de voo
engenheiro_de_teste_elétrico	engenheiro de teste elétrico
engenheiro_de_testes	engenheiro de testes
engenheiro_de_transmissão	engenheiro de transmissão
engenheiro_de_trem_de_força	engenheiro de trem de força
engenheiro_de_vendas_da_área	engenheiro de vendas da área
engenheiro_de_voz	engenheiro de voz
engenheiro_de_vídeo	engenheiro de vídeo
engenheiro_de_áudio	engenheiro de áudio
engenheiro_distrital	engenheiro distrital
engenheiro_edison	engenheiro edison
engenheiro_eletricista	engenheiro eletricista
engenheiro_eletricista_e_eletronico	engenheiro eletricista e eletronico
engenheiro_eletricista_e_instrumentação	engenheiro eletricista e instrumentação
engenheiro_eletricista_pessoal	engenheiro eletricista pessoal
engenheiro_eletricista_principal	engenheiro eletricista principal
engenheiro_eletromecânico	engenheiro eletromecânico
engenheiro_elétrico	engenheiro elétrico
engenheiro_empresarial	engenheiro empresarial
engenheiro_estrutural_graduado	engenheiro estrutural graduado
engenheiro_geológico	engenheiro geológico
engenheiro_mecanico_contratado	engenheiro mecanico contratado
engenheiro_mecânico_chefe	engenheiro mecânico chefe
engenheiro_mecânico_de_processos	engenheiro mecânico de processos
engenheiro_mecânico_graduado	engenheiro mecânico graduado
engenheiro_mecânico_principal	engenheiro mecânico principal
engenheiro_metalúrgico	engenheiro metalúrgico
engenheiro_municipal	engenheiro municipal
engenheiro_médico	engenheiro médico
engenheiro_móvel	engenheiro móvel
engenheiro_petrolífero	engenheiro petrolífero
engenheiro_portuário	engenheiro portuário
engenheiro_profissional	engenheiro profissional
engenheiro_residente	engenheiro residente
engenheiro_residente_assistente	engenheiro residente assistente
engenheiro_scada	engenheiro scada
engenheiro_sem_fio	engenheiro sem fio
engenheiro_técnico_de_campo	engenheiro técnico de campo
engenheiro_voip	engenheiro voip
engenheiro_web	engenheiro web
equipe_executiva_lidera_a_experiência_do_hóspede	equipe executiva lidera a experiência do hóspede
escritor	escritor
escritor_contribuinte	escritor contribuinte
escritor_criativo	escritor criativo
escritor_de_negócios	escritor de negócios
escritor_de_recursos	escritor de recursos
escritor_de_viagens	escritor de viagens
escritor_financeiro	escritor financeiro
escriturário	escriturário
escriturário_de_verão	escriturário de verão
escriturário_judiciário	escriturário judiciário
escultor	escultor
especialista_acadêmico	especialista acadêmico
especialista_de_campo_da_agência	especialista de campo da agência
especialista_em_alfabetização	especialista em alfabetização
especialista_em_aplicações_clínicas	especialista em aplicações clínicas
especialista_em_aplicações_web	especialista em aplicações web
especialista_em_armazém	especialista em armazém
especialista_em_arte	especialista em arte
especialista_em_atendimento_ao_cliente	especialista em atendimento ao cliente
especialista_em_automação	especialista em automação
especialista_em_automação_de_testes	especialista em automação de testes
especialista_em_banco_empresarial	especialista em banco empresarial
especialista_em_computadores_pessoais	especialista em computadores pessoais
especialista_em_comunicação	especialista em comunicação
especialista_em_comunicação_de_marketing	especialista em comunicação de marketing
especialista_em_comunicação_web	especialista em comunicação web
especialista_em_comércio_internacional	especialista em comércio internacional
especialista_em_contencioso	especialista em contencioso
especialista_em_cores	especialista em cores
especialista_em_crédito	especialista em crédito
especialista_em_crédito_habitação	especialista em crédito habitação
especialista_em_derivativos	especialista em derivativos
especialista_em_desenvolvimento_de_negócios	especialista em desenvolvimento de negócios
especialista_em_eletrônica	especialista em eletrônica
especialista_em_emprego	especialista em emprego
especialista_em_empréstimos	especialista em empréstimos
especialista_em_engenharia_de_processos	especialista em engenharia de processos
especialista_em_eventos	especialista em eventos
especialista_em_execução_hipotecária	especialista em execução hipotecária
especialista_em_exportação	especialista em exportação
especialista_em_falência	especialista em falência
especialista_em_farmácia_clínica	especialista em farmácia clínica
especialista_em_fechamento	especialista em fechamento
especialista_em_fitness	especialista em fitness
especialista_em_fotografia	especialista em fotografia
especialista_em_fundos_mútuos	especialista em fundos mútuos
especialista_em_gestão_de_talentos	especialista em gestão de talentos
especialista_em_hardware	especialista em hardware
especialista_em_hipoteca	especialista em hipoteca
especialista_em_home_theater	especialista em home theater
especialista_em_importação	especialista em importação
especialista_em_impostos	especialista em impostos
especialista_em_imóveis	especialista em imóveis
especialista_em_imóveis_comerciais	especialista em imóveis comerciais
especialista_em_investigações	especialista em investigações
especialista_em_investimentos	especialista em investimentos
especialista_em_leitura	especialista em leitura
especialista_em_liquidação	especialista em liquidação
especialista_em_localização	especialista em localização
especialista_em_logística	especialista em logística
especialista_em_marketing_e_relações_públicas	especialista em marketing e relações públicas
especialista_em_microcomputadores	especialista em microcomputadores
especialista_em_mídia_da_biblioteca_escolar	especialista em mídia da biblioteca escolar
especialista_em_mídia_de_biblioteca	especialista em mídia de biblioteca
especialista_em_mídias_sociais	especialista em mídias sociais
especialista_em_negociação	especialista em negociação
especialista_em_negócios	especialista em negócios
especialista_em_novos_negócios	especialista em novos negócios
especialista_em_patrimônio	especialista em patrimônio
especialista_em_planejamento_hipotecário_certificado	especialista em planejamento hipotecário certificado
especialista_em_política	especialista em política
especialista_em_processos	especialista em processos
especialista_em_produção_de_mídia	especialista em produção de mídia
especialista_em_produção_de_vídeo	especialista em produção de vídeo
especialista_em_propriedade	especialista em propriedade
especialista_em_propriedade_intelectual	especialista em propriedade intelectual
especialista_em_proteção_ambiental	especialista em proteção ambiental
especialista_em_publicidade	especialista em publicidade
especialista_em_realocação	especialista em realocação
especialista_em_recrutamento	especialista em recrutamento
especialista_em_recrutamento_de_rh	especialista em recrutamento de rh
especialista_em_recursos	especialista em recursos
especialista_em_rede	especialista em rede
especialista_em_rede_de_computadores	especialista em rede de computadores
especialista_em_rede_de_dados	especialista em rede de dados
especialista_em_renda_fixa	especialista em renda fixa
especialista_em_saúde_e_fitness	especialista em saúde e fitness
especialista_em_segurança	especialista em segurança
especialista_em_segurança_de_rede	especialista em segurança de rede
especialista_em_seguros	especialista em seguros
especialista_em_sistema_de_controle	especialista em sistema de controle
especialista_em_software	especialista em software
especialista_em_suporte	especialista em suporte
especialista_em_suporte_ao_cliente	especialista em suporte ao cliente
especialista_em_suporte_ao_usuário	especialista em suporte ao usuário
especialista_em_suporte_ao_usuário_final	especialista em suporte ao usuário final
especialista_em_suporte_de_desktop	especialista em suporte de desktop
especialista_em_suporte_regional	especialista em suporte regional
especialista_em_suporte_técnico	especialista em suporte técnico
especialista_em_telecomunicações	especialista em telecomunicações
especialista_em_vendas_consultivas	especialista em vendas consultivas
especialista_em_viagens	especialista em viagens
especialista_em_wireless	especialista em wireless
especialista_gráfico	especialista gráfico
especialista_instrucional	especialista instrucional
especialista_jurídico	especialista jurídico
especialista_mecânico	especialista mecânico
especialista_nacional	especialista nacional
especialista_operacional	especialista operacional
especialista_técnico_regional	especialista técnico regional
especialista_visual	especialista visual
estagiária_de_alimentos_e_bebidas	estagiária de alimentos e bebidas
estagiária_de_aquisição_de_talentos	estagiária de aquisição de talentos
estagiária_de_banco_de_investimento	estagiária de banco de investimento
estagiária_de_desenvolvimento_web	estagiária de desenvolvimento web
estagiária_de_design_de_moda	estagiária de design de moda
estagiária_de_design_e_produção	estagiária de design e produção
estagiária_de_design_gráfico	estagiária de design gráfico
estagiária_de_direção_de_arte	estagiária de direção de arte
estagiária_de_engenharia_de_sistemas	estagiária de engenharia de sistemas
estagiária_de_engenharia_de_software	estagiária de engenharia de software
estagiária_de_finanças_corporativas	estagiária de finanças corporativas
estagiária_de_front_office	estagiária de front office
estagiária_de_gestão_de_risco	estagiária de gestão de risco
estagiária_de_medicina	estagiária de medicina
estagiária_de_paisagismo	estagiária de paisagismo
estagiária_de_pesquisa_de_patrimônio	estagiária de pesquisa de patrimônio
estagiária_de_private_equity	estagiária de private equity
estagiária_de_pós_produção	estagiária de pós produção
estagiária_de_serviços_criativos	estagiária de serviços criativos
estagiária_de_suporte_de_mesa	estagiária de suporte de mesa
estagiária_de_visual_merchandising	estagiária de visual merchandising
estagiária_departamento_jurídico	estagiária departamento jurídico
estagiária_desenvolvedora_de_software	estagiária desenvolvedora de software
estagiária_do_programa_da_faculdade	estagiária do programa da faculdade
estagiária_do_programa_de_gestão_financeira	estagiária do programa de gestão financeira
estagiário	estagiário
estagiário_criativo	estagiário criativo
estagiário_de_admissão	estagiário de admissão
estagiário_de_animação	estagiário de animação
estagiário_de_arquivos	estagiário de arquivos
estagiário_de_cobrança	estagiário de cobrança
estagiário_de_construção	estagiário de construção
estagiário_de_design	estagiário de design
estagiário_de_engenharia	estagiário de engenharia
estagiário_de_engenharia_civil	estagiário de engenharia civil
estagiário_de_engenharia_de_software	estagiário de engenharia de software
estagiário_de_engenharia_mecânica	estagiário de engenharia mecânica
estagiário_de_música	estagiário de música
estagiário_de_software	estagiário de software
estagiário_esportivo	estagiário esportivo
estagiário_legal_certificado	estagiário legal certificado
estagiário_multimídia	estagiário multimídia
estalajadeiro	estalajadeiro
estilista	estilista
estilista_de_cabelo	estilista de cabelo
estilista_de_fotos	estilista de fotos
estilista_de_guarda-roupa	estilista de guarda-roupa
estilista_de_moda	estilista de moda
estilista_mestre	estilista mestre
estimador_de_projetos	estimador de projetos
estoquista_noturno	estoquista noturno
estrategista_de_ações	estrategista de ações
estrategista_de_contas	estrategista de contas
estrategista_de_conteúdo	estrategista de conteúdo
estrategista_de_investimentos	estrategista de investimentos
estrategista_de_marketing	estrategista de marketing
estrategista_de_mídia	estrategista de mídia
estrategista_de_mídias_sociais	estrategista de mídias sociais
estrategista_de_produto	estrategista de produto
estratégia_vp	estratégia vp
estudante_Professor	estudante Professor
estudante_de_arquitetura	estudante de arquitetura
estudante_de_design_gráfico	estudante de design gráfico
estudante_de_enfermagem	estudante de enfermagem
estudante_de_engenharia_mecânica	estudante de engenharia mecânica
estudante_de_informática	estudante de informática
estudante_de_mba	estudante de mba
estudante_voluntário	estudante voluntário
examinador_de_banco	examinador de banco
examinador_de_título	examinador de título
examinador_externo	examinador externo
executivo_de_aquisição_de_talentos	executivo de aquisição de talentos
executivo_de_campo_da_agência	executivo de campo da agência
executivo_de_contas	executivo de contas
executivo_de_contas_de_relações_públicas	executivo de contas de relações públicas
executivo_de_contas_digitais	executivo de contas digitais
executivo_de_documentação	executivo de documentação
executivo_de_eventos	executivo de eventos
executivo_de_finanças_corporativas	executivo de finanças corporativas
executivo_de_front_office	executivo de front office
executivo_de_importação	executivo de importação
executivo_de_importação_e_exportação	executivo de importação e exportação
executivo_de_logística	executivo de logística
executivo_de_marketing_e_comunicação	executivo de marketing e comunicação
executivo_de_mídia	executivo de mídia
executivo_de_relacionamento	executivo de relacionamento
executivo_de_relações_com_hóspedes	executivo de relações com hóspedes
executivo_de_seguros	executivo de seguros
executivo_de_vendas_de_exportação	executivo de vendas de exportação
executivo_de_viagens	executivo de viagens
executivo_em_residência	executivo em residência
executivo_legal	executivo legal
expedidor	expedidor
exploração_vp	exploração vp
facilitador_de_grupo	facilitador de grupo
farmacêutico_assuntos_regulatórios	farmacêutico assuntos regulatórios
farmacêutico_clínico	farmacêutico clínico
farmacêutico_de_produção	farmacêutico de produção
farmacêutico_do_corpo_clínico	farmacêutico do corpo clínico
financiador	financiador
fonte	fonte
fornecedor	fornecedor
fotógrafo_assistente	fotógrafo assistente
fotógrafo_contratado	fotógrafo contratado
fotógrafo_da_equipe	fotógrafo da equipe
fotógrafo_de_arte	fotógrafo de arte
fotógrafo_de_eventos	fotógrafo de eventos
fotógrafo_de_moda	fotógrafo de moda
fotógrafo_esportivo	fotógrafo esportivo
freelance	freelance
front_office_líder_de_equipe	front office líder de equipe
funcionário_da_contabilidade	funcionário da contabilidade
funcionário_de_auditoria	funcionário de auditoria
funcionário_de_cortesia	funcionário de cortesia
funcionário_de_empréstimo	funcionário de empréstimo
funcionário_de_importação	funcionário de importação
funcionário_do_banco	funcionário do banco
funcionário_público	funcionário público
física_geral	física geral
garçom	garçom
garçom_principal	garçom principal
garçonete_de_coquetel	garçonete de coquetel
generalista_3d	generalista 3d
generalista_de_rh	generalista de rh
geocientista	geocientista
geofísico_da_equipe	geofísico da equipe
geofísico_de_processamento	geofísico de processamento
gerenciador_de_cofre	gerenciador de cofre
gerenciador_de_conteúdo_digital	gerenciador de conteúdo digital
gerenciador_de_conteúdo_do_site	gerenciador de conteúdo do site
gerenciador_de_cópias	gerenciador de cópias
gerenciador_de_mídia_interativa	gerenciador de mídia interativa
gerenciador_de_rede_central	gerenciador de rede central
gerenciador_de_sites	gerenciador de sites
gerenciador_de_terminais	gerenciador de terminais
gerente_assistente_de_recepção	gerente assistente de recepção
gerente_assistente_de_serviços_ao_hóspede	gerente assistente de serviços ao hóspede
gerente_bancário	gerente bancário
gerente_criativo	gerente criativo
gerente_da_frente_da_casa	gerente da frente da casa
gerente_de_agência	gerente de agência
gerente_de_agência_de_viagens	gerente de agência de viagens
gerente_de_alimentação	gerente de alimentação
gerente_de_angariação_de_fundos	gerente de angariação de fundos
gerente_de_anúncios_classificados	gerente de anúncios classificados
gerente_de_aquisição_de_sites	gerente de aquisição de sites
gerente_de_aquisição_de_talentos	gerente de aquisição de talentos
gerente_de_armazém	gerente de armazém
gerente_de_armazém_e_distribuição	gerente de armazém e distribuição
gerente_de_armazém_e_logística	gerente de armazém e logística
gerente_de_banco_pessoal	gerente de banco pessoal
gerente_de_banco_privado	gerente de banco privado
gerente_de_banda	gerente de banda
gerente_de_bar	gerente de bar
gerente_de_base	gerente de base
gerente_de_benefícios	gerente de benefícios
gerente_de_café	gerente de café
gerente_de_carteira_de_ações	gerente de carteira de ações
gerente_de_centro_de_atendimento	gerente de centro de atendimento
gerente_de_centro_de_conferências	gerente de centro de conferências
gerente_de_centro_de_negócios	gerente de centro de negócios
gerente_de_centro_logístico	gerente de centro logístico
gerente_de_cliente_privado	gerente de cliente privado
gerente_de_coleções_da_área	gerente de coleções da área
gerente_de_comissionamento	gerente de comissionamento
gerente_de_compliance_fiscal	gerente de compliance fiscal
gerente_de_compras_internacionais	gerente de compras internacionais
gerente_de_comunicação_externa	gerente de comunicação externa
gerente_de_comunicação_global	gerente de comunicação global
gerente_de_comunicações	gerente de comunicações
gerente_de_conferência	gerente de conferência
gerente_de_consultoria	gerente de consultoria
gerente_de_conta_logística	gerente de conta logística
gerente_de_contas	gerente de contas
gerente_de_contas_de_publicidade	gerente de contas de publicidade
gerente_de_contas_de_recrutamento	gerente de contas de recrutamento
gerente_de_contas_digitais	gerente de contas digitais
gerente_de_contas_middle_market	gerente de contas middle market
gerente_de_contas_principal	gerente de contas principal
gerente_de_contencioso	gerente de contencioso
gerente_de_coordenação_de_projetos	gerente de coordenação de projetos
gerente_de_cozinha	gerente de cozinha
gerente_de_culinária	gerente de culinária
gerente_de_custos	gerente de custos
gerente_de_câmbio	gerente de câmbio
gerente_de_departamento_de_arte	gerente de departamento de arte
gerente_de_departamento_de_logística	gerente de departamento de logística
gerente_de_departamento_elétrico	gerente de departamento elétrico
gerente_de_desenvolvimento_de_negócios_globais	gerente de desenvolvimento de negócios globais
gerente_de_desenvolvimento_de_rotas	gerente de desenvolvimento de rotas
gerente_de_desenvolvimento_web	gerente de desenvolvimento web
gerente_de_design_criativo	gerente de design criativo
gerente_de_design_de_marca	gerente de design de marca
gerente_de_design_gráfico	gerente de design gráfico
gerente_de_dieta	gerente de dieta
gerente_de_doação_anual	gerente de doação anual
gerente_de_doação_individual	gerente de doação individual
gerente_de_engenharia_de_campo	gerente de engenharia de campo
gerente_de_engenharia_de_rede	gerente de engenharia de rede
gerente_de_engenharia_do_grupo	gerente de engenharia do grupo
gerente_de_engenharia_elétrica	gerente de engenharia elétrica
gerente_de_envio_e_recebimento	gerente de envio e recebimento
gerente_de_escritório_técnico	gerente de escritório técnico
gerente_de_esportes	gerente de esportes
gerente_de_estoque	gerente de estoque
gerente_de_estratégia_e_operações	gerente de estratégia e operações
gerente_de_estúdio_de_design	gerente de estúdio de design
gerente_de_eventos	gerente de eventos
gerente_de_eventos_gastronômicos	gerente de eventos gastronômicos
gerente_de_expedição	gerente de expedição
gerente_de_exportação	gerente de exportação
gerente_de_farmacia_clinica	gerente de farmacia clinica
gerente_de_filial	gerente de filial
gerente_de_fitness	gerente de fitness
gerente_de_fotografia	gerente de fotografia
gerente_de_fundação	gerente de fundação
gerente_de_galeria	gerente de galeria
gerente_de_hospitalidade	gerente de hospitalidade
gerente_de_implementação_de_rede	gerente de implementação de rede
gerente_de_importação	gerente de importação
gerente_de_importação_e_exportação	gerente de importação e exportação
gerente_de_imposto_predial	gerente de imposto predial
gerente_de_impostos_corporativos	gerente de impostos corporativos
gerente_de_impostos_federais	gerente de impostos federais
gerente_de_imprensa_e_relações_públicas	gerente de imprensa e relações públicas
gerente_de_informações_médicas	gerente de informações médicas
gerente_de_infraestrutura_de_rede	gerente de infraestrutura de rede
gerente_de_linhas_pessoais	gerente de linhas pessoais
gerente_de_localização	gerente de localização
gerente_de_logística	gerente de logística
gerente_de_logística_corporativa	gerente de logística corporativa
gerente_de_logística_do_grupo	gerente de logística do grupo
gerente_de_logística_internacional	gerente de logística internacional
gerente_de_marketing_de_aquisição	gerente de marketing de aquisição
gerente_de_marketing_de_conteúdo	gerente de marketing de conteúdo
gerente_de_marketing_de_mídia_social	gerente de marketing de mídia social
gerente_de_marketing_digital	gerente de marketing digital
gerente_de_marketing_integrado	gerente de marketing integrado
gerente_de_marketing_secundário	gerente de marketing secundário
gerente_de_mídia	gerente de mídia
gerente_de_mídia_e_comunicação	gerente de mídia e comunicação
gerente_de_mídia_social	gerente de mídia social
gerente_de_negócios_do_país	gerente de negócios do país
gerente_de_operações_de_armazém	gerente de operações de armazém
gerente_de_operações_de_farmácia	gerente de operações de farmácia
gerente_de_operações_de_investimento	gerente de operações de investimento
gerente_de_operações_de_notícias	gerente de operações de notícias
gerente_de_operações_de_recrutamento	gerente de operações de recrutamento
gerente_de_operações_de_rede	gerente de operações de rede
gerente_de_operações_de_voo	gerente de operações de voo
gerente_de_operações_e_logística	gerente de operações e logística
gerente_de_operações_marítimas	gerente de operações marítimas
gerente_de_operações_terrestres	gerente de operações terrestres
gerente_de_padaria	gerente de padaria
gerente_de_perfuração	gerente de perfuração
gerente_de_pessoal	gerente de pessoal
gerente_de_piscina	gerente de piscina
gerente_de_planejamento_estratégico	gerente de planejamento estratégico
gerente_de_plantão	gerente de plantão
gerente_de_politicas_publicas	gerente de politicas publicas
gerente_de_portfólio	gerente de portfólio
gerente_de_portfólio_de_produtos	gerente de portfólio de produtos
gerente_de_presentes_principais	gerente de presentes principais
gerente_de_processos	gerente de processos
gerente_de_produto_sem_fio	gerente de produto sem fio
gerente_de_produção	gerente de produção
gerente_de_produção_de_impressão	gerente de produção de impressão
gerente_de_produção_de_vídeo	gerente de produção de vídeo
gerente_de_produção_editorial	gerente de produção editorial
gerente_de_programa_ambiental	gerente de programa ambiental
gerente_de_programa_técnico_de_equipe	gerente de programa técnico de equipe
gerente_de_projeto_de_rede	gerente de projeto de rede
gerente_de_projeto_físico	gerente de projeto físico
gerente_de_projetos_ambientais	gerente de projetos ambientais
gerente_de_projetos_criativos	gerente de projetos criativos
gerente_de_projetos_de_recrutamento	gerente de projetos de recrutamento
gerente_de_projetos_editoriais	gerente de projetos editoriais
gerente_de_projetos_mecânicos	gerente de projetos mecânicos
gerente_de_pré-construção	gerente de pré-construção
gerente_de_publicação	gerente de publicação
gerente_de_publicações	gerente de publicações
gerente_de_publicidade	gerente de publicidade
gerente_de_publicidade_online	gerente de publicidade online
gerente_de_pós-produção	gerente de pós-produção
gerente_de_radiologia	gerente de radiologia
gerente_de_receita_regional	gerente de receita regional
gerente_de_recepção	gerente de recepção
gerente_de_recrutamento	gerente de recrutamento
gerente_de_recrutamento_de_contas	gerente de recrutamento de contas
gerente_de_recrutamento_e_seleção	gerente de recrutamento e seleção
gerente_de_recrutamento_e_treinamento	gerente de recrutamento e treinamento
gerente_de_recrutamento_graduado	gerente de recrutamento graduado
gerente_de_recursos	gerente de recursos
gerente_de_relacionamento	gerente de relacionamento
gerente_de_relacionamento_com_doadores	gerente de relacionamento com doadores
gerente_de_relacionamento_com_ex-alunos	gerente de relacionamento com ex-alunos
gerente_de_relacionamento_com_o_cliente	gerente de relacionamento com o cliente
gerente_de_relacionamento_comercial	gerente de relacionamento comercial
gerente_de_relacionamento_de_banco_privado	gerente de relacionamento de banco privado
gerente_de_relações_públicas_internacionais	gerente de relações públicas internacionais
gerente_de_rendimento	gerente de rendimento
gerente_de_responsabilidade_de_ativos	gerente de responsabilidade de ativos
gerente_de_restaurante	gerente de restaurante
gerente_de_restaurante_e_bar	gerente de restaurante e bar
gerente_de_rh_do_grupo	gerente de rh do grupo
gerente_de_risco_de_mercado	gerente de risco de mercado
gerente_de_sala	gerente de sala
gerente_de_salão	gerente de salão
gerente_de_segurança_alimentar	gerente de segurança alimentar
gerente_de_serviços_avançados	gerente de serviços avançados
gerente_de_serviços_criativos	gerente de serviços criativos
gerente_de_serviços_de_conferência	gerente de serviços de conferência
gerente_de_serviços_gráficos	gerente de serviços gráficos
gerente_de_show	gerente de show
gerente_de_socorro	gerente de socorro
gerente_de_subsídios	gerente de subsídios
gerente_de_terceirização	gerente de terceirização
gerente_de_terminal_assistente	gerente de terminal assistente
gerente_de_transmissão	gerente de transmissão
gerente_de_transporte	gerente de transporte
gerente_de_treinamento_pessoal	gerente de treinamento pessoal
gerente_de_unidade_de_produção	gerente de unidade de produção
gerente_de_varejo	gerente de varejo
gerente_de_vendas	gerente de vendas
gerente_de_vendas_comunidade	gerente de vendas comunidade
gerente_de_vendas_de_hipoteca	gerente de vendas de hipoteca
gerente_de_vendas_digitais	gerente de vendas digitais
gerente_de_vendas_interativo	gerente de vendas interativo
gerente_de_vendas_local	gerente de vendas local
gerente_de_viagens	gerente de viagens
gerente_de_viagens_corporativas	gerente de viagens corporativas
gerente_de_área_de_exportação	gerente de área de exportação
gerente_distrital_de_proteção_de_ativos	gerente distrital de proteção de ativos
gerente_do_centro_de_design	gerente do centro de design
gerente_do_local	gerente do local
gerente_do_programa_de_localização	gerente do programa de localização
gerente_editorial	gerente editorial
gerente_fiscal	gerente fiscal
gerente_fiscal_estadual_e_municipal	gerente fiscal estadual e municipal
gerente_floral	gerente floral
gerente_geral_de_restaurante	gerente geral de restaurante
gerente_geral_de_área	gerente geral de área
gerente_global_de_logística	gerente global de logística
gerente_global_de_relações_públicas	gerente global de relações públicas
gerente_global_de_viagens	gerente global de viagens
gerente_imobiliário_regional	gerente imobiliário regional
gerente_nacional_de_logística	gerente nacional de logística
gerente_nacional_de_rh	gerente nacional de rh
gerente_noturno	gerente noturno
gerente_proprietário	gerente proprietário
gerente_regional_de_exportação	gerente regional de exportação
gerente_regional_de_logística	gerente regional de logística
gerente_regional_de_obras	gerente regional de obras
gerente_regional_de_produção	gerente regional de produção
gerente_regional_de_recrutamento	gerente regional de recrutamento
gerente_regional_de_transporte	gerente regional de transporte
gerente_técnico_de_recrutamento	gerente técnico de recrutamento
gestor_de_carteira_de_imóveis	gestor de carteira de imóveis
gestor_de_carteira_de_renda_fixa	gestor de carteira de renda fixa
gestor_de_conteúdos	gestor de conteúdos
gestor_de_fundos	gestor de fundos
gestor_de_fundos_anual	gestor de fundos anual
geólogo	geólogo
geólogo_ambiental	geólogo ambiental
geólogo_chefe	geólogo chefe
geólogo_consultor	geólogo consultor
geólogo_contratado	geólogo contratado
geólogo_da_equipe	geólogo da equipe
geólogo_de_campo	geólogo de campo
geólogo_de_minas	geólogo de minas
geólogo_de_pesquisa	geólogo de pesquisa
geólogo_do_projeto	geólogo do projeto
geólogo_do_reservatório	geólogo do reservatório
geólogo_principal	geólogo principal
guia_turístico	guia turístico
guitarrista	guitarrista
herbalista	herbalista
hidrogeólogo_do_projeto	hidrogeólogo do projeto
hidrogeólogo_principal	hidrogeólogo principal
hidrólogo	hidrólogo
higienista_dental_registrado	higienista dental registrado
home_stager	home stager
hospedeiro	hospedeiro
ilustrador	ilustrador
ilustrador_médico	ilustrador médico
ilustre_membro_do_corpo_técnico	ilustre membro do corpo técnico
inspetor_de_construção	inspetor de construção
inspetor_policial	inspetor policial
inspetor_postal	inspetor postal
instrutor_adjunto	instrutor adjunto
instrutor_chefe_de_voo	instrutor chefe de voo
instrutor_clínico	instrutor clínico
instrutor_de_animação	instrutor de animação
instrutor_de_armas_de_fogo	instrutor de armas de fogo
instrutor_de_arremesso	instrutor de arremesso
instrutor_de_artes_marciais	instrutor de artes marciais
instrutor_de_barra	instrutor de barra
instrutor_de_bootcamp	instrutor de bootcamp
instrutor_de_ciclismo_indoor	instrutor de ciclismo indoor
instrutor_de_cinesiologia	instrutor de cinesiologia
instrutor_de_contabilidade	instrutor de contabilidade
instrutor_de_costura	instrutor de costura
instrutor_de_crossfit	instrutor de crossfit
instrutor_de_culinária	instrutor de culinária
instrutor_de_dança	instrutor de dança
instrutor_de_design	instrutor de design
instrutor_de_design_gráfico	instrutor de design gráfico
instrutor_de_enfermagem	instrutor de enfermagem
instrutor_de_ginástica_em_grupo	instrutor de ginástica em grupo
instrutor_de_hidroginástica	instrutor de hidroginástica
instrutor_de_latão	instrutor de latão
instrutor_de_música	instrutor de música
instrutor_de_pós-graduação	instrutor de pós-graduação
instrutor_de_remo	instrutor de remo
instrutor_de_sociologia	instrutor de sociologia
instrutor_de_torcida	instrutor de torcida
instrutor_de_voo	instrutor de voo
instrutor_de_vôo	instrutor de vôo
instrutor_esportivo	instrutor esportivo
instrutor_primário_de_tiro	instrutor primário de tiro
instrutor_principal	instrutor principal
instrutor_universitário	instrutor universitário
instrutor_visitante	instrutor visitante
integrador_de_rede	integrador de rede
intensivista	intensivista
investigador	investigador
investigador_chefe	investigador chefe
investigador_corporativo	investigador corporativo
investigador_de_campo	investigador de campo
investigador_de_fraudes	investigador de fraudes
investigador_de_fundo	investigador de fundo
investigador_especial	investigador especial
investigador_particular	investigador particular
investigador_regional	investigador regional
jogador	jogador
jogador_de_futebol	jogador de futebol
jogador_de_futebol_profissional	jogador de futebol profissional
jornalista_de_radiodifusão	jornalista de radiodifusão
jornalista_de_televisão	jornalista de televisão
jornalista_de_vídeo	jornalista de vídeo
jornalista_financeiro	jornalista financeiro
jornalista_multimídia	jornalista multimídia
juiz	juiz
juiz_de_direito_administrativo	juiz de direito administrativo
juiz_distrital	juiz distrital
leiloeiro	leiloeiro
liderança_criativa	liderança criativa
ligação_clínica	ligação clínica
ligação_da_ciência_médica	ligação da ciência médica
linguista	linguista
linguista_russo	linguista russo
locutor_de_endereço_público	locutor de endereço público
locutor_de_rádio	locutor de rádio
locutor_no_ar	locutor no ar
logística	logística
lojista	lojista
líder_de_animação	líder de animação
líder_de_aquisição_de_talentos	líder de aquisição de talentos
líder_de_cluster	líder de cluster
líder_de_comunicações	líder de comunicações
líder_de_desenvolvimento_de_negócios	líder de desenvolvimento de negócios
líder_de_equipe_de_armazém	líder de equipe de armazém
líder_de_equipe_de_atendimento	líder de equipe de atendimento
líder_de_equipe_de_automação	líder de equipe de automação
líder_de_equipe_de_corretores	líder de equipe de corretores
líder_de_equipe_de_desenvolvimento_de_aplicativos	líder de equipe de desenvolvimento de aplicativos
líder_de_equipe_de_desenvolvimento_web	líder de equipe de desenvolvimento web
líder_de_equipe_de_engenheiro_de_software	líder de equipe de engenheiro de software
líder_de_equipe_de_hardware	líder de equipe de hardware
líder_de_equipe_de_implantação	líder de equipe de implantação
líder_de_equipe_de_logística	líder de equipe de logística
líder_de_equipe_de_projeto	líder de equipe de projeto
líder_de_equipe_de_recrutamento	líder de equipe de recrutamento
líder_de_equipe_de_software_embarcado	líder de equipe de software embarcado
líder_de_equipe_de_suporte_de_desktop	líder de equipe de suporte de desktop
líder_de_equipe_de_suporte_técnico	líder de equipe de suporte técnico
líder_de_equipe_de_telecomunicações	líder de equipe de telecomunicações
líder_de_equipe_do_centro_de_operações_de_rede	líder de equipe do centro de operações de rede
líder_de_equipe_java	líder de equipe java
líder_de_pessoal	líder de pessoal
líder_de_projeto_de_software	líder de projeto de software
líder_de_teste_técnico	líder de teste técnico
líder_do_módulo	líder do módulo
líder_técnico	líder técnico
líder_técnico_java	líder técnico java
major_aposentado	major aposentado
manicuro	manicuro
manipulador_de_arte	manipulador de arte
manipulador_de_materiais	manipulador de materiais
maquiador_profissional	maquiador profissional
marechal_de_fogo	marechal de fogo
mediador	mediador
membro_da_banda	membro da banda
membro_da_equipe_de_vendas	membro da equipe de vendas
membro_da_equipe_profissional	membro da equipe profissional
membro_da_equipe_técnica	membro da equipe técnica
membro_do_conselho_consultivo	membro do conselho consultivo
membro_do_corpo	membro do corpo
mestre_carpinteiro	mestre carpinteiro
mestre_encanador	mestre encanador
mestre_marinheiro	mestre marinheiro
metalúrgico_de_plantas	metalúrgico de plantas
mixer_de_regravação	mixer de regravação
mixer_de_áudio	mixer de áudio
mixologista	mixologista
modelador	modelador
modelador_3d	modelador 3d
modelador_de_personagens	modelador de personagens
modelista	modelista
montador_de_personagens	montador de personagens
motorista_da_empresa	motorista da empresa
motorista_de_estrada	motorista de estrada
motorista_profissional	motorista profissional
mudança_de_liderança	mudança de liderança
muralista	muralista
médico	médico
médico_assistente	médico assistente
médico_da_equipe	médico da equipe
médico_de_emergência	médico de emergência
médico_de_medicina_interna	médico de medicina interna
médico_residente	médico residente
músico	músico
músico_profissional	músico profissional
na_personalidade_do_ar	na personalidade do ar
negociador_de_transmissão	negociador de transmissão
negociante_de_arte	negociante de arte
negociante_de_ações	negociante de ações
neonatologista	neonatologista
oficial_da_cadeia_de_suprimentos	oficial da cadeia de suprimentos
oficial_da_lei	oficial da lei
oficial_da_marinha	oficial da marinha
oficial_de_advocacia	oficial de advocacia
oficial_de_angariação_de_fundos	oficial de angariação de fundos
oficial_de_atendimento_ao_hóspede	oficial de atendimento ao hóspede
oficial_de_audiência	oficial de audiência
oficial_de_banco_privado	oficial de banco privado
oficial_de_caixa	oficial de caixa
oficial_de_comunicação_interna	oficial de comunicação interna
oficial_de_correção	oficial de correção
oficial_de_crédito	oficial de crédito
oficial_de_desenvolvimento_economico	oficial de desenvolvimento economico
oficial_de_empréstimo_hipotecário	oficial de empréstimo hipotecário
oficial_de_ex-alunos	oficial de ex-alunos
oficial_de_exportação	oficial de exportação
oficial_de_garantia_da_informação	oficial de garantia da informação
oficial_de_guarda	oficial de guarda
oficial_de_investigações	oficial de investigações
oficial_de_marketing_e_relações_públicas	oficial de marketing e relações públicas
oficial_de_operações	oficial de operações
oficial_de_projetos	oficial de projetos
oficial_de_recrutamento	oficial de recrutamento
oficial_de_rede	oficial de rede
oficial_de_relacionamento	oficial de relacionamento
oficial_de_relacionamento_com_ex-alunos	oficial de relacionamento com ex-alunos
oficial_de_relações_com_doadores	oficial de relações com doadores
oficial_de_relações_com_hóspedes	oficial de relações com hóspedes
oficial_de_relações_públicas	oficial de relações públicas
oficial_de_telecomunicações	oficial de telecomunicações
oficial_de_treinamento_e_colocação	oficial de treinamento e colocação
oficial_de_título	oficial de título
oficial_intermediário	oficial intermediário
oficial_marítimo	oficial marítimo
oficial_superior	oficial superior
operador_de_armazém	operador de armazém
operador_de_centro_de_operações_de_rede	operador de centro de operações de rede
operador_de_controle_de_qualidade	operador de controle de qualidade
operador_de_controle_mestre	operador de controle mestre
operador_de_câmera	operador de câmera
operador_de_datacenter	operador de datacenter
operador_de_editoração_eletrônica	operador de editoração eletrônica
operador_de_fita	operador de fita
operador_de_placa	operador de placa
operador_técnico	operador técnico
operadora_de_telefone	operadora de telefone
organista	organista
orientador_acadêmico	orientador acadêmico
originador_de_empréstimo_hipotecário	originador de empréstimo hipotecário
ortodontista	ortodontista
padeiro	padeiro
paisagista	paisagista
palhaço	palhaço
paraeducador	paraeducador
paralegal_corporativo	paralegal corporativo
parceiro	parceiro
parceiro_de_litígio	parceiro de litígio
parceiro_de_negócios_de_rh	parceiro de negócios de rh
participante_de_mba	participante de mba
passeador_de_cães	passeador de cães
pasteleiro	pasteleiro
pediatra	pediatra
perfusionista	perfusionista
pesquisador_da_equipe	pesquisador da equipe
pesquisador_de_mídia	pesquisador de mídia
pesquisador_de_pós-graduação	pesquisador de pós-graduação
pesquisador_jurídico	pesquisador jurídico
pesquisador_principal	pesquisador principal
pessoal_da_cozinha	pessoal da cozinha
pessoal_de_chão	pessoal de chão
pessoal_de_contabilidade	pessoal de contabilidade
piloto_assistente-chefe	piloto assistente-chefe
piloto_chefe	piloto chefe
piloto_corporativo	piloto corporativo
piloto_de_contrato	piloto de contrato
piloto_de_linha	piloto de linha
pintor	pintor
planeador_de_eventos	planeador de eventos
planejador	planejador
planejador_de_casamentos_e_eventos	planejador de casamentos e eventos
planejador_de_conferência	planejador de conferência
planejador_de_contas	planejador de contas
planejador_de_eventos_corporativos	planejador de eventos corporativos
planejador_de_eventos_especiais	planejador de eventos especiais
planejador_de_férias	planejador de férias
planejador_de_hipoteca_certificado	planejador de hipoteca certificado
planejador_de_logística	planejador de logística
planejador_de_marca	planejador de marca
planejador_de_mídia	planejador de mídia
planejador_de_mídia_digital	planejador de mídia digital
planejador_de_vendas	planejador de vendas
planejador_digital	planejador digital
planejador_urbano	planejador urbano
policial	policial
policial_reserva	policial reserva
polícia	polícia
porta-voz	porta-voz
porteiro	porteiro
poste_mais_perto	poste mais perto
praticante_legal	praticante legal
preparador_de_impostos	preparador de impostos
preparador_físico	preparador físico
primeiro_assistente_de_câmera	primeiro assistente de câmera
primeiro_assistente_de_direção	primeiro assistente de direção
primeiro_editor_assistente	primeiro editor assistente
primeiro_engenheiro	primeiro engenheiro
primeiro_oficial	primeiro oficial
principal_banqueiro	principal banqueiro
principal_designer_gráfico	principal designer gráfico
principal_fiscal	principal fiscal
principal_gestor_de_carteira	principal gestor de carteira
principal_recrutador	principal recrutador
processador_de_correio	processador de correio
processador_de_empréstimo	processador de empréstimo
procurador	procurador
procurador_distrital_assistente	procurador distrital assistente
procurador-adjunto_do_condado	procurador-adjunto do condado
procurador-geral_adjunto	procurador-geral adjunto
produtor	produtor
produtor_assistente	produtor assistente
produtor_comercial	produtor comercial
produtor_criativo	produtor criativo
produtor_da_web	produtor da web
produtor_de_cinema	produtor de cinema
produtor_de_conteúdo	produtor de conteúdo
produtor_de_desenvolvimento	produtor de desenvolvimento
produtor_de_elenco	produtor de elenco
produtor_de_impressão	produtor de impressão
produtor_de_linha_comercial	produtor de linha comercial
produtor_de_mídia_digital	produtor de mídia digital
produtor_de_notícias	produtor de notícias
produtor_de_novas_mídias	produtor de novas mídias
produtor_de_programa_matinal	produtor de programa matinal
produtor_de_promoções	produtor de promoções
produtor_de_rádio	produtor de rádio
produtor_de_seguros	produtor de seguros
produtor_de_serviços_criativos	produtor de serviços criativos
produtor_de_talentos	produtor de talentos
produtor_de_telejornal	produtor de telejornal
produtor_de_televisão	produtor de televisão
produtor_de_vídeo	produtor de vídeo
produtor_de_áudio	produtor de áudio
produtor_digital	produtor digital
produtor_do_programa	produtor do programa
produtor_esportivo	produtor esportivo
produtor_executivo	produtor executivo
produtor_interativo	produtor interativo
produtor_multimídia	produtor multimídia
produtor_musical	produtor musical
produtor_técnico	produtor técnico
produzir_associado	produzir associado
professor	professor
professor_adjunto	professor adjunto
professor_adjunto_de_finanças	professor adjunto de finanças
professor_adjunto_de_história	professor adjunto de história
professor_assistente	professor assistente
professor_assistente_de_administração	professor assistente de administração
professor_assistente_de_direito	professor assistente de direito
professor_assistente_de_educação	professor assistente de educação
professor_assistente_de_filosofia	professor assistente de filosofia
professor_assistente_de_história	professor assistente de história
professor_assistente_de_ingles	professor assistente de ingles
professor_assistente_de_medicina	professor assistente de medicina
professor_assistente_visitante	professor assistente visitante
professor_associado_clínico	professor associado clínico
professor_bilíngue	professor bilíngue
professor_convidado	professor convidado
professor_de_antropologia	professor de antropologia
professor_de_apoio_ao_aprendizado	professor de apoio ao aprendizado
professor_de_arquitetura	professor de arquitetura
professor_de_arte	professor de arte
professor_de_arte_ingles	professor de arte ingles
professor_de_biologia	professor de biologia
professor_de_ciencia_politica	professor de ciencia politica
professor_de_ciencias_secundario	professor de ciencias secundario
professor_de_cirurgia	professor de cirurgia
professor_de_dança	professor de dança
professor_de_design_gráfico	professor de design gráfico
professor_de_educação	professor de educação
professor_de_educação_empresarial	professor de educação empresarial
professor_de_educação_especial	professor de educação especial
professor_de_escola_fundamental	professor de escola fundamental
professor_de_escola_primária	professor de escola primária
professor_de_escola_publica	professor de escola publica
professor_de_esportes	professor de esportes
professor_de_filosofia	professor de filosofia
professor_de_história	professor de história
professor_de_ingles	professor de ingles
professor_de_inglês_secundário	professor de inglês secundário
professor_de_italiano	professor de italiano
professor_de_jardim_de_infância	professor de jardim de infância
professor_de_leitura	professor de leitura
professor_de_línguas	professor de línguas
professor_de_matemática	professor de matemática
professor_de_matemática_do_ensino_médio	professor de matemática do ensino médio
professor_de_sala_de_aula	professor de sala de aula
professor_de_sociologia	professor de sociologia
professor_de_teatro	professor de teatro
professor_de_violão	professor de violão
professor_do_ensino_médio	professor do ensino médio
professor_emérito	professor emérito
professor_secundário	professor secundário
professor_substituto	professor substituto
professor_universitário	professor universitário
professora	professora
professora_de_creche	professora de creche
professora_de_ingles_lingua_estrangeira	professora de ingles lingua estrangeira
professora_de_primeira_infância	professora de primeira infância
professora_de_pré_jardim_de_infância	professora de pré jardim de infância
professora_de_pré-escola	professora de pré-escola
professora_de_verão	professora de verão
professora_do_ensino_fundamental	professora do ensino fundamental
profissional_da_música	profissional da música
profissional_imobiliário_licenciado	profissional imobiliário licenciado
programa_de_desenvolvimento_de_engenharia_edison	programa de desenvolvimento de engenharia edison
programador_de_aplicações_web	programador de aplicações web
programador_multimídia	programador multimídia
programador_php	programador php
programador_web	programador web
projetista	projetista
projetista_de_circuitos	projetista de circuitos
projetista_de_engenharia	projetista de engenharia
projetista_de_placa_de_circuito_impresso	projetista de placa de circuito impresso
projetista_de_sistema_de_controle	projetista de sistema de controle
proprietário_da_agência	proprietário da agência
provedor_de_rede	provedor de rede
psicanalista	psicanalista
psicoterapeuta_em_consultório_particular	psicoterapeuta em consultório particular
psicólogo	psicólogo
psicólogo_chefe	psicólogo chefe
psicólogo_clínico	psicólogo clínico
psicólogo_clínico_licenciado	psicólogo clínico licenciado
psicólogo_consultor	psicólogo consultor
psicólogo_forense	psicólogo forense
psicólogo_licenciado	psicólogo licenciado
publicista	publicista
pós-produtor	pós-produtor
radialista	radialista
radiologista	radiologista
recepcionista	recepcionista
recrutador	recrutador
recrutador_científico	recrutador científico
recrutador_de_agência	recrutador de agência
recrutador_de_contrato	recrutador de contrato
recrutador_de_engenharia	recrutador de engenharia
recrutador_de_rh	recrutador de rh
recrutador_de_saúde	recrutador de saúde
recrutador_de_talentos	recrutador de talentos
recrutador_de_tecnologia	recrutador de tecnologia
recrutador_de_vendas	recrutador de vendas
recrutador_executivo	recrutador executivo
recrutador_financeiro	recrutador financeiro
recrutador_internacional	recrutador internacional
recrutador_interno	recrutador interno
recrutador_médico	recrutador médico
recrutador_nacional	recrutador nacional
recrutador_técnico	recrutador técnico
recrutamento_assistente_de_gerente	recrutamento assistente de gerente
recursos_executivos	recursos executivos
redator_criativo	redator criativo
redator_de_conteúdo	redator de conteúdo
redator_de_conteúdo_web	redator de conteúdo web
redator_de_contrato	redator de contrato
redator_de_marketing	redator de marketing
redator_editorial	redator editorial
redator_publicitário	redator publicitário
registrador	registrador
registrador_universitário	registrador universitário
reitor	reitor
reitor_de_admissões	reitor de admissões
relações_com_a_mídia	relações com a mídia
relações_públicas	relações públicas
representante_bancário_pessoal	representante bancário pessoal
representante_da_agência	representante da agência
representante_de_atendimento_ao_cliente	representante de atendimento ao cliente
representante_de_atendimento_ao_hóspede	representante de atendimento ao hóspede
representante_de_conta_de_publicidade	representante de conta de publicidade
representante_de_crédito	representante de crédito
representante_de_empréstimo	representante de empréstimo
representante_de_marketing	representante de marketing
representante_de_recepção	representante de recepção
representante_de_relações_públicas	representante de relações públicas
representante_de_seguro	representante de seguro
representante_de_sinistros	representante de sinistros
representante_de_sinistros_especiais	representante de sinistros especiais
representante_de_suporte_técnico	representante de suporte técnico
representante_de_suporte_técnico_ao_cliente	representante de suporte técnico ao cliente
representante_de_vendas	representante de vendas
representante_de_vendas_de_exportação	representante de vendas de exportação
representante_de_vendas_de_seguros	representante de vendas de seguros
representante_do_país	representante do país
representante_financeiro	representante financeiro
repórter_chefe	repórter chefe
repórter_de_mercado	repórter de mercado
repórter_de_televisão	repórter de televisão
repórter_de_trânsito	repórter de trânsito
repórter_esportivo	repórter esportivo
repórter_estudante	repórter estudante
residente	residente
residente_de_anestesiologia	residente de anestesiologia
residente_de_farmácia	residente de farmácia
residente_de_medicina_interna	residente de medicina interna
responsável_pela_política	responsável pela política
retocador	retocador
revisor	revisor
roteirista	roteirista
sargento	sargento
sargento_da_polícia	sargento da polícia
sargento_de_patrulha	sargento de patrulha
secretária_corporativa_adjunta	secretária corporativa adjunta
secretária_executiva_bilingue	secretária executiva bilingue
secretário_de_produção	secretário de produção
secretário_jurídico	secretário jurídico
secretário_jurídico_executivo	secretário jurídico executivo
segundo_assistente	segundo assistente
segundo_assistente_de_direção	segundo assistente de direção
segundo_companheiro	segundo companheiro
segundo_oficial	segundo oficial
segundo_subgerente	segundo subgerente
selecionador	selecionador
selecionador_de_pedidos	selecionador de pedidos
seletor_de_pedidos	seletor de pedidos
servidor	servidor
servidor_de_banquete	servidor de banquete
servidor_de_comida	servidor de comida
servidor_de_coquetéis	servidor de coquetéis
servidor_de_restaurante	servidor de restaurante
servidor_principal	servidor principal
serviço_agora_desenvolvedor	serviço agora desenvolvedor
serviços_para_clientes_particulares	serviços para clientes particulares
soldado_da_paz	soldado da paz
soldado_estadual	soldado estadual
sondador	sondador
sous_chef	sous chef
sous-chef_executivo	sous-chef executivo
subchefe_de_polícia	subchefe de polícia
subgerente_de_comunicação_corporativa	subgerente de comunicação corporativa
subprofessor	subprofessor
subscritor_de_campo	subscritor de campo
subscritor_de_crédito_ao_consumidor	subscritor de crédito ao consumidor
subscritor_de_hipoteca	subscritor de hipoteca
subscritor_de_linhas_pessoais	subscritor de linhas pessoais
subscritor_de_produção	subscritor de produção
subscritor_de_seguros	subscritor de seguros
subscritor_de_vida	subscritor de vida
superintendente_da_marinha	superintendente da marinha
superintendente_de_perfuração	superintendente de perfuração
superintendente_de_projeto	superintendente de projeto
superintendente_do_local	superintendente do local
superintendente_geral	superintendente geral
superintendente_técnico	superintendente técnico
supervisor_administrativo	supervisor administrativo
supervisor_civil	supervisor civil
supervisor_clínico	supervisor clínico
supervisor_comercial	supervisor comercial
supervisor_da_casa	supervisor da casa
supervisor_de_alimentos_e_bebidas	supervisor de alimentos e bebidas
supervisor_de_animação	supervisor de animação
supervisor_de_arte_do_grupo	supervisor de arte do grupo
supervisor_de_atendimento	supervisor de atendimento
supervisor_de_atendimento_ao_hóspede	supervisor de atendimento ao hóspede
supervisor_de_banquete	supervisor de banquete
supervisor_de_bar	supervisor de bar
supervisor_de_catering	supervisor de catering
supervisor_de_centro_de_distribuição	supervisor de centro de distribuição
supervisor_de_clínica	supervisor de clínica
supervisor_de_contas	supervisor de contas
supervisor_de_conteúdo	supervisor de conteúdo
supervisor_de_controle_de_estoque	supervisor de controle de estoque
supervisor_de_cozinha	supervisor de cozinha
supervisor_de_crédito	supervisor de crédito
supervisor_de_cópia	supervisor de cópia
supervisor_de_cópia_de_grupo	supervisor de cópia de grupo
supervisor_de_datacenter	supervisor de datacenter
supervisor_de_educação_especial	supervisor de educação especial
supervisor_de_engenharia_de_produto	supervisor de engenharia de produto
supervisor_de_estratégia	supervisor de estratégia
supervisor_de_expedição	supervisor de expedição
supervisor_de_farmácia	supervisor de farmácia
supervisor_de_fechamento	supervisor de fechamento
supervisor_de_folha_de_pagamento	supervisor de folha de pagamento
supervisor_de_front-end	supervisor de front-end
supervisor_de_imagem	supervisor de imagem
supervisor_de_implementação	supervisor de implementação
supervisor_de_infraestrutura	supervisor de infraestrutura
supervisor_de_limpeza_doméstica	supervisor de limpeza doméstica
supervisor_de_marketing_comercial	supervisor de marketing comercial
supervisor_de_mídia	supervisor de mídia
supervisor_de_mídia_digital	supervisor de mídia digital
supervisor_de_operações_aeroportuárias	supervisor de operações aeroportuárias
supervisor_de_operações_da_filial	supervisor de operações da filial
supervisor_de_perfuração	supervisor de perfuração
supervisor_de_planejamento_de_mídia	supervisor de planejamento de mídia
supervisor_de_preços	supervisor de preços
supervisor_de_publicidade	supervisor de publicidade
supervisor_de_radiologia	supervisor de radiologia
supervisor_de_recebimento	supervisor de recebimento
supervisor_de_recepção	supervisor de recepção
supervisor_de_recrutamento	supervisor de recrutamento
supervisor_de_relações_com_hóspedes	supervisor de relações com hóspedes
supervisor_de_relações_públicas	supervisor de relações públicas
supervisor_de_restaurante	supervisor de restaurante
supervisor_de_roteiro	supervisor de roteiro
supervisor_de_serviços_criativos	supervisor de serviços criativos
supervisor_de_spa	supervisor de spa
supervisor_de_suporte_ao_sistema	supervisor de suporte ao sistema
supervisor_de_suporte_técnico	supervisor de suporte técnico
supervisor_de_telecomunicações	supervisor de telecomunicações
supervisor_de_transmissão	supervisor de transmissão
supervisor_de_transporte	supervisor de transporte
supervisor_digital	supervisor digital
supervisor_editorial	supervisor editorial
supervisor_fiscal	supervisor fiscal
supervisor_geral	supervisor geral
supervisora_​​de_design_gráfico	supervisora ​​de design gráfico
supervisora_​​de_pós-produção	supervisora ​​de pós-produção
suporte_de_primeira_linha	suporte de primeira linha
suporte_para_desktop	suporte para desktop
suporte_técnico	suporte técnico
sócio_de_private_equity	sócio de private equity
sócio_fundador	sócio fundador
sócio_gerente_de_escritório	sócio gerente de escritório
sócio_limitado	sócio limitado
sócio-gerente	sócio-gerente
tecladista	tecladista
tecnologia	tecnologia
tecnólogo_da_equipe	tecnólogo da equipe
tecnólogo_de_aplicação	tecnólogo de aplicação
tecnólogo_de_desenvolvimento	tecnólogo de desenvolvimento
tecnólogo_de_desenvolvimento_de_produtos	tecnólogo de desenvolvimento de produtos
tecnólogo_de_garantia_de_qualidade	tecnólogo de garantia de qualidade
tecnólogo_de_processos	tecnólogo de processos
tecnólogo_de_produto	tecnólogo de produto
tecnólogo_em_medicina_nuclear	tecnólogo em medicina nuclear
tecnólogo_em_pesquisa_e_desenvolvimento	tecnólogo em pesquisa e desenvolvimento
tecnólogo_em_radiologia	tecnólogo em radiologia
tecnólogo_em_ultrassom	tecnólogo em ultrassom
tecnólogo_vascular	tecnólogo vascular
tenente	tenente
tenente_de_bombeiros	tenente de bombeiros
tenente_de_polícia	tenente de polícia
terapeuta	terapeuta
terapeuta_clínico	terapeuta clínico
terapeuta_de_casamento_e_familia	terapeuta de casamento e familia
terapeuta_de_casamento_e_família_licenciado	terapeuta de casamento e família licenciado
terapeuta_de_escola	terapeuta de escola
terapeuta_educacional	terapeuta educacional
testador_de_aplicativos	testador de aplicativos
torcedor	torcedor
tosador	tosador
trabalhador_de_apoio_à_família	trabalhador de apoio à família
trabalhador_de_cuidados_infantis	trabalhador de cuidados infantis
trader_de_derivativos_de_ações	trader de derivativos de ações
tradutor_de_inglês	tradutor de inglês
tradutor_espanhol	tradutor espanhol
tradutor_interno	tradutor interno
tradutor_japonês	tradutor japonês
tradutor_técnico	tradutor técnico
transportadora_rural	transportadora rural
treinador_assistente_de_força_e_condicionamento	treinador assistente de força e condicionamento
treinador_de_alfabetização	treinador de alfabetização
treinador_de_cachorro	treinador de cachorro
treinador_de_desempenho	treinador de desempenho
treinador_de_fitness	treinador de fitness
treinador_de_força_e_condicionamento	treinador de força e condicionamento
treinador_de_futebol	treinador de futebol
treinador_de_leitura	treinador de leitura
treinador_de_natação	treinador de natação
treinador_de_tecnologia	treinador de tecnologia
treinador_de_área	treinador de área
treinador_distrital	treinador distrital
treinador_executivo	treinador executivo
treinador_instrucional	treinador instrucional
treinador_pessoal	treinador pessoal
treinador_pessoal_certificado	treinador pessoal certificado
treinador_principal	treinador principal
treinador_vocal	treinador vocal
tutor_de_espanhol	tutor de espanhol
tutor_de_informática	tutor de informática
técnico	técnico
técnico_ambiental	técnico ambiental
técnico_de_TI	técnico de TI
técnico_de_anestesia	técnico de anestesia
técnico_de_arquivos	técnico de arquivos
técnico_de_atendimento	técnico de atendimento
técnico_de_automação	técnico de automação
técnico_de_aviônica	técnico de aviônica
técnico_de_bancada	técnico de bancada
técnico_de_campo	técnico de campo
técnico_de_comunicações	técnico de comunicações
técnico_de_configuração	técnico de configuração
técnico_de_controle_de_rede	técnico de controle de rede
técnico_de_cuidados_com_animais	técnico de cuidados com animais
técnico_de_desenho	técnico de desenho
técnico_de_emergência	técnico de emergência
técnico_de_emergência_médica	técnico de emergência médica
técnico_de_engenharia_civil	técnico de engenharia civil
técnico_de_farmácia_certificado	técnico de farmácia certificado
técnico_de_fotografia	técnico de fotografia
técnico_de_futebol	técnico de futebol
técnico_de_hardware	técnico de hardware
técnico_de_helpdesk	técnico de helpdesk
técnico_de_imagem_digital	técnico de imagem digital
técnico_de_implantação	técnico de implantação
técnico_de_informática	técnico de informática
técnico_de_laboratório_de_informática	técnico de laboratório de informática
técnico_de_laboratório_fotográfico	técnico de laboratório fotográfico
técnico_de_licença	técnico de licença
técnico_de_manutenção_de_equipamentos	técnico de manutenção de equipamentos
técnico_de_mídia	técnico de mídia
técnico_de_operações_de_campo	técnico de operações de campo
técnico_de_piano	técnico de piano
técnico_de_piso	técnico de piso
técnico_de_rede	técnico de rede
técnico_de_rede_de_computadores	técnico de rede de computadores
técnico_de_reparo	técnico de reparo
técnico_de_reparo_de_computador_pessoal	técnico de reparo de computador pessoal
técnico_de_suporte	técnico de suporte
técnico_de_suporte_a_aplicativos	técnico de suporte a aplicativos
técnico_de_suporte_ao_cliente	técnico de suporte ao cliente
técnico_de_suporte_ao_produto	técnico de suporte ao produto
técnico_de_suporte_ao_sistema	técnico de suporte ao sistema
técnico_de_suporte_ao_usuário	técnico de suporte ao usuário
técnico_de_suporte_de_campo	técnico de suporte de campo
técnico_de_suporte_de_informática	técnico de suporte de informática
técnico_de_suporte_de_mesa	técnico de suporte de mesa
técnico_de_suporte_de_rede	técnico de suporte de rede
técnico_de_suporte_de_software	técnico de suporte de software
técnico_de_suporte_técnico	técnico de suporte técnico
técnico_de_telecomunicações	técnico de telecomunicações
técnico_de_transmissão	técnico de transmissão
técnico_em_equipamentos_biomédicos	técnico em equipamentos biomédicos
técnico_em_informática	técnico em informática
técnico_em_mecânica	técnico em mecânica
técnico_em_radiologia	técnico em radiologia
técnico_em_saúde_comportamental	técnico em saúde comportamental
técnico_fiscal	técnico fiscal
técnico_geológico	técnico geológico
técnico_gráfico	técnico gráfico
técnico_no_local	técnico no local
técnico_sem_fio	técnico sem fio
técnico_veterinário	técnico veterinário
técnico_veterinário_registrado	técnico veterinário registrado
título_1_professor	título 1 professor
vendas_de_ações	vendas de ações
vendas_de_derivativos_de_ações	vendas de derivativos de ações
vendedor	vendedor
vendedor_de_computadores	vendedor de computadores
vendedor_eletrônico	vendedor eletrônico
vendedor_institucional	vendedor institucional
vendedor_sazonal	vendedor sazonal
vendedora_em_tempo_parcial	vendedora em tempo parcial
vice-chanceler	vice-chanceler
vice-chefe_de_polícia	vice-chefe de polícia
vice-chefe_dos_bombeiros	vice-chefe dos bombeiros
vice-conselheiro_geral	vice-conselheiro geral
vice-defensor_público	vice-defensor público
vice-diretor	vice-diretor
vice-diretor_de_criação	vice-diretor de criação
vice-diretor_de_desenvolvimento_de_negócios	vice-diretor de desenvolvimento de negócios
vice-gerente	vice-gerente
vice-presidente_assistente_de_executivo_de_contas	vice-presidente assistente de executivo de contas
vice-presidente_conselho_de_administração	vice-presidente conselho de administração
vice-presidente_executivo	vice-presidente executivo
vice-presidente_executivo_de_desenvolvimento_de_negócios	vice-presidente executivo de desenvolvimento de negócios
vice-procurador_distrital	vice-procurador distrital
vice-procurador_municipal	vice-procurador municipal
vice-reitor_de_admissões	vice-reitor de admissões
vice-secretário	vice-secretário
vice-xerife	vice-xerife
visitante_de_saúde	visitante de saúde
vocalista	vocalista
vp	vp
vp_assistente_de_subscrição	vp assistente de subscrição
vp_de_alimentos_e_bebidas	vp de alimentos e bebidas
vp_de_aquisição_de_talentos	vp de aquisição de talentos
vp_de_crédito_residencial	vp de crédito residencial
vp_de_desenvolvimento_de_negócios	vp de desenvolvimento de negócios
vp_de_desenvolvimento_organizacional	vp de desenvolvimento organizacional
vp_de_empréstimos_hipotecários	vp de empréstimos hipotecários
vp_de_gestão_de_ativos	vp de gestão de ativos
vp_de_gestão_de_talentos	vp de gestão de talentos
vp_de_operações_comerciais	vp de operações comerciais
vp_de_recrutamento	vp de recrutamento
vp_de_relações_externas	vp de relações externas
vp_de_rh_global	vp de rh global
vp_de_serviços_criativos	vp de serviços criativos
vp_de_vendas_de_ações_institucionais	vp de vendas de ações institucionais
vp_de_vendas_institucionais	vp de vendas institucionais
vp_iniciativas_estratégicas	vp iniciativas estratégicas
web_designer	web designer
web_e_designer_gráfico	web e designer gráfico
webjornalista	webjornalista
webmaster_corporativo	webmaster corporativo
xerife	xerife
zelador	zelador
zelador_principal	zelador principal
árbitro	árbitro
âncora	âncora
âncora_do_noticiário_da_manhã	âncora do noticiário da manhã
âncora_esportiva	âncora esportiva
é_generalista	é generalista
é_recrutador	é recrutador
