Abastecedor	Abastecedor
Abogado	Abogado
Abogado_Asistente	Abogado Asistente
Abogado_Internacional	Abogado Internacional
Abogado_Laboral_y_Laboral	Abogado Laboral y Laboral
Abogado_Mercantil	Abogado Mercantil
Abogado_Principal	Abogado Principal
Abogado_asistente	Abogado asistente
Abogado_asistente_de_la_corporación	Abogado asistente de la corporación
Abogado_de_Bienes_Raíces	Abogado de Bienes Raíces
Abogado_de_Defensa_Criminal	Abogado de Defensa Criminal
Abogado_de_Propiedad_Intelectual	Abogado de Propiedad Intelectual
Abogado_de_Reclamos	Abogado de Reclamos
Abogado_de_derecho_familiar	Abogado de derecho familiar
Abogado_de_empresa	Abogado de empresa
Abogado_de_impuestos	Abogado de impuestos
Abogado_del_personal	Abogado del personal
Abogado_externo	Abogado externo
Abogado_gerente	Abogado gerente
Abogado_investigador	Abogado investigador
Abogado_litigante	Abogado litigante
Accionista	Accionista
Accionista_Gerente	Accionista Gerente
Acompañante	Acompañante
Acupunturista_licenciado	Acupunturista licenciado
Administrador_de_Impuestos	Administrador de Impuestos
Administrador_de_Internet	Administrador de Internet
Administrador_de_contenido_del_sitio_web	Administrador de contenido del sitio web
Administrador_de_copias	Administrador de copias
Administrador_de_correos	Administrador de correos
Administrador_de_cuentas_por_pagar	Administrador de cuentas por pagar
Administrador_de_escritorio	Administrador de escritorio
Administrador_de_evento	Administrador de evento
Administrador_de_importación_y_exportación	Administrador de importación y exportación
Administrador_de_intercambio	Administrador de intercambio
Administrador_de_la_galería	Administrador de la galería
Administrador_de_la_mesa_de_ayuda	Administrador de la mesa de ayuda
Administrador_de_la_mesa_de_servicio	Administrador de la mesa de servicio
Administrador_de_la_propiedad	Administrador de la propiedad
Administrador_de_logística	Administrador de logística
Administrador_de_medios	Administrador de medios
Administrador_de_medios_interactivos	Administrador de medios interactivos
Administrador_de_personal	Administrador de personal
Administrador_de_portafolio	Administrador de portafolio
Administrador_de_propiedades_residenciales	Administrador de propiedades residenciales
Administrador_de_red	Administrador de red
Administrador_de_red_central	Administrador de red central
Administrador_de_red_de_área_local	Administrador de red de área local
Administrador_de_red_del_sistema	Administrador de red del sistema
Administrador_de_redes_sociales	Administrador de redes sociales
Administrador_de_seguridad	Administrador de seguridad
Administrador_de_seguridad_de_TI	Administrador de seguridad de TI
Administrador_de_seguridad_de_datos	Administrador de seguridad de datos
Administrador_de_seguridad_de_la_información	Administrador de seguridad de la información
Administrador_de_seguridad_de_red	Administrador de seguridad de red
Administrador_de_sistema	Administrador de sistema
Administrador_de_sistemas_de_Microsoft	Administrador de sistemas de Microsoft
Administrador_del_centro_de_datos	Administrador del centro de datos
Administrador_del_servidor	Administrador del servidor
Administrador_del_sitio_web	Administrador del sitio web
Agente_Logístico	Agente Logístico
Agente_comercial	Agente comercial
Agente_de_Rentas_Internas	Agente de Rentas Internas
Agente_de_alquiler	Agente de alquiler
Agente_de_bienes_raíces	Agente de bienes raíces
Agente_de_carga	Agente de carga
Agente_de_compradores	Agente de compradores
Agente_de_ingresos	Agente de ingresos
Agente_de_la_mesa_de_servicio	Agente de la mesa de servicio
Agente_de_policía	Agente de policía
Agente_de_recepción	Agente de recepción
Agente_de_referencia	Agente de referencia
Agente_de_reservas	Agente de reservas
Agente_de_seguros	Agente de seguros
Agente_de_seguros_comerciales	Agente de seguros comerciales
Agente_de_seguros_con_licencia	Agente de seguros con licencia
Agente_de_títulos	Agente de títulos
Agente_de_ventas_con_licencia	Agente de ventas con licencia
Agente_de_ventas_de_bienes_raíces	Agente de ventas de bienes raíces
Agente_de_ventas_de_reservas	Agente de ventas de reservas
Agente_de_viajes	Agente de viajes
Agente_de_viajes_corporativos	Agente de viajes corporativos
Agente_especial	Agente especial
Agente_especial_supervisor	Agente especial supervisor
Agente_exclusivo	Agente exclusivo
Agente_federal	Agente federal
Agente_hipotecario	Agente hipotecario
Agente_inmobiliario_comercial	Agente inmobiliario comercial
Agente_inmobiliario_con_licencia	Agente inmobiliario con licencia
Agente_inmobiliario_profesional	Agente inmobiliario profesional
Agente_inmobiliario_residencial	Agente inmobiliario residencial
Ajustador_de_reclamos_de_propiedad	Ajustador de reclamos de propiedad
Ajustador_de_reclamos_de_siniestros	Ajustador de reclamos de siniestros
Alguacil	Alguacil
Almacenador_durante_la_noche	Almacenador durante la noche
Ama_de_Llaves_Ejecutiva	Ama de Llaves Ejecutiva
Analista_Administrativo	Analista Administrativo
Analista_Banca_Privada	Analista Banca Privada
Analista_Comercial	Analista Comercial
Analista_Inmobiliario	Analista Inmobiliario
Analista_de_Banca_Corporativa	Analista de Banca Corporativa
Analista_de_Banca_Privada	Analista de Banca Privada
Analista_de_Banca_de_Inversión	Analista de Banca de Inversión
Analista_de_Capital_Privado	Analista de Capital Privado
Analista_de_Crédito_Corporativo	Analista de Crédito Corporativo
Analista_de_Desarrollo_Corporativo	Analista de Desarrollo Corporativo
Analista_de_Financiamiento	Analista de Financiamiento
Analista_de_Finanzas_Apalancadas	Analista de Finanzas Apalancadas
Analista_de_Finanzas_Corporativas	Analista de Finanzas Corporativas
Analista_de_Finanzas_Estructuradas	Analista de Finanzas Estructuradas
Analista_de_Fondos_Mutuos	Analista de Fondos Mutuos
Analista_de_Gestión_de_Cartera	Analista de Gestión de Cartera
Analista_de_Impuestos	Analista de Impuestos
Analista_de_Investigación_de_Crédito	Analista de Investigación de Crédito
Analista_de_Investigación_de_Mercado	Analista de Investigación de Mercado
Analista_de_Mercado_Financiero	Analista de Mercado Financiero
Analista_de_Mercado_de_Capitales	Analista de Mercado de Capitales
Analista_de_Planificación_Estratégica	Analista de Planificación Estratégica
Analista_de_Pruebas_de_Automatización	Analista de Pruebas de Automatización
Analista_de_Reclutamiento	Analista de Reclutamiento
Analista_de_Renta_Fija	Analista de Renta Fija
Analista_de_Sistemas_Asesores	Analista de Sistemas Asesores
Analista_de_Sistemas_de_Información	Analista de Sistemas de Información
Analista_de_Soporte_Informático	Analista de Soporte Informático
Analista_de_Soporte_Tecnológico	Analista de Soporte Tecnológico
Analista_de_Soporte_Técnico	Analista de Soporte Técnico
Analista_de_Soporte_de_Litigios	Analista de Soporte de Litigios
Analista_de_Valoración	Analista de Valoración
Analista_de_Verano_de_Banca_de_Inversión	Analista de Verano de Banca de Inversión
Analista_de_acciones	Analista de acciones
Analista_de_atención_al_cliente	Analista de atención al cliente
Analista_de_calificación	Analista de calificación
Analista_de_capital_de_riesgo	Analista de capital de riesgo
Analista_de_centro_de_datos	Analista de centro de datos
Analista_de_centro_de_servicio	Analista de centro de servicio
Analista_de_contenido	Analista de contenido
Analista_de_crédito	Analista de crédito
Analista_de_datos_de_mercado	Analista de datos de mercado
Analista_de_desarrollo_de_software	Analista de desarrollo de software
Analista_de_estrés	Analista de estrés
Analista_de_fondos_de_cobertura	Analista de fondos de cobertura
Analista_de_importaciones	Analista de importaciones
Analista_de_importaciones_y_exportaciones	Analista de importaciones y exportaciones
Analista_de_inteligencia_de_mercado	Analista de inteligencia de mercado
Analista_de_inversión	Analista de inversión
Analista_de_investigación_de_acciones	Analista de investigación de acciones
Analista_de_investigación_de_inversiones	Analista de investigación de inversiones
Analista_de_logística	Analista de logística
Analista_de_marca	Analista de marca
Analista_de_marketing_de_productos	Analista de marketing de productos
Analista_de_mesa_de_ayuda	Analista de mesa de ayuda
Analista_de_negocios	Analista de negocios
Analista_de_operaciones_de_red	Analista de operaciones de red
Analista_de_programación	Analista de programación
Analista_de_red	Analista de red
Analista_de_rendimiento_de_inversiones	Analista de rendimiento de inversiones
Analista_de_seguridad_de_TI	Analista de seguridad de TI
Analista_de_seguridad_de_la_información	Analista de seguridad de la información
Analista_de_seguridad_de_redes	Analista de seguridad de redes
Analista_de_sistemas	Analista de sistemas
Analista_de_sistemas_de_información_de_recursos_humanos	Analista de sistemas de información de recursos humanos
Analista_de_sistemas_de_información_del_personal	Analista de sistemas de información del personal
Analista_de_sistemas_operativos	Analista de sistemas operativos
Analista_de_soporte_al_cliente	Analista de soporte al cliente
Analista_de_soporte_de_campo	Analista de soporte de campo
Analista_de_soporte_de_escritorio	Analista de soporte de escritorio
Analista_de_soporte_de_mesa_de_ayuda	Analista de soporte de mesa de ayuda
Analista_de_soporte_de_red	Analista de soporte de red
Analista_de_soporte_de_segunda_línea	Analista de soporte de segunda línea
Analista_de_soporte_de_software	Analista de soporte de software
Analista_de_tecnología	Analista de tecnología
Analista_del_centro_de_operaciones_de_red	Analista del centro de operaciones de red
Analista_del_centro_de_soporte	Analista del centro de soporte
Analista_financiero	Analista financiero
Analista_financiero_autorizado	Analista financiero autorizado
Ancla	Ancla
Anestesiólogo_de_planta	Anestesiólogo de planta
Anfitrión	Anfitrión
Animador	Animador
Animador_Flash	Animador Flash
Animador_Técnico	Animador Técnico
Animador_de_personajes	Animador de personajes
Animador_de_personajes_3D	Animador de personajes 3D
Animador_por_computadora	Animador por computadora
Aparejador_de_personajes	Aparejador de personajes
Apoyo_técnico	Apoyo técnico
Aprendiz_de_Ingeniería_de_Software	Aprendiz de Ingeniería de Software
Aprovisionador_de_red	Aprovisionador de red
Archivero_del_proyecto	Archivero del proyecto
Archivista_asistente	Archivista asistente
Arquitecto	Arquitecto
Arquitecto_Asistente	Arquitecto Asistente
Arquitecto_Graduado	Arquitecto Graduado
Arquitecto_Intermedio	Arquitecto Intermedio
Arquitecto_Java	Arquitecto Java
Arquitecto_Técnico	Arquitecto Técnico
Arquitecto_de_Diseño	Arquitecto de Diseño
Arquitecto_de_red	Arquitecto de red
Arquitecto_de_tecnología	Arquitecto de tecnología
Arquitecto_paisajista	Arquitecto paisajista
Arquitecto_paisajista_principal	Arquitecto paisajista principal
Artista	Artista
Artista_3D	Artista 3D
Artista_Profesional	Artista Profesional
Artista_Residente	Artista Residente
Artista_ambiental_3D	Artista ambiental 3D
Artista_conceptual	Artista conceptual
Artista_creativo	Artista creativo
Artista_de_Producción_Gráfica	Artista de Producción Gráfica
Artista_de_animación	Artista de animación
Artista_de_desarrollo_visual	Artista de desarrollo visual
Artista_de_diseño_gráfico	Artista de diseño gráfico
Artista_de_efectos_visuales	Artista de efectos visuales
Artista_de_estudio	Artista de estudio
Artista_de_grabación	Artista de grabación
Artista_de_la_llama	Artista de la llama
Artista_de_maquetación	Artista de maquetación
Artista_de_personajes	Artista de personajes
Artista_de_pintura	Artista de pintura
Artista_de_producción	Artista de producción
Artista_de_textura	Artista de textura
Artista_del_juego	Artista del juego
Artista_en_residencia	Artista en residencia
Artista_grafico	Artista grafico
Artista_gráfico_por_computadora	Artista gráfico por computadora
Artista_intérprete_o_ejecutante	Artista intérprete o ejecutante
Artista_invitado	Artista invitado
Artista_técnico	Artista técnico
Artista_visual	Artista visual
Asesor_Bancario_Personal	Asesor Bancario Personal
Asesor_Jurídico_Principal	Asesor Jurídico Principal
Asesor_Legal_del_Grupo	Asesor Legal del Grupo
Asesor_de_estudios_en_el_extranjero	Asesor de estudios en el extranjero
Asesor_regulatorio	Asesor regulatorio
Asesoría_Legal_Corporativa	Asesoría Legal Corporativa
Asistente_Arquitectónico	Asistente Arquitectónico
Asistente_Banca_Privada	Asistente Banca Privada
Asistente_Legal_Corporativo	Asistente Legal Corporativo
Asistente_Personal_Jurídico	Asistente Personal Jurídico
Asistente_Psicologico	Asistente Psicologico
Asistente_articulado	Asistente articulado
Asistente_de_Diseño_Gráfico	Asistente de Diseño Gráfico
Asistente_de_Educación_Especial	Asistente de Educación Especial
Asistente_de_Enfermería_Certificado	Asistente de Enfermería Certificado
Asistente_de_Fotógrafos	Asistente de Fotógrafos
Asistente_de_Gerente_Nocturno	Asistente de Gerente Nocturno
Asistente_de_Gerente_de_Cocina	Asistente de Gerente de Cocina
Asistente_de_Gerente_de_Ingresos	Asistente de Gerente de Ingresos
Asistente_de_Gerente_de_Interfaz	Asistente de Gerente de Interfaz
Asistente_de_Gerente_de_Inversiones	Asistente de Gerente de Inversiones
Asistente_de_Gerente_de_Marca	Asistente de Gerente de Marca
Asistente_de_Gerente_de_Mercado	Asistente de Gerente de Mercado
Asistente_de_Gerente_de_Relaciones	Asistente de Gerente de Relaciones
Asistente_de_Gerente_de_Reservas	Asistente de Gerente de Reservas
Asistente_de_Instrucción_de_Educación_Especial	Asistente de Instrucción de Educación Especial
Asistente_de_Litigios	Asistente de Litigios
Asistente_de_Post_Producción	Asistente de Post Producción
Asistente_de_Proyecto	Asistente de Proyecto
Asistente_de_Publicaciones	Asistente de Publicaciones
Asistente_de_Reclutamiento_de_Recursos_Humanos	Asistente de Reclutamiento de Recursos Humanos
Asistente_de_Relaciones_Comunitarias	Asistente de Relaciones Comunitarias
Asistente_de_Trade_Marketing	Asistente de Trade Marketing
Asistente_de_VP_de_Ejecutivo_de_Cuentas	Asistente de VP de Ejecutivo de Cuentas
Asistente_de_analista_de_sistemas	Asistente de analista de sistemas
Asistente_de_archivos	Asistente de archivos
Asistente_de_barra	Asistente de barra
Asistente_de_cocina	Asistente de cocina
Asistente_de_cuidado_de_niños	Asistente de cuidado de niños
Asistente_de_cámara	Asistente de cámara
Asistente_de_depósito_en_garantía	Asistente de depósito en garantía
Asistente_de_desarrollo_de_productos	Asistente de desarrollo de productos
Asistente_de_diseñador	Asistente de diseñador
Asistente_de_diseñador_técnico	Asistente de diseñador técnico
Asistente_de_diseño	Asistente de diseño
Asistente_de_enfermería	Asistente de enfermería
Asistente_de_fotógrafo	Asistente de fotógrafo
Asistente_de_galería	Asistente de galería
Asistente_de_importación_y_exportación	Asistente de importación y exportación
Asistente_de_ingeniero_de_diseño	Asistente de ingeniero de diseño
Asistente_de_investigación	Asistente de investigación
Asistente_de_perrera	Asistente de perrera
Asistente_de_planificación_de_eventos	Asistente de planificación de eventos
Asistente_de_producción_de_escenarios	Asistente de producción de escenarios
Asistente_de_producción_de_oficina	Asistente de producción de oficina
Asistente_de_préstamos_comerciales	Asistente de préstamos comerciales
Asistente_de_salud	Asistente de salud
Asistente_de_telecomunicaciones	Asistente de telecomunicaciones
Asistente_de_transmisión	Asistente de transmisión
Asistente_de_ventas_locales	Asistente de ventas locales
Asistente_de_ventas_minoristas	Asistente de ventas minoristas
Asistente_de_vuelo_corporativo	Asistente de vuelo corporativo
Asistente_del_Defensor_Público	Asistente del Defensor Público
Asistente_del_Fiscal_General	Asistente del Fiscal General
Asistente_del_Jefe_de_Policía	Asistente del Jefe de Policía
Asistente_del_administrador_de_contenido	Asistente del administrador de contenido
Asistente_del_chef	Asistente del chef
Asistente_del_director_del_servicio_de_alimentos	Asistente del director del servicio de alimentos
Asistente_del_fiscal_de_distrito	Asistente del fiscal de distrito
Asistente_del_fiscal_del_condado	Asistente del fiscal del condado
Asistente_del_piloto_principal	Asistente del piloto principal
Asistente_dental_registrado	Asistente dental registrado
Asistente_editorial	Asistente editorial
Asistente_legal_de_verano	Asistente legal de verano
Asistente_médico	Asistente médico
Asistente_personal_del_gerente_general	Asistente personal del gerente general
Asistente_principal	Asistente principal
Asistente_veterinario	Asistente veterinario
Asociado	Asociado
Asociado_Arquitectónico	Asociado Arquitectónico
Asociado_Graduado	Asociado Graduado
Asociado_Hipotecario	Asociado Hipotecario
Asociado_Legal	Asociado Legal
Asociado_Temporal	Asociado Temporal
Asociado_Walmart	Asociado Walmart
Asociado_comercial	Asociado comercial
Asociado_de_Bienes_Raíces	Asociado de Bienes Raíces
Asociado_de_Capital_Privado	Asociado de Capital Privado
Asociado_de_Comunicaciones_Corporativas	Asociado de Comunicaciones Corporativas
Asociado_de_Desarrollo_Corporativo	Asociado de Desarrollo Corporativo
Asociado_de_Desarrollo_de_Negocios	Asociado de Desarrollo de Negocios
Asociado_de_Gestión_de_Riesgos	Asociado de Gestión de Riesgos
Asociado_de_Litigios	Asociado de Litigios
Asociado_de_Logística	Asociado de Logística
Asociado_de_Marketing_y_Comunicaciones	Asociado de Marketing y Comunicaciones
Asociado_de_Reclamos	Asociado de Reclamos
Asociado_de_Reclutamiento	Asociado de Reclutamiento
Asociado_de_Relaciones_Públicas	Asociado de Relaciones Públicas
Asociado_de_Relaciones_con_Inversionistas	Asociado de Relaciones con Inversionistas
Asociado_de_Relaciones_con_los_Medios	Asociado de Relaciones con los Medios
Asociado_de_Servicios_al_Huésped	Asociado de Servicios al Huésped
Asociado_de_Tesorería	Asociado de Tesorería
Asociado_de_Transportistas_Rurales	Asociado de Transportistas Rurales
Asociado_de_acciones	Asociado de acciones
Asociado_de_almacén	Asociado de almacén
Asociado_de_banca_de_inversión	Asociado de banca de inversión
Asociado_de_bienes_raíces	Asociado de bienes raíces
Asociado_de_cartera	Asociado de cartera
Asociado_de_casting	Asociado de casting
Asociado_de_colecciones	Asociado de colecciones
Asociado_de_cuidado_de_animales	Asociado de cuidado de animales
Asociado_de_desarrollo_de_productos	Asociado de desarrollo de productos
Asociado_de_impuestos	Asociado de impuestos
Asociado_de_investigación_de_acciones	Asociado de investigación de acciones
Asociado_de_la_galería	Asociado de la galería
Asociado_de_medios	Asociado de medios
Asociado_de_mostrador	Asociado de mostrador
Asociado_de_probadores	Asociado de probadores
Asociado_de_recepción	Asociado de recepción
Asociado_de_relación_con_el_cliente	Asociado de relación con el cliente
Asociado_de_servicios_financieros	Asociado de servicios financieros
Asociado_de_servicios_para_miembros	Asociado de servicios para miembros
Asociado_de_soporte_técnico	Asociado de soporte técnico
Asociado_de_tienda_de_regalos	Asociado de tienda de regalos
Asociado_de_transmisión	Asociado de transmisión
Asociado_de_valoración	Asociado de valoración
Asociado_de_ventas	Asociado de ventas
Asociado_de_ventas_a_tiempo_parcial	Asociado de ventas a tiempo parcial
Asociado_de_ventas_de_bienes_raíces	Asociado de ventas de bienes raíces
Asociado_de_ventas_de_computadoras	Asociado de ventas de computadoras
Asociado_de_ventas_de_temporada	Asociado de ventas de temporada
Asociado_de_ventas_electrónicas	Asociado de ventas electrónicas
Asociado_extranjero	Asociado extranjero
Atención_al_cliente_del_cajero	Atención al cliente del cajero
Atleta_profesional	Atleta profesional
Auditor	Auditor
Auditor_nocturno	Auditor nocturno
Auxiliar_de_vuelo	Auxiliar de vuelo
Aviador	Aviador
Ayudante_de_mesero	Ayudante de mesero
Ayudante_de_pastelero	Ayudante de pastelero
Ayudante_del_profesor	Ayudante del profesor
Ayudante_del_sheriff	Ayudante del sheriff
Ayudante_legal	Ayudante legal
Bailarin_profesional	Bailarin profesional
Bajista	Bajista
Banquero_hipotecario_privado	Banquero hipotecario privado
Banquero_preferido	Banquero preferido
Barbero	Barbero
Barman	Barman
Batería	Batería
Becaria_de_Diseño_y_Producción	Becaria de Diseño y Producción
Becaria_de_Post_Producción	Becaria de Post Producción
Becaria_de_dirección_de_arte	Becaria de dirección de arte
Becario_de_cardiología	Becario de cardiología
Bibliotecario_de_Servicios_Públicos	Bibliotecario de Servicios Públicos
Bibliotecario_de_medios	Bibliotecario de medios
Bodega_operativa	Bodega operativa
Bombero	Bombero
Buen_artista	Buen artista
Cajero	Cajero
Cajero_principal	Cajero principal
Camarero_jefe	Camarero jefe
Camarógrafo	Camarógrafo
Camarógrafo_de_iluminación	Camarógrafo de iluminación
Campeón_de_producto	Campeón de producto
Candidato_a_MBA	Candidato a MBA
Cantante	Cantante
Cantante_de_opera	Cantante de opera
Cantante_profesional	Cantante profesional
Capataz	Capataz
Capataz_de_construcción	Capataz de construcción
Capataz_de_proyecto	Capataz de proyecto
Capitán	Capitán
Capitán_de_banquetes	Capitán de banquetes
Capitán_de_entrenamiento	Capitán de entrenamiento
Cardiólogo	Cardiólogo
Cargador	Cargador
Cartero_de_la_ciudad	Cartero de la ciudad
Chef_Ejecutivo_Corporativo	Chef Ejecutivo Corporativo
Chef_ejecutivo	Chef ejecutivo
Chef_pastelero_ejecutivo	Chef pastelero ejecutivo
Chef_privado	Chef privado
Científico_ambiental	Científico ambiental
Científico_de_Investigación_y_Desarrollo	Científico de Investigación y Desarrollo
Científico_de_comida	Científico de comida
Cineasta	Cineasta
Cirujano	Cirujano
Cirujano_Oral_y_Maxilofacial	Cirujano Oral y Maxilofacial
Cirujano_de_Veterinaria	Cirujano de Veterinaria
Clasificador	Clasificador
Coanfitrión_del_programa_matutino	Coanfitrión del programa matutino
Cocinar	Cocinar
Cocinero	Cocinero
Cocinero_Corporativo	Cocinero Corporativo
Cocinero_asistente	Cocinero asistente
Cocinero_de_línea	Cocinero de línea
Cocinero_personal	Cocinero personal
Cocinero_principal	Cocinero principal
Columnista	Columnista
Comerciante	Comerciante
Comerciante_de_acciones_por_cuenta_propia	Comerciante de acciones por cuenta propia
Comerciante_de_arte	Comerciante de arte
Comerciante_de_divisas	Comerciante de divisas
Comerciante_de_opciones	Comerciante de opciones
Comerciante_de_opciones_de_acciones	Comerciante de opciones de acciones
Comerciante_de_ventas	Comerciante de ventas
Comerciante_de_ventas_de_acciones	Comerciante de ventas de acciones
Comerciante_principal	Comerciante principal
Comisario_de_exposiciones	Comisario de exposiciones
Compañero	Compañero
Compañero_limitado	Compañero limitado
Compañía_de_software	Compañía de software
Compositor	Compositor
Compositor_de_canciones	Compositor de canciones
Compositor_de_cine	Compositor de cine
Compositor_musical	Compositor musical
Comprador_de_transmisión	Comprador de transmisión
Comunicaciones_Estratégicas	Comunicaciones Estratégicas
Conductor	Conductor
Conductor_de_carretera	Conductor de carretera
Conductor_de_la_empresa	Conductor de la empresa
Conductor_profesional	Conductor profesional
Conferenciante	Conferenciante
Consejero	Consejero
Consejero_Clínico	Consejero Clínico
Consejero_Delegado	Consejero Delegado
Consejero_Jefe_Adjunto	Consejero Jefe Adjunto
Consejero_Legal	Consejero Legal
Consejero_Profesional_Clínico_Licenciado	Consejero Profesional Clínico Licenciado
Consejero_Profesional_Licenciado	Consejero Profesional Licenciado
Consejero_Regional	Consejero Regional
Consejero_de_Educación	Consejero de Educación
Consejero_de_Ventas_de_Casas_Nuevas	Consejero de Ventas de Casas Nuevas
Consejero_de_belleza	Consejero de belleza
Consejero_de_campamento_de_verano	Consejero de campamento de verano
Consejero_de_campamento_diurno	Consejero de campamento diurno
Consejero_de_escuela_primaria	Consejero de escuela primaria
Consejero_de_extensión	Consejero de extensión
Consejero_de_la_facultad	Consejero de la facultad
Consejero_de_salud_mental	Consejero de salud mental
Consejero_de_salud_mental_con_licencia	Consejero de salud mental con licencia
Consejero_de_viajes	Consejero de viajes
Consejero_familiar	Consejero familiar
Consejero_general_adjunto	Consejero general adjunto
Consejero_legal	Consejero legal
Consejo	Consejo
Consejo_Corporativo	Consejo Corporativo
Conserje	Conserje
Constructor	Constructor
Consultor	Consultor
Consultor_Estratégico_de_Negocios	Consultor Estratégico de Negocios
Consultor_Inalámbrico	Consultor Inalámbrico
Consultor_Java	Consultor Java
Consultor_Jurídico_Extranjero	Consultor Jurídico Extranjero
Consultor_Logístico	Consultor Logístico
Consultor_de_Automatización	Consultor de Automatización
Consultor_de_Bienes_Raíces_Comerciales	Consultor de Bienes Raíces Comerciales
Consultor_de_Desarrollo_Organizacional	Consultor de Desarrollo Organizacional
Consultor_de_Desarrollo_de_Liderazgo	Consultor de Desarrollo de Liderazgo
Consultor_de_Desarrollo_de_Negocios	Consultor de Desarrollo de Negocios
Consultor_de_Desarrollo_de_Negocios_Internacionales	Consultor de Desarrollo de Negocios Internacionales
Consultor_de_Gestión_del_Talento	Consultor de Gestión del Talento
Consultor_de_Impuestos_Corporativos	Consultor de Impuestos Corporativos
Consultor_de_Ingeniería_Mecánica	Consultor de Ingeniería Mecánica
Consultor_de_Membresía	Consultor de Membresía
Consultor_de_Reclutamiento	Consultor de Reclutamiento
Consultor_de_Reclutamiento_Legal	Consultor de Reclutamiento Legal
Consultor_de_Reclutamiento_Permanente	Consultor de Reclutamiento Permanente
Consultor_de_Reclutamiento_de_TI	Consultor de Reclutamiento de TI
Consultor_de_Relaciones_Públicas	Consultor de Relaciones Públicas
Consultor_de_Salud_Mental	Consultor de Salud Mental
Consultor_de_Suscripción	Consultor de Suscripción
Consultor_de_TI	Consultor de TI
Consultor_de_Telecomunicaciones	Consultor de Telecomunicaciones
Consultor_de_acondicionamiento_físico	Consultor de acondicionamiento físico
Consultor_de_arte	Consultor de arte
Consultor_de_automatización_de_pruebas	Consultor de automatización de pruebas
Consultor_de_bodas	Consultor de bodas
Consultor_de_bronceado	Consultor de bronceado
Consultor_de_búsqueda	Consultor de búsqueda
Consultor_de_búsqueda_de_ejecutivos	Consultor de búsqueda de ejecutivos
Consultor_de_casas_nuevas	Consultor de casas nuevas
Consultor_de_colocación	Consultor de colocación
Consultor_de_comunicaciones	Consultor de comunicaciones
Consultor_de_decoración	Consultor de decoración
Consultor_de_diseño_de_producto	Consultor de diseño de producto
Consultor_de_diseño_de_redes	Consultor de diseño de redes
Consultor_de_diseño_gráfico	Consultor de diseño gráfico
Consultor_de_estilo	Consultor de estilo
Consultor_de_estrategia	Consultor de estrategia
Consultor_de_eventos	Consultor de eventos
Consultor_de_idiomas	Consultor de idiomas
Consultor_de_impuestos	Consultor de impuestos
Consultor_de_ingeniería_de_redes	Consultor de ingeniería de redes
Consultor_de_litigios	Consultor de litigios
Consultor_de_marketing	Consultor de marketing
Consultor_de_marketing_en_redes_sociales	Consultor de marketing en redes sociales
Consultor_de_negocios	Consultor de negocios
Consultor_de_perforación	Consultor de perforación
Consultor_de_procesos	Consultor de procesos
Consultor_de_préstamos_hipotecarios	Consultor de préstamos hipotecarios
Consultor_de_recaudación_de_fondos	Consultor de recaudación de fondos
Consultor_de_recursos_humanos	Consultor de recursos humanos
Consultor_de_red	Consultor de red
Consultor_de_redes_de_datos	Consultor de redes de datos
Consultor_de_seguridad_de_redes	Consultor de seguridad de redes
Consultor_de_seguros	Consultor de seguros
Consultor_de_software	Consultor de software
Consultor_de_ventas_de_casas_nuevas	Consultor de ventas de casas nuevas
Consultor_de_viajes_internacionales	Consultor de viajes internacionales
Consultor_editorial	Consultor editorial
Consultor_en_Gestión_Empresarial	Consultor en Gestión Empresarial
Consultor_en_administración	Consultor en administración
Consultor_hipotecario_de_vivienda	Consultor hipotecario de vivienda
Consultor_inmobiliario	Consultor inmobiliario
Consultor_marino	Consultor marino
Consultor_musical	Consultor musical
Consultora_de_Adquisición_de_Talento	Consultora de Adquisición de Talento
Consultora_de_Mercadeo_y_Relaciones_Públicas	Consultora de Mercadeo y Relaciones Públicas
Consultora_de_Relaciones_Públicas_y_Comunicaciones	Consultora de Relaciones Públicas y Comunicaciones
Consultora_de_moda	Consultora de moda
Contable	Contable
Contador	Contador
Contador_Intermedio	Contador Intermedio
Contador_Principal	Contador Principal
Contador_Profesional	Contador Profesional
Contador_Público_certificado	Contador Público certificado
Contador_Temporal	Contador Temporal
Contador_auxiliar_de_gestión	Contador auxiliar de gestión
Contador_de_clientes	Contador de clientes
Contador_de_impuestos_de_nómina	Contador de impuestos de nómina
Contador_de_impuestos_del_personal	Contador de impuestos del personal
Contador_de_la_propiedad	Contador de la propiedad
Contador_del_personal	Contador del personal
Contratista	Contratista
Contratista_general	Contratista general
Contribuyente	Contribuyente
Controlador_de_Logística	Controlador de Logística
Controlador_de_Riesgos	Controlador de Riesgos
Controlador_de_producto	Controlador de producto
Controlador_de_transmisión	Controlador de transmisión
Coordinador_Atlético	Coordinador Atlético
Coordinador_Comercial	Coordinador Comercial
Coordinador_Deportivo	Coordinador Deportivo
Coordinador_Editorial	Coordinador Editorial
Coordinador_Importación_Exportación	Coordinador Importación Exportación
Coordinador_Jurídico	Coordinador Jurídico
Coordinador_certificado_de_investigación_clínica	Coordinador certificado de investigación clínica
Coordinador_de_Alianzas	Coordinador de Alianzas
Coordinador_de_Automatización	Coordinador de Automatización
Coordinador_de_Catering	Coordinador de Catering
Coordinador_de_Colocación_de_Estudiantes	Coordinador de Colocación de Estudiantes
Coordinador_de_Compensaciones_y_Beneficios	Coordinador de Compensaciones y Beneficios
Coordinador_de_Comunicaciones	Coordinador de Comunicaciones
Coordinador_de_Comunicaciones_Internas	Coordinador de Comunicaciones Internas
Coordinador_de_Desarrollo_de_Fondos	Coordinador de Desarrollo de Fondos
Coordinador_de_Diseño	Coordinador de Diseño
Coordinador_de_Diseño_Gráfico	Coordinador de Diseño Gráfico
Coordinador_de_Envíos_y_Recepción	Coordinador de Envíos y Recepción
Coordinador_de_Investigación_Clínica	Coordinador de Investigación Clínica
Coordinador_de_Logística	Coordinador de Logística
Coordinador_de_Logística_Internacional	Coordinador de Logística Internacional
Coordinador_de_Manejo_de_Emergencias	Coordinador de Manejo de Emergencias
Coordinador_de_Mejora_del_Desempeño	Coordinador de Mejora del Desempeño
Coordinador_de_Mercadeo_en_Internet	Coordinador de Mercadeo en Internet
Coordinador_de_Nómina_y_Beneficios	Coordinador de Nómina y Beneficios
Coordinador_de_Post_Producción	Coordinador de Post Producción
Coordinador_de_Producción_Publicitaria	Coordinador de Producción Publicitaria
Coordinador_de_Préstamos_Hipotecarios	Coordinador de Préstamos Hipotecarios
Coordinador_de_Publicidad	Coordinador de Publicidad
Coordinador_de_Recursos_Humanos	Coordinador de Recursos Humanos
Coordinador_de_Relaciones_con_Donantes	Coordinador de Relaciones con Donantes
Coordinador_de_Relaciones_con_los_Huéspedes	Coordinador de Relaciones con los Huéspedes
Coordinador_de_Reservas	Coordinador de Reservas
Coordinador_de_Servicio_de_Campo	Coordinador de Servicio de Campo
Coordinador_de_Servicios_al_Huésped	Coordinador de Servicios al Huésped
Coordinador_de_Servicios_de_Mercadeo	Coordinador de Servicios de Mercadeo
Coordinador_de_Soporte_Técnico	Coordinador de Soporte Técnico
Coordinador_de_Telecomunicaciones	Coordinador de Telecomunicaciones
Coordinador_de_Transición	Coordinador de Transición
Coordinador_de_acondicionamiento_físico	Coordinador de acondicionamiento físico
Coordinador_de_banquetes	Coordinador de banquetes
Coordinador_de_bodas	Coordinador de bodas
Coordinador_de_convenciones	Coordinador de convenciones
Coordinador_de_estudios_de_investigación	Coordinador de estudios de investigación
Coordinador_de_eventos	Coordinador de eventos
Coordinador_de_galería	Coordinador de galería
Coordinador_de_giras	Coordinador de giras
Coordinador_de_hospitalidad	Coordinador de hospitalidad
Coordinador_de_importaciones	Coordinador de importaciones
Coordinador_de_mesa_de_ayuda	Coordinador de mesa de ayuda
Coordinador_de_políticas	Coordinador de políticas
Coordinador_de_precios	Coordinador de precios
Coordinador_de_preimpresión	Coordinador de preimpresión
Coordinador_de_produccion	Coordinador de produccion
Coordinador_de_producción_de_impresión	Coordinador de producción de impresión
Coordinador_de_préstamos	Coordinador de préstamos
Coordinador_de_publicaciones	Coordinador de publicaciones
Coordinador_de_recaudación_de_fondos	Coordinador de recaudación de fondos
Coordinador_de_salón	Coordinador de salón
Coordinador_de_servicios_de_conferencias	Coordinador de servicios de conferencias
Coordinador_de_traducción	Coordinador de traducción
Coordinador_de_transmisiones	Coordinador de transmisiones
Coordinador_del_Departamento_de_Arte	Coordinador del Departamento de Arte
Coordinador_del_Programa_Académico	Coordinador del Programa Académico
Coordinador_del_programa_de_posgrado	Coordinador del programa de posgrado
Coordinadora_de_Comunicaciones_Corporativas	Coordinadora de Comunicaciones Corporativas
Coordinadora_de_Marketing_y_Comunicaciones	Coordinadora de Marketing y Comunicaciones
Coordinadora_de_Moda	Coordinadora de Moda
Coordinadora_de_Reclutamiento_de_Recursos_Humanos	Coordinadora de Reclutamiento de Recursos Humanos
Coordinadora_de_Relaciones_Públicas	Coordinadora de Relaciones Públicas
Coordinadora_de_Relaciones_Públicas_y_Comunicaciones	Coordinadora de Relaciones Públicas y Comunicaciones
Coordinadora_de_Reservas_de_Grupos	Coordinadora de Reservas de Grupos
Coordinadora_de_Trade_Marketing	Coordinadora de Trade Marketing
Coordinadora_de_conferencias_y_eventos	Coordinadora de conferencias y eventos
Coreógrafo	Coreógrafo
Corporal	Corporal
Corrector_de_pruebas	Corrector de pruebas
Corredor	Corredor
Corredor_administrador	Corredor administrador
Corredor_afiliado	Corredor afiliado
Corredor_asociado_de_ventas	Corredor asociado de ventas
Corredor_de_Bienes_Raíces_Asociado_con_Licencia	Corredor de Bienes Raíces Asociado con Licencia
Corredor_de_Reaseguros	Corredor de Reaseguros
Corredor_de_barcos	Corredor de barcos
Corredor_de_derivados	Corredor de derivados
Corredor_de_derivados_de_acciones	Corredor de derivados de acciones
Corredor_de_futuros	Corredor de futuros
Corredor_de_hipotecas_con_licencia	Corredor de hipotecas con licencia
Corredor_de_seguros_comerciales	Corredor de seguros comerciales
Corredor_designado	Corredor designado
Corresponsal_Nacional	Corresponsal Nacional
Corresponsal_Principal	Corresponsal Principal
Creador_de_patrones	Creador de patrones
Criador	Criador
Cuidador_de_mascotas	Cuidador de mascotas
Cuidador_de_niños	Cuidador de niños
Cuidador_infantil	Cuidador infantil
Curador	Curador
Curador_jefe	Curador jefe
Custodio_principal	Custodio principal
Cómoda	Cómoda
Decano	Decano
Decano_de_Admisiones	Decano de Admisiones
Defensor	Defensor
Defensor_Público_Adjunto	Defensor Público Adjunto
Defensor_del_cliente	Defensor del cliente
Departamento_de_importación	Departamento de importación
Dependiente	Dependiente
Desarrollador	Desarrollador
Desarrollador_Html5	Desarrollador Html5
Desarrollador_J2Ee	Desarrollador J2Ee
Desarrollador_Java	Desarrollador Java
Desarrollador_Java_por_contrato	Desarrollador Java por contrato
Desarrollador_Java/J2Ee	Desarrollador Java/J2Ee
Desarrollador_Web_Java	Desarrollador Web Java
Desarrollador_Web_Php	Desarrollador Web Php
Desarrollador_back-end	Desarrollador back-end
Desarrollador_creativo	Desarrollador creativo
Desarrollador_de_Android	Desarrollador de Android
Desarrollador_de_aplicaciones	Desarrollador de aplicaciones
Desarrollador_de_aplicaciones_Java	Desarrollador de aplicaciones Java
Desarrollador_de_aplicaciones_de_software	Desarrollador de aplicaciones de software
Desarrollador_de_aplicaciones_iOS	Desarrollador de aplicaciones iOS
Desarrollador_de_aplicaciones_móviles	Desarrollador de aplicaciones móviles
Desarrollador_de_aplicaciones_web	Desarrollador de aplicaciones web
Desarrollador_de_automatización	Desarrollador de automatización
Desarrollador_de_base_de_datos	Desarrollador de base de datos
Desarrollador_de_conceptos	Desarrollador de conceptos
Desarrollador_de_contenido	Desarrollador de contenido
Desarrollador_de_código_abierto	Desarrollador de código abierto
Desarrollador_de_hardware	Desarrollador de hardware
Desarrollador_de_herramientas	Desarrollador de herramientas
Desarrollador_de_interfaz_de_usuario_web	Desarrollador de interfaz de usuario web
Desarrollador_de_negocios	Desarrollador de negocios
Desarrollador_de_personal	Desarrollador de personal
Desarrollador_de_producto	Desarrollador de producto
Desarrollador_de_soluciones	Desarrollador de soluciones
Desarrollador_del_lado_del_cliente	Desarrollador del lado del cliente
Desarrollador_interactivo	Desarrollador interactivo
Desarrollador_web_por_contrato	Desarrollador web por contrato
Despachador	Despachador
Despachador_de_emergencia	Despachador de emergencia
Detective_policial	Detective policial
Diagnóstico_Educativo	Diagnóstico Educativo
Dibujante_Civil	Dibujante Civil
Director	Director
Director_Comercial	Director Comercial
Director_General_Adjunto	Director General Adjunto
Director_Médico_Ejecutivo	Director Médico Ejecutivo
Director_Regional_de_Prevención_de_Pérdidas	Director Regional de Prevención de Pérdidas
Director_Técnico_de_Arte	Director Técnico de Arte
Director_Técnico_de_Personajes	Director Técnico de Personajes
Director_artistico	Director artistico
Director_creativo_adjunto	Director creativo adjunto
Director_creativo_ejecutivo	Director creativo ejecutivo
Director_creativo_principal	Director creativo principal
Director_de_Admisiones	Director de Admisiones
Director_de_Adquisición_de_Talento	Director de Adquisición de Talento
Director_de_Alimentos_y_Bebidas	Director de Alimentos y Bebidas
Director_de_Asociaciones_Corporativas	Director de Asociaciones Corporativas
Director_de_Asuntos_Legales	Director de Asuntos Legales
Director_de_Banca_Corporativa	Director de Banca Corporativa
Director_de_Búsqueda_Ejecutiva	Director de Búsqueda Ejecutiva
Director_de_Crédito	Director de Crédito
Director_de_Desarrollo_Estratégico	Director de Desarrollo Estratégico
Director_de_Desarrollo_de_Negocios	Director de Desarrollo de Negocios
Director_de_Desarrollo_de_Talento	Director de Desarrollo de Talento
Director_de_Desarrollo_y_Relaciones_Públicas	Director de Desarrollo y Relaciones Públicas
Director_de_Diseño_y_Desarrollo	Director de Diseño y Desarrollo
Director_de_Educación_Médica	Director de Educación Médica
Director_de_Entrenamiento_Personal	Director de Entrenamiento Personal
Director_de_Estrategia_y_Operaciones	Director de Estrategia y Operaciones
Director_de_Eventos_Especiales	Director de Eventos Especiales
Director_de_Finanzas_Estructuradas	Director de Finanzas Estructuradas
Director_de_Fisioterapia	Director de Fisioterapia
Director_de_Gestión_de_Inscripciones	Director de Gestión de Inscripciones
Director_de_Impuestos	Director de Impuestos
Director_de_Ingeniería_Eléctrica	Director de Ingeniería Eléctrica
Director_de_Inscripción	Director de Inscripción
Director_de_Inteligencia_de_Mercado	Director de Inteligencia de Mercado
Director_de_Investigaciones	Director de Investigaciones
Director_de_Limpieza	Director de Limpieza
Director_de_Litigios	Director de Litigios
Director_de_Operaciones	Director de Operaciones
Director_de_Operaciones_Comerciales	Director de Operaciones Comerciales
Director_de_Operaciones_de_Producción	Director de Operaciones de Producción
Director_de_Operaciones_de_Vuelo	Director de Operaciones de Vuelo
Director_de_Personal	Director de Personal
Director_de_Post_Producción	Director de Post Producción
Director_de_Preconstrucción	Director de Preconstrucción
Director_de_Producción_de_Radiodifusión	Director de Producción de Radiodifusión
Director_de_Préstamos	Director de Préstamos
Director_de_Radiología	Director de Radiología
Director_de_Reclutamiento	Director de Reclutamiento
Director_de_Redes_Sociales	Director de Redes Sociales
Director_de_Relaciones_Corporativas_y_de_Fundaciones	Director de Relaciones Corporativas y de Fundaciones
Director_de_Relaciones_Públicas	Director de Relaciones Públicas
Director_de_Relaciones_con_los_Medios	Director de Relaciones con los Medios
Director_de_Renta_Fija	Director de Renta Fija
Director_de_Servicios_Especiales	Director de Servicios Especiales
Director_de_Servicios_Familiares	Director de Servicios Familiares
Director_de_Servicios_al_Cliente	Director de Servicios al Cliente
Director_de_Servicios_de_Comedor	Director de Servicios de Comedor
Director_de_Servicios_de_Imágenes	Director de Servicios de Imágenes
Director_de_Servicios_de_Medios	Director de Servicios de Medios
Director_de_Servicios_de_Membresía	Director de Servicios de Membresía
Director_de_Suscripción	Director de Suscripción
Director_de_Televisión	Director de Televisión
Director_de_Ventas_Institucionales	Director de Ventas Institucionales
Director_de_Ventas_de_Catering	Director de Ventas de Catering
Director_de_Ventas_de_Ocio	Director de Ventas de Ocio
Director_de_acondicionamiento_físico	Director de acondicionamiento físico
Director_de_adoración	Director de adoración
Director_de_adquisición_de_talento	Director de adquisición de talento
Director_de_animación	Director de animación
Director_de_arte	Director de arte
Director_de_arte_ejecutivo	Director de arte ejecutivo
Director_de_arte_interactivo	Director de arte interactivo
Director_de_arte_principal	Director de arte principal
Director_de_casting	Director de casting
Director_de_cine	Director de cine
Director_de_colecciones	Director de colecciones
Director_de_copias	Director de copias
Director_de_cuenta	Director de cuenta
Director_de_desarrollo_de_audiencia	Director de desarrollo de audiencia
Director_de_desarrollo_de_fondos	Director de desarrollo de fondos
Director_de_desarrollo_de_hardware	Director de desarrollo de hardware
Director_de_donaciones_planificadas	Director de donaciones planificadas
Director_de_escuela	Director de escuela
Director_de_escuela_primaria	Director de escuela primaria
Director_de_estudios	Director de estudios
Director_de_fotografía	Director de fotografía
Director_de_gestión_de_eventos	Director de gestión de eventos
Director_de_investigación_de_acciones	Director de investigación de acciones
Director_de_la_agencia	Director de la agencia
Director_de_marketing_y_comunicaciones	Director de marketing y comunicaciones
Director_de_medios	Director de medios
Director_de_noticias	Director de noticias
Director_de_operaciones_de_red	Director de operaciones de red
Director_de_operaciones_de_transmisión	Director de operaciones de transmisión
Director_de_planta	Director de planta
Director_de_producción_de_video	Director de producción de video
Director_de_recaudación_de_fondos	Director de recaudación de fondos
Director_de_reubicación	Director de reubicación
Director_de_riesgos	Director de riesgos
Director_de_suscripción	Director de suscripción
Director_de_ventas_y_Marketing	Director de ventas y Marketing
Director_del_Centro_de_Operaciones_de_Red	Director del Centro de Operaciones de Red
Director_editorial	Director editorial
Director_ejecutivo	Director ejecutivo
Director_general	Director general
Director_musical	Director musical
Director_operativo	Director operativo
Directora_Efectividad_Organizacional	Directora Efectividad Organizacional
Directora_de_Capital_Humano	Directora de Capital Humano
Directora_de_Cuentas_Digitales	Directora de Cuentas Digitales
Directora_de_Logística	Directora de Logística
Directora_de_Medios_del_Grupo	Directora de Medios del Grupo
Directora_de_Planificación_del_Grupo	Directora de Planificación del Grupo
Directora_de_Primaria	Directora de Primaria
Directora_de_Servicio_de_Alimentos	Directora de Servicio de Alimentos
Directora_de_eventos_privados	Directora de eventos privados
Diseñador	Diseñador
Diseñador_Digital	Diseñador Digital
Diseñador_Web_y_Gráfico	Diseñador Web y Gráfico
Diseñador_analógico	Diseñador analógico
Diseñador_arquitectónico	Diseñador arquitectónico
Diseñador_conceptual	Diseñador conceptual
Diseñador_de_Publicaciones	Diseñador de Publicaciones
Diseñador_de_accesorios	Diseñador de accesorios
Diseñador_de_circuitos	Diseñador de circuitos
Diseñador_de_comunicaciones	Diseñador de comunicaciones
Diseñador_de_diseño	Diseñador de diseño
Diseñador_de_eventos	Diseñador de eventos
Diseñador_de_hardware	Diseñador de hardware
Diseñador_de_impresión	Diseñador de impresión
Diseñador_de_ingeniería	Diseñador de ingeniería
Diseñador_de_interfaz_de_usuario	Diseñador de interfaz de usuario
Diseñador_de_interiores	Diseñador de interiores
Diseñador_de_juegos	Diseñador de juegos
Diseñador_de_marca	Diseñador de marca
Diseñador_de_medios_digitales	Diseñador de medios digitales
Diseñador_de_moda	Diseñador de moda
Diseñador_de_pelo	Diseñador de pelo
Diseñador_de_personajes	Diseñador de personajes
Diseñador_de_placas_de_circuito_impreso	Diseñador de placas de circuito impreso
Diseñador_de_plomería	Diseñador de plomería
Diseñador_de_proyectos	Diseñador de proyectos
Diseñador_de_red	Diseñador de red
Diseñador_de_ropa	Diseñador de ropa
Diseñador_de_ropa_de_mujer	Diseñador de ropa de mujer
Diseñador_de_ropa_masculina	Diseñador de ropa masculina
Diseñador_de_servicios	Diseñador de servicios
Diseñador_de_sistemas_de_control	Diseñador de sistemas de control
Diseñador_de_transmisiones	Diseñador de transmisiones
Diseñador_electrónico	Diseñador electrónico
Diseñador_físico	Diseñador físico
Diseñador_gráfico_creativo	Diseñador gráfico creativo
Diseñador_gráfico_principal	Diseñador gráfico principal
Diseñador_jefe	Diseñador jefe
Diseñador_mecanico	Diseñador mecanico
Diseñador_multimedia	Diseñador multimedia
Diseñador_publicitario	Diseñador publicitario
Diseñador_técnico	Diseñador técnico
Diseñador_web	Diseñador web
Diseñadora_Gráfica_Ambiental	Diseñadora Gráfica Ambiental
Diseñadora_Textil	Diseñadora Textil
Diseñadora_de_prendas_de_punto	Diseñadora de prendas de punto
Distribución_asociada	Distribución asociada
Distribuidor_de_acciones	Distribuidor de acciones
Doctor_en_Medicina	Doctor en Medicina
Editor	Editor
Editor_Gerente_Adjunto	Editor Gerente Adjunto
Editor_asistente	Editor asistente
Editor_de_cine_y_video	Editor de cine y video
Editor_de_fotos	Editor de fotos
Editor_de_grupo	Editor de grupo
Editor_de_películas	Editor de películas
Editor_de_proyectos	Editor de proyectos
Editor_de_puesta_en_marcha	Editor de puesta en marcha
Editor_de_tareas	Editor de tareas
Editor_de_video	Editor de video
Editor_de_video_asistente	Editor de video asistente
Editor_en_jefe	Editor en jefe
Editor_web	Editor web
Educadora_de_Primera_Infancia	Educadora de Primera Infancia
Ejecutivo_Importación_Exportación	Ejecutivo Importación Exportación
Ejecutivo_de_Adquisición_de_Talento	Ejecutivo de Adquisición de Talento
Ejecutivo_de_Cuentas_de_Relaciones_Públicas	Ejecutivo de Cuentas de Relaciones Públicas
Ejecutivo_de_Documentación	Ejecutivo de Documentación
Ejecutivo_de_Finanzas_Corporativas	Ejecutivo de Finanzas Corporativas
Ejecutivo_de_Logística	Ejecutivo de Logística
Ejecutivo_de_Marketing_y_Comunicaciones	Ejecutivo de Marketing y Comunicaciones
Ejecutivo_de_Reclutamiento	Ejecutivo de Reclutamiento
Ejecutivo_de_Relaciones_con_los_Huéspedes	Ejecutivo de Relaciones con los Huéspedes
Ejecutivo_de_Seguros	Ejecutivo de Seguros
Ejecutivo_de_campo_de_la_agencia	Ejecutivo de campo de la agencia
Ejecutivo_de_cuentas	Ejecutivo de cuentas
Ejecutivo_de_cuentas_digitales	Ejecutivo de cuentas digitales
Ejecutivo_de_eventos	Ejecutivo de eventos
Ejecutivo_de_importación	Ejecutivo de importación
Ejecutivo_de_medios	Ejecutivo de medios
Ejecutivo_de_recepción	Ejecutivo de recepción
Ejecutivo_de_relaciones	Ejecutivo de relaciones
Ejecutivo_de_ventas_de_exportación	Ejecutivo de ventas de exportación
Ejecutivo_de_viajes	Ejecutivo de viajes
Ejecutivo_en_Residencia	Ejecutivo en Residencia
Ejecutivo_legal	Ejecutivo legal
Embajador_de_admisiones	Embajador de admisiones
Empleado_bancario	Empleado bancario
Empleado_de_envío_y_recepción	Empleado de envío y recepción
Empleado_de_la_sala_del_correo	Empleado de la sala del correo
Empleado_de_la_tienda	Empleado de la tienda
Enfermera_de_Práctica_Avanzada	Enfermera de Práctica Avanzada
Enfermera_de_Salud_Ocupacional	Enfermera de Salud Ocupacional
Enfermera_de_cuidados_intensivos	Enfermera de cuidados intensivos
Enfermera_de_enlace	Enfermera de enlace
Enfermera_de_la_escuela	Enfermera de la escuela
Enfermera_de_salud_en_el_hogar	Enfermera de salud en el hogar
Enfermera_de_salud_pública	Enfermera de salud pública
Enfermera_de_viaje	Enfermera de viaje
Enfermera_del_distrito	Enfermera del distrito
Enfermera_dental	Enfermera dental
Enfermera_practicante_de_adultos	Enfermera practicante de adultos
Enfermera_practicante_de_salud_mental_psiquiátrica	Enfermera practicante de salud mental psiquiátrica
Enfermera_practicante_pediátrica	Enfermera practicante pediátrica
Enfermera_práctica_licenciada	Enfermera práctica licenciada
Enfermero	Enfermero
Entrenador	Entrenador
Entrenador_Ejecutivo	Entrenador Ejecutivo
Entrenador_asistente_de_fuerza_y_acondicionamiento	Entrenador asistente de fuerza y acondicionamiento
Entrenador_asistente_de_fútbol	Entrenador asistente de fútbol
Entrenador_de_Distrito	Entrenador de Distrito
Entrenador_de_alfabetización	Entrenador de alfabetización
Entrenador_de_fuerza_y_acondicionamiento	Entrenador de fuerza y acondicionamiento
Entrenador_de_futbol	Entrenador de futbol
Entrenador_de_fútbol	Entrenador de fútbol
Entrenador_de_lectura	Entrenador de lectura
Entrenador_de_natación	Entrenador de natación
Entrenador_de_perros	Entrenador de perros
Entrenador_de_rendimiento	Entrenador de rendimiento
Entrenador_de_tecnología	Entrenador de tecnología
Entrenador_de_tenis	Entrenador de tenis
Entrenador_de_área	Entrenador de área
Entrenador_físico	Entrenador físico
Entrenador_personal	Entrenador personal
Entrenador_personal_certificado	Entrenador personal certificado
Entrenador_vocal	Entrenador vocal
Equipo_de_enfermeras	Equipo de enfermeras
Escenario_casero	Escenario casero
Escritor	Escritor
Escritor_colaborador	Escritor colaborador
Escritor_de_características	Escritor de características
Escritor_de_contenido	Escritor de contenido
Escritor_de_contratos	Escritor de contratos
Escritor_de_viajes	Escritor de viajes
Escritor_financiero	Escritor financiero
Escultor	Escultor
Especialista_Académico	Especialista Académico
Especialista_Gráfico	Especialista Gráfico
Especialista_Inalámbrico	Especialista Inalámbrico
Especialista_Legal	Especialista Legal
Especialista_Mecanico	Especialista Mecanico
Especialista_Operacional	Especialista Operacional
Especialista_Técnico_Regional	Especialista Técnico Regional
Especialista_Visual	Especialista Visual
Especialista_certificado_en_planificación_hipotecaria	Especialista certificado en planificación hipotecaria
Especialista_de_campo_de_la_agencia	Especialista de campo de la agencia
Especialista_de_soporte_regional	Especialista de soporte regional
Especialista_en_Adquisición_de_Talento	Especialista en Adquisición de Talento
Especialista_en_Banca_de_Empresas	Especialista en Banca de Empresas
Especialista_en_Bienes_Raíces	Especialista en Bienes Raíces
Especialista_en_Bienes_Raíces_Comerciales	Especialista en Bienes Raíces Comerciales
Especialista_en_Cierre	Especialista en Cierre
Especialista_en_Comercio_Internacional	Especialista en Comercio Internacional
Especialista_en_Comunicaciones	Especialista en Comunicaciones
Especialista_en_Crédito	Especialista en Crédito
Especialista_en_Derivados	Especialista en Derivados
Especialista_en_Desarrollo_de_Negocios	Especialista en Desarrollo de Negocios
Especialista_en_Empleo	Especialista en Empleo
Especialista_en_Exportaciones	Especialista en Exportaciones
Especialista_en_Farmacia_Clínica	Especialista en Farmacia Clínica
Especialista_en_Fondos_Mutuos	Especialista en Fondos Mutuos
Especialista_en_Gestión_del_Talento	Especialista en Gestión del Talento
Especialista_en_Importaciones	Especialista en Importaciones
Especialista_en_Impuestos	Especialista en Impuestos
Especialista_en_Ingeniería_de_Procesos	Especialista en Ingeniería de Procesos
Especialista_en_Instrucción	Especialista en Instrucción
Especialista_en_Inversiones	Especialista en Inversiones
Especialista_en_Investigaciones	Especialista en Investigaciones
Especialista_en_Lectura	Especialista en Lectura
Especialista_en_Litigios	Especialista en Litigios
Especialista_en_Mercadeo_y_Relaciones_Públicas	Especialista en Mercadeo y Relaciones Públicas
Especialista_en_Nuevos_Negocios	Especialista en Nuevos Negocios
Especialista_en_Procesos	Especialista en Procesos
Especialista_en_Propiedad_Intelectual	Especialista en Propiedad Intelectual
Especialista_en_Protección_Ambiental	Especialista en Protección Ambiental
Especialista_en_Quiebras	Especialista en Quiebras
Especialista_en_Reclutamiento_de_Recursos_Humanos	Especialista en Reclutamiento de Recursos Humanos
Especialista_en_Renta_Fija	Especialista en Renta Fija
Especialista_en_Seguridad_de_Redes	Especialista en Seguridad de Redes
Especialista_en_Seguros	Especialista en Seguros
Especialista_en_Social_Media	Especialista en Social Media
Especialista_en_TI	Especialista en TI
Especialista_en_Telecomunicaciones	Especialista en Telecomunicaciones
Especialista_en_Ventas_Asesoras	Especialista en Ventas Asesoras
Especialista_en_acciones	Especialista en acciones
Especialista_en_acondicionamiento_físico	Especialista en acondicionamiento físico
Especialista_en_alfabetización	Especialista en alfabetización
Especialista_en_almacén	Especialista en almacén
Especialista_en_aplicaciones_clínicas	Especialista en aplicaciones clínicas
Especialista_en_aplicaciones_web	Especialista en aplicaciones web
Especialista_en_arte	Especialista en arte
Especialista_en_atención_al_cliente	Especialista en atención al cliente
Especialista_en_automatización	Especialista en automatización
Especialista_en_automatización_de_pruebas	Especialista en automatización de pruebas
Especialista_en_cine_en_casa	Especialista en cine en casa
Especialista_en_color	Especialista en color
Especialista_en_comercio	Especialista en comercio
Especialista_en_computadoras_personales	Especialista en computadoras personales
Especialista_en_comunicaciones_de_marketing	Especialista en comunicaciones de marketing
Especialista_en_comunicaciones_web	Especialista en comunicaciones web
Especialista_en_dotación_de_personal	Especialista en dotación de personal
Especialista_en_ejecuciones_hipotecarias	Especialista en ejecuciones hipotecarias
Especialista_en_electronica	Especialista en electronica
Especialista_en_eventos	Especialista en eventos
Especialista_en_fotografía	Especialista en fotografía
Especialista_en_hardware	Especialista en hardware
Especialista_en_liquidación	Especialista en liquidación
Especialista_en_localización	Especialista en localización
Especialista_en_medios_bibliotecarios	Especialista en medios bibliotecarios
Especialista_en_medios_de_la_biblioteca_escolar	Especialista en medios de la biblioteca escolar
Especialista_en_microcomputadoras	Especialista en microcomputadoras
Especialista_en_políticas	Especialista en políticas
Especialista_en_producción_de_medios	Especialista en producción de medios
Especialista_en_producción_de_video	Especialista en producción de video
Especialista_en_propiedades	Especialista en propiedades
Especialista_en_préstamos	Especialista en préstamos
Especialista_en_préstamos_hipotecarios	Especialista en préstamos hipotecarios
Especialista_en_publicidad	Especialista en publicidad
Especialista_en_reclutamiento	Especialista en reclutamiento
Especialista_en_recursos	Especialista en recursos
Especialista_en_redes	Especialista en redes
Especialista_en_redes_de_datos	Especialista en redes de datos
Especialista_en_redes_informáticas	Especialista en redes informáticas
Especialista_en_reubicación	Especialista en reubicación
Especialista_en_salud_y_estado_físico	Especialista en salud y estado físico
Especialista_en_servicio_al_cliente	Especialista en servicio al cliente
Especialista_en_sistemas_de_control	Especialista en sistemas de control
Especialista_en_software	Especialista en software
Especialista_en_soporte_al_usuario	Especialista en soporte al usuario
Especialista_en_soporte_al_usuario_final	Especialista en soporte al usuario final
Especialista_en_soporte_de_TI	Especialista en soporte de TI
Especialista_en_soporte_de_escritorio	Especialista en soporte de escritorio
Especialista_en_soporte_de_servicio	Especialista en soporte de servicio
Especialista_en_viajes	Especialista en viajes
Estilista	Estilista
Estilista_de_Vestuario	Estilista de Vestuario
Estilista_de_moda	Estilista de moda
Estimador_de_proyectos	Estimador de proyectos
Estratega_de_redes_sociales	Estratega de redes sociales
Estrategia_de_vicepresidente	Estrategia de vicepresidente
Estudiante_de_Diseño_Gráfico	Estudiante de Diseño Gráfico
Estudiante_de_Informática	Estudiante de Informática
Estudiante_de_Ingeniería_Mecánica	Estudiante de Ingeniería Mecánica
Estudiante_de_Posgrado_de_Maestría_en_Administración_de_Empresas	Estudiante de Posgrado de Maestría en Administración de Empresas
Estudiante_de_arquitectura	Estudiante de arquitectura
Estudiante_de_enfermería	Estudiante de enfermería
Estudiante_profesor	Estudiante profesor
Examinador_de_títulos	Examinador de títulos
Expedidor	Expedidor
Experiencia_del_huésped_del_líder_del_equipo_ejecutivo	Experiencia del huésped del líder del equipo ejecutivo
Experto_Nacional	Experto Nacional
Experto_en_Negocios	Experto en Negocios
Experto_en_Telecomunicaciones	Experto en Telecomunicaciones
Experto_en_logística	Experto en logística
Experto_en_seguridad	Experto en seguridad
Experto_en_soporte_técnico	Experto en soporte técnico
Exploración_de_vicepresidente	Exploración de vicepresidente
Explorador_de_ubicación	Explorador de ubicación
Facilitador_de_grupo	Facilitador de grupo
Facultad_de_tiempo_completo	Facultad de tiempo completo
Farmacéutico_Clínico	Farmacéutico Clínico
Farmacéutico_de_Asuntos_Regulatorios	Farmacéutico de Asuntos Regulatorios
Farmacéutico_de_Personal_Clínico	Farmacéutico de Personal Clínico
Farmacéutico_de_Producción	Farmacéutico de Producción
Fiscal_Adjunto_del_Distrito	Fiscal Adjunto del Distrito
Fiscal_General_Adjunto	Fiscal General Adjunto
Fiscal_adjunto_de_la_ciudad	Fiscal adjunto de la ciudad
Fotógrafo_de_Bellas_Artes	Fotógrafo de Bellas Artes
Fotógrafo_de_eventos	Fotógrafo de eventos
Fotógrafo_del_personal	Fotógrafo del personal
Fotógrafo_deportivo	Fotógrafo deportivo
Fotógrafo_por_contrato	Fotógrafo por contrato
Fotógrafo_profesional	Fotógrafo profesional
Futbolista_profesional	Futbolista profesional
Generalista	Generalista
Generalista_3D	Generalista 3D
Geofísico_de_procesamiento	Geofísico de procesamiento
Geofísico_del_personal	Geofísico del personal
Gerente_Comercial_de_País	Gerente Comercial de País
Gerente_Corporativo_de_Logística	Gerente Corporativo de Logística
Gerente_Culinario	Gerente Culinario
Gerente_Departamento_Eléctrico	Gerente Departamento Eléctrico
Gerente_Deportivo	Gerente Deportivo
Gerente_División_Habitaciones	Gerente División Habitaciones
Gerente_Editorial	Gerente Editorial
Gerente_General_de_Restaurante	Gerente General de Restaurante
Gerente_General_de_Área	Gerente General de Área
Gerente_Nacional_de_Logística	Gerente Nacional de Logística
Gerente_Nacional_de_RRHH	Gerente Nacional de RRHH
Gerente_Oficina_Técnica	Gerente Oficina Técnica
Gerente_Planificación_Estratégica	Gerente Planificación Estratégica
Gerente_Regional_de_Bienes_Raíces	Gerente Regional de Bienes Raíces
Gerente_Regional_de_Construcción	Gerente Regional de Construcción
Gerente_Regional_de_Exportaciones	Gerente Regional de Exportaciones
Gerente_Regional_de_Ingresos	Gerente Regional de Ingresos
Gerente_Regional_de_Logística	Gerente Regional de Logística
Gerente_Regional_de_Producción	Gerente Regional de Producción
Gerente_Regional_de_Reclutamiento	Gerente Regional de Reclutamiento
Gerente_Regional_de_Transporte	Gerente Regional de Transporte
Gerente_Técnico_de_Programas_de_Personal	Gerente Técnico de Programas de Personal
Gerente_Técnico_de_Reclutamiento	Gerente Técnico de Reclutamiento
Gerente_creativo	Gerente creativo
Gerente_de_Activos_y_Pasivos	Gerente de Activos y Pasivos
Gerente_de_Adquisición_de_Talento	Gerente de Adquisición de Talento
Gerente_de_Agencia	Gerente de Agencia
Gerente_de_Agencia_de_Viajes	Gerente de Agencia de Viajes
Gerente_de_Almacen_y_Logistica	Gerente de Almacen y Logistica
Gerente_de_Almacén_y_Distribución	Gerente de Almacén y Distribución
Gerente_de_Banca_Personal	Gerente de Banca Personal
Gerente_de_Banca_Privada	Gerente de Banca Privada
Gerente_de_Centro_Logístico	Gerente de Centro Logístico
Gerente_de_Cobranzas_de_Área	Gerente de Cobranzas de Área
Gerente_de_Compras_Internacionales	Gerente de Compras Internacionales
Gerente_de_Comunicaciones	Gerente de Comunicaciones
Gerente_de_Comunicaciones_Externas	Gerente de Comunicaciones Externas
Gerente_de_Comunicaciones_Globales	Gerente de Comunicaciones Globales
Gerente_de_Consultoría	Gerente de Consultoría
Gerente_de_Coordinación_de_Proyectos	Gerente de Coordinación de Proyectos
Gerente_de_Cuentas_Mayores	Gerente de Cuentas Mayores
Gerente_de_Cumplimiento_Tributario	Gerente de Cumplimiento Tributario
Gerente_de_Desarrollo_Web	Gerente de Desarrollo Web
Gerente_de_Desarrollo_de_Negocios	Gerente de Desarrollo de Negocios
Gerente_de_Desarrollo_de_Negocios_Globales	Gerente de Desarrollo de Negocios Globales
Gerente_de_Desarrollo_de_Rutas	Gerente de Desarrollo de Rutas
Gerente_de_Diseño_Físico	Gerente de Diseño Físico
Gerente_de_Diseño_Gráfico	Gerente de Diseño Gráfico
Gerente_de_Diseño_Mecánico	Gerente de Diseño Mecánico
Gerente_de_Diseño_de_Marca	Gerente de Diseño de Marca
Gerente_de_Divisas	Gerente de Divisas
Gerente_de_Donaciones_Anuales	Gerente de Donaciones Anuales
Gerente_de_Entrenamiento_Personal	Gerente de Entrenamiento Personal
Gerente_de_Estrategia_y_Operaciones	Gerente de Estrategia y Operaciones
Gerente_de_Farmacia_Clínica	Gerente de Farmacia Clínica
Gerente_de_Fondo_Anual	Gerente de Fondo Anual
Gerente_de_Fotografía	Gerente de Fotografía
Gerente_de_Grandes_Regalos	Gerente de Grandes Regalos
Gerente_de_Hospitalidad	Gerente de Hospitalidad
Gerente_de_Implementación_de_Redes	Gerente de Implementación de Redes
Gerente_de_Impuestos_Corporativos	Gerente de Impuestos Corporativos
Gerente_de_Impuestos_Estatales_y_Locales	Gerente de Impuestos Estatales y Locales
Gerente_de_Impuestos_Federales	Gerente de Impuestos Federales
Gerente_de_Impuestos_a_la_Propiedad	Gerente de Impuestos a la Propiedad
Gerente_de_Información_Médica	Gerente de Información Médica
Gerente_de_Infraestructura_de_Red	Gerente de Infraestructura de Red
Gerente_de_Ingeniería_Eléctrica	Gerente de Ingeniería Eléctrica
Gerente_de_Ingeniería_de_Campo	Gerente de Ingeniería de Campo
Gerente_de_Ingeniería_de_Redes	Gerente de Ingeniería de Redes
Gerente_de_Litigios	Gerente de Litigios
Gerente_de_Logistica	Gerente de Logistica
Gerente_de_Logística_Global	Gerente de Logística Global
Gerente_de_Logística_Internacional	Gerente de Logística Internacional
Gerente_de_Logística_del_Grupo	Gerente de Logística del Grupo
Gerente_de_Líneas_Personales	Gerente de Líneas Personales
Gerente_de_Marketing_Secundario	Gerente de Marketing Secundario
Gerente_de_Marketing_de_Adquisiciones	Gerente de Marketing de Adquisiciones
Gerente_de_Marketing_de_Contenidos	Gerente de Marketing de Contenidos
Gerente_de_Medios_y_Comunicaciones	Gerente de Medios y Comunicaciones
Gerente_de_Mercadeo_Digital	Gerente de Mercadeo Digital
Gerente_de_Mercadeo_Integrado	Gerente de Mercadeo Integrado
Gerente_de_Mercadeo_en_Redes_Sociales	Gerente de Mercadeo en Redes Sociales
Gerente_de_Mercado_Minorista	Gerente de Mercado Minorista
Gerente_de_Operaciones_Marítimas	Gerente de Operaciones Marítimas
Gerente_de_Operaciones_Terrestres	Gerente de Operaciones Terrestres
Gerente_de_Operaciones_de_Almacén	Gerente de Operaciones de Almacén
Gerente_de_Operaciones_de_Farmacia	Gerente de Operaciones de Farmacia
Gerente_de_Operaciones_de_Inversión	Gerente de Operaciones de Inversión
Gerente_de_Operaciones_de_Noticias	Gerente de Operaciones de Noticias
Gerente_de_Operaciones_de_Reclutamiento	Gerente de Operaciones de Reclutamiento
Gerente_de_Operaciones_de_Vuelo	Gerente de Operaciones de Vuelo
Gerente_de_Operaciones_y_Logística	Gerente de Operaciones y Logística
Gerente_de_Perforación	Gerente de Perforación
Gerente_de_Personal	Gerente de Personal
Gerente_de_Planificación_Estratégica	Gerente de Planificación Estratégica
Gerente_de_Políticas_Públicas	Gerente de Políticas Públicas
Gerente_de_Portafolio_Inmobiliario	Gerente de Portafolio Inmobiliario
Gerente_de_Post_Producción	Gerente de Post Producción
Gerente_de_Preconstrucción	Gerente de Preconstrucción
Gerente_de_Prensa_y_Relaciones_Públicas	Gerente de Prensa y Relaciones Públicas
Gerente_de_Producción_Editorial	Gerente de Producción Editorial
Gerente_de_Programa_Ambiental	Gerente de Programa Ambiental
Gerente_de_Protección_de_Activos_del_Distrito	Gerente de Protección de Activos del Distrito
Gerente_de_Proyectos_Ambientales	Gerente de Proyectos Ambientales
Gerente_de_Proyectos_Creativos	Gerente de Proyectos Creativos
Gerente_de_Proyectos_Editoriales	Gerente de Proyectos Editoriales
Gerente_de_Proyectos_de_Reclutamiento	Gerente de Proyectos de Reclutamiento
Gerente_de_Publicaciones	Gerente de Publicaciones
Gerente_de_Radiología	Gerente de Radiología
Gerente_de_Reclutamiento_de_Cuentas	Gerente de Reclutamiento de Cuentas
Gerente_de_Reclutamiento_de_Graduados	Gerente de Reclutamiento de Graduados
Gerente_de_Reclutamiento_y_Capacitación	Gerente de Reclutamiento y Capacitación
Gerente_de_Reclutamiento_y_Selección	Gerente de Reclutamiento y Selección
Gerente_de_Recursos_Humanos	Gerente de Recursos Humanos
Gerente_de_Relaciones_Públicas_Globales	Gerente de Relaciones Públicas Globales
Gerente_de_Relaciones_Públicas_Internacionales	Gerente de Relaciones Públicas Internacionales
Gerente_de_Relaciones_con_Banca_Privada	Gerente de Relaciones con Banca Privada
Gerente_de_Relaciones_con_Donantes	Gerente de Relaciones con Donantes
Gerente_de_Relaciones_con_Exalumnos	Gerente de Relaciones con Exalumnos
Gerente_de_Relaciones_con_el_Cliente	Gerente de Relaciones con el Cliente
Gerente_de_Relaciones_de_Banca_Comercial	Gerente de Relaciones de Banca Comercial
Gerente_de_Riesgo_de_Mercado	Gerente de Riesgo de Mercado
Gerente_de_Seguridad_Alimentaria	Gerente de Seguridad Alimentaria
Gerente_de_Servicio	Gerente de Servicio
Gerente_de_Servicio_de_Alimentos	Gerente de Servicio de Alimentos
Gerente_de_Servicios_Avanzados	Gerente de Servicios Avanzados
Gerente_de_Servicios_Creativos	Gerente de Servicios Creativos
Gerente_de_Servicios_Gráficos	Gerente de Servicios Gráficos
Gerente_de_Servicios_de_Conferencias	Gerente de Servicios de Conferencias
Gerente_de_Subvenciones	Gerente de Subvenciones
Gerente_de_Sucursal	Gerente de Sucursal
Gerente_de_Unidad_de_Producción	Gerente de Unidad de Producción
Gerente_de_Ventas_Comunitarias	Gerente de Ventas Comunitarias
Gerente_de_Ventas_Digitales	Gerente de Ventas Digitales
Gerente_de_Ventas_Hipotecarias	Gerente de Ventas Hipotecarias
Gerente_de_Ventas_Interactivo	Gerente de Ventas Interactivo
Gerente_de_Ventas_Locales	Gerente de Ventas Locales
Gerente_de_Viajes_Corporativos	Gerente de Viajes Corporativos
Gerente_de_Viajes_Globales	Gerente de Viajes Globales
Gerente_de_acondicionamiento_físico	Gerente de acondicionamiento físico
Gerente_de_adquisición_del_sitio	Gerente de adquisición del sitio
Gerente_de_anuncios_clasificados	Gerente de anuncios clasificados
Gerente_de_banco	Gerente de banco
Gerente_de_banda	Gerente de banda
Gerente_de_base	Gerente de base
Gerente_de_beneficios	Gerente de beneficios
Gerente_de_bóveda	Gerente de bóveda
Gerente_de_cafetería	Gerente de cafetería
Gerente_de_cartera_de_productos	Gerente de cartera de productos
Gerente_de_centro_de_negocios	Gerente de centro de negocios
Gerente_de_cocina	Gerente de cocina
Gerente_de_conferencias	Gerente de conferencias
Gerente_de_costos	Gerente de costos
Gerente_de_cuenta_de_publicidad	Gerente de cuenta de publicidad
Gerente_de_cuenta_de_reclutamiento	Gerente de cuenta de reclutamiento
Gerente_de_cuentas	Gerente de cuentas
Gerente_de_cuentas_de_logística	Gerente de cuentas de logística
Gerente_de_cuentas_de_mercado_medio	Gerente de cuentas de mercado medio
Gerente_de_cuentas_digitales	Gerente de cuentas digitales
Gerente_de_despacho	Gerente de despacho
Gerente_de_diseño_creativo	Gerente de diseño creativo
Gerente_de_diseño_de_red	Gerente de diseño de red
Gerente_de_donaciones_individuales	Gerente de donaciones individuales
Gerente_de_envío	Gerente de envío
Gerente_de_envío_y_recepción	Gerente de envío y recepción
Gerente_de_espectáculos	Gerente de espectáculos
Gerente_de_estudio_de_diseño	Gerente de estudio de diseño
Gerente_de_eventos_de_catering	Gerente de eventos de catering
Gerente_de_exportaciones	Gerente de exportaciones
Gerente_de_importaciones	Gerente de importaciones
Gerente_de_impuestos	Gerente de impuestos
Gerente_de_ingeniería_del_grupo	Gerente de ingeniería del grupo
Gerente_de_inventario	Gerente de inventario
Gerente_de_la_Fundación	Gerente de la Fundación
Gerente_de_locación	Gerente de locación
Gerente_de_lugar	Gerente de lugar
Gerente_de_operaciones_de_red	Gerente de operaciones de red
Gerente_de_panadería	Gerente de panadería
Gerente_de_piscina	Gerente de piscina
Gerente_de_producción_de_impresión	Gerente de producción de impresión
Gerente_de_producción_de_video	Gerente de producción de video
Gerente_de_productos_inalámbricos	Gerente de productos inalámbricos
Gerente_de_publicación	Gerente de publicación
Gerente_de_publicidad	Gerente de publicidad
Gerente_de_publicidad_en_línea	Gerente de publicidad en línea
Gerente_de_recaudación_de_fondos	Gerente de recaudación de fondos
Gerente_de_recepción	Gerente de recepción
Gerente_de_reclutamiento	Gerente de reclutamiento
Gerente_de_recursos	Gerente de recursos
Gerente_de_recursos_humanos_del_grupo	Gerente de recursos humanos del grupo
Gerente_de_relaciones	Gerente de relaciones
Gerente_de_relevo	Gerente de relevo
Gerente_de_rendimiento	Gerente de rendimiento
Gerente_de_restaurante_y_bar	Gerente de restaurante y bar
Gerente_de_salón	Gerente de salón
Gerente_de_subcontratación	Gerente de subcontratación
Gerente_de_talento	Gerente de talento
Gerente_de_terminal	Gerente de terminal
Gerente_de_transmisión	Gerente de transmisión
Gerente_de_ventas	Gerente de ventas
Gerente_de_viajes	Gerente de viajes
Gerente_del_Centro_de_Conferencias	Gerente del Centro de Conferencias
Gerente_del_Centro_de_Diseño	Gerente del Centro de Diseño
Gerente_del_Centro_de_Servicio	Gerente del Centro de Servicio
Gerente_del_Departamento_de_Arte	Gerente del Departamento de Arte
Gerente_del_Departamento_de_Logística	Gerente del Departamento de Logística
Gerente_del_Programa_de_Localización	Gerente del Programa de Localización
Gerente_del_bar	Gerente del bar
Gerente_del_restaurante	Gerente del restaurante
Gerente_dietético	Gerente dietético
Gerente_floral	Gerente floral
Gerente_general	Gerente general
Gerente_nocturno	Gerente nocturno
Gerente_Área_Exportación	Gerente Área Exportación
Gestor_Principal_de_Cartera	Gestor Principal de Cartera
Gestor_de_Cartera_de_Renta_Fija	Gestor de Cartera de Renta Fija
Gestor_de_cartera_de_renta_variable	Gestor de cartera de renta variable
Gestor_de_clientes_privados	Gestor de clientes privados
Gestor_de_contenidos	Gestor de contenidos
Gestor_de_contenidos_digitales	Gestor de contenidos digitales
Gestor_de_fondos	Gestor de fondos
Gestor_de_procesos	Gestor de procesos
Gestor_de_tráfico	Gestor de tráfico
Geólogo	Geólogo
Geólogo_Ambiental	Geólogo Ambiental
Geólogo_Consultor	Geólogo Consultor
Geólogo_de_campo	Geólogo de campo
Geólogo_de_minas	Geólogo de minas
Geólogo_de_planta	Geólogo de planta
Geólogo_de_yacimientos	Geólogo de yacimientos
Geólogo_del_proyecto	Geólogo del proyecto
Geólogo_investigador	Geólogo investigador
Geólogo_jefe	Geólogo jefe
Geólogo_por_contrato	Geólogo por contrato
Geólogo_principal	Geólogo principal
Guionista	Guionista
Guitarrista	Guitarrista
Guía_turística	Guía turística
HR_Generalista	HR Generalista
Herbalista	Herbalista
Hidrogeólogo_Principal	Hidrogeólogo Principal
Hidrogeólogo_de_proyectos	Hidrogeólogo de proyectos
Higienista_dental_registrado	Higienista dental registrado
Ilustrador_médico	Ilustrador médico
Impuesto_principal	Impuesto principal
Ingenieria_Eléctrica	Ingenieria Eléctrica
Ingeniero_Aerodinámico	Ingeniero Aerodinámico
Ingeniero_Asistente_de_Proyectos	Ingeniero Asistente de Proyectos
Ingeniero_Bsc	Ingeniero Bsc
Ingeniero_Civil_Graduado	Ingeniero Civil Graduado
Ingeniero_Clínico	Ingeniero Clínico
Ingeniero_Edison	Ingeniero Edison
Ingeniero_Electricista_Personal	Ingeniero Electricista Personal
Ingeniero_Electromecánico	Ingeniero Electromecánico
Ingeniero_Eléctrico_Principal	Ingeniero Eléctrico Principal
Ingeniero_Eléctrico_e_Instrumentación	Ingeniero Eléctrico e Instrumentación
Ingeniero_Eléctrico_y_Electrónico	Ingeniero Eléctrico y Electrónico
Ingeniero_Estructural_Graduado	Ingeniero Estructural Graduado
Ingeniero_General_de_Campo	Ingeniero General de Campo
Ingeniero_Inalámbrico	Ingeniero Inalámbrico
Ingeniero_Mecanico_Graduado	Ingeniero Mecanico Graduado
Ingeniero_Mecánico_Asistente	Ingeniero Mecánico Asistente
Ingeniero_Mecánico_Contratado	Ingeniero Mecánico Contratado
Ingeniero_Mecánico_Jefe	Ingeniero Mecánico Jefe
Ingeniero_Mecánico_Principal	Ingeniero Mecánico Principal
Ingeniero_Mecánico_de_Procesos	Ingeniero Mecánico de Procesos
Ingeniero_Metalúrgico	Ingeniero Metalúrgico
Ingeniero_Municipal	Ingeniero Municipal
Ingeniero_Portuario	Ingeniero Portuario
Ingeniero_Regional_de_Sistemas	Ingeniero Regional de Sistemas
Ingeniero_Residente_Asistente	Ingeniero Residente Asistente
Ingeniero_Scada	Ingeniero Scada
Ingeniero_Telefónico	Ingeniero Telefónico
Ingeniero_Técnico_de_Campo	Ingeniero Técnico de Campo
Ingeniero_VoIP	Ingeniero VoIP
Ingeniero_aeronáutico	Ingeniero aeronáutico
Ingeniero_agricultor	Ingeniero agricultor
Ingeniero_ambiental	Ingeniero ambiental
Ingeniero_asistente_de_la_ciudad	Ingeniero asistente de la ciudad
Ingeniero_civil_de_obra	Ingeniero civil de obra
Ingeniero_civil_principal	Ingeniero civil principal
Ingeniero_consultor	Ingeniero consultor
Ingeniero_de_Aplicaciones_Corporativas	Ingeniero de Aplicaciones Corporativas
Ingeniero_de_Automatización_de_Aseguramiento_de_la_Calidad	Ingeniero de Automatización de Aseguramiento de la Calidad
Ingeniero_de_Automatización_de_Diseño	Ingeniero de Automatización de Diseño
Ingeniero_de_Automatización_de_Procesos	Ingeniero de Automatización de Procesos
Ingeniero_de_Calefacción_y_Aire_Acondicionado	Ingeniero de Calefacción y Aire Acondicionado
Ingeniero_de_Certificación	Ingeniero de Certificación
Ingeniero_de_Control_de_Procesos	Ingeniero de Control de Procesos
Ingeniero_de_Desarrollo_Electrónico	Ingeniero de Desarrollo Electrónico
Ingeniero_de_Desarrollo_Mecánico	Ingeniero de Desarrollo Mecánico
Ingeniero_de_Diagnóstico	Ingeniero de Diagnóstico
Ingeniero_de_Diseño	Ingeniero de Diseño
Ingeniero_de_Diseño_Civil	Ingeniero de Diseño Civil
Ingeniero_de_Diseño_Digital	Ingeniero de Diseño Digital
Ingeniero_de_Diseño_Electrónico	Ingeniero de Diseño Electrónico
Ingeniero_de_Diseño_Físico	Ingeniero de Diseño Físico
Ingeniero_de_Diseño_de_Manufactura	Ingeniero de Diseño de Manufactura
Ingeniero_de_Diseño_de_Procesos	Ingeniero de Diseño de Procesos
Ingeniero_de_Diseño_de_Redes	Ingeniero de Diseño de Redes
Ingeniero_de_Diseño_de_Señal_Mixta	Ingeniero de Diseño de Señal Mixta
Ingeniero_de_Diseño_de_Sistemas	Ingeniero de Diseño de Sistemas
Ingeniero_de_Diseño_y_Desarrollo	Ingeniero de Diseño y Desarrollo
Ingeniero_de_Diseño_y_Desarrollo_de_Producto	Ingeniero de Diseño y Desarrollo de Producto
Ingeniero_de_Distrito	Ingeniero de Distrito
Ingeniero_de_Drenaje	Ingeniero de Drenaje
Ingeniero_de_Estrés	Ingeniero de Estrés
Ingeniero_de_Hardware_Informático	Ingeniero de Hardware Informático
Ingeniero_de_Implementación	Ingeniero de Implementación
Ingeniero_de_Infraestructura_de_Redes	Ingeniero de Infraestructura de Redes
Ingeniero_de_Innovación	Ingeniero de Innovación
Ingeniero_de_Integración_de_Redes	Ingeniero de Integración de Redes
Ingeniero_de_Investigación_de_Personal	Ingeniero de Investigación de Personal
Ingeniero_de_Investigación_y_Desarrollo	Ingeniero de Investigación y Desarrollo
Ingeniero_de_Manufactura	Ingeniero de Manufactura
Ingeniero_de_Oficina_Técnica	Ingeniero de Oficina Técnica
Ingeniero_de_Operaciones_de_Campo	Ingeniero de Operaciones de Campo
Ingeniero_de_Operaciones_de_Red	Ingeniero de Operaciones de Red
Ingeniero_de_Pavimentos	Ingeniero de Pavimentos
Ingeniero_de_Planificación_de_Radio	Ingeniero de Planificación de Radio
Ingeniero_de_Planificación_de_Redes	Ingeniero de Planificación de Redes
Ingeniero_de_Procesos	Ingeniero de Procesos
Ingeniero_de_Procesos_de_Planta	Ingeniero de Procesos de Planta
Ingeniero_de_Producto	Ingeniero de Producto
Ingeniero_de_Propiedad_Intelectual	Ingeniero de Propiedad Intelectual
Ingeniero_de_Propulsión	Ingeniero de Propulsión
Ingeniero_de_Proyectos	Ingeniero de Proyectos
Ingeniero_de_Proyectos_Eléctricos	Ingeniero de Proyectos Eléctricos
Ingeniero_de_Proyectos_Mecánicos	Ingeniero de Proyectos Mecánicos
Ingeniero_de_Proyectos_de_Telecomunicaciones	Ingeniero de Proyectos de Telecomunicaciones
Ingeniero_de_Pruebas	Ingeniero de Pruebas
Ingeniero_de_Pruebas_Eléctricas	Ingeniero de Pruebas Eléctricas
Ingeniero_de_Redes_Cisco	Ingeniero de Redes Cisco
Ingeniero_de_Redes_Informáticas	Ingeniero de Redes Informáticas
Ingeniero_de_Sección	Ingeniero de Sección
Ingeniero_de_Seguridad	Ingeniero de Seguridad
Ingeniero_de_Seguridad_TI	Ingeniero de Seguridad TI
Ingeniero_de_Seguridad_de_Redes	Ingeniero de Seguridad de Redes
Ingeniero_de_Seguridad_de_la_Información	Ingeniero de Seguridad de la Información
Ingeniero_de_Sistemas_Avanzados	Ingeniero de Sistemas Avanzados
Ingeniero_de_Sistemas_Electrónicos	Ingeniero de Sistemas Electrónicos
Ingeniero_de_Sistemas_Embebidos	Ingeniero de Sistemas Embebidos
Ingeniero_de_Sistemas_Mecánicos	Ingeniero de Sistemas Mecánicos
Ingeniero_de_Sistemas_de_Automatización	Ingeniero de Sistemas de Automatización
Ingeniero_de_Sistemas_de_Control	Ingeniero de Sistemas de Control
Ingeniero_de_Sistemas_de_TI	Ingeniero de Sistemas de TI
Ingeniero_de_Sistemas_de_Telecomunicaciones	Ingeniero de Sistemas de Telecomunicaciones
Ingeniero_de_Telecomunicaciones	Ingeniero de Telecomunicaciones
Ingeniero_de_aplicaciones	Ingeniero de aplicaciones
Ingeniero_de_aplicaciones_de_personal	Ingeniero de aplicaciones de personal
Ingeniero_de_aseguramiento_de_la_calidad_del_software	Ingeniero de aseguramiento de la calidad del software
Ingeniero_de_audio	Ingeniero de audio
Ingeniero_de_calibración	Ingeniero de calibración
Ingeniero_de_campo	Ingeniero de campo
Ingeniero_de_campo_de_telefonía_fija	Ingeniero de campo de telefonía fija
Ingeniero_de_cortafuegos	Ingeniero de cortafuegos
Ingeniero_de_desarrollo_de_hardware	Ingeniero de desarrollo de hardware
Ingeniero_de_desarrollo_de_software	Ingeniero de desarrollo de software
Ingeniero_de_desarrollo_de_software_en_prueba	Ingeniero de desarrollo de software en prueba
Ingeniero_de_desarrollo_web	Ingeniero de desarrollo web
Ingeniero_de_diseño	Ingeniero de diseño
Ingeniero_de_diseño_analógico	Ingeniero de diseño analógico
Ingeniero_de_diseño_de_circuitos	Ingeniero de diseño de circuitos
Ingeniero_de_diseño_de_firmware	Ingeniero de diseño de firmware
Ingeniero_de_diseño_de_hardware	Ingeniero de diseño de hardware
Ingeniero_de_diseño_de_maquetación	Ingeniero de diseño de maquetación
Ingeniero_de_diseño_de_máquinas	Ingeniero de diseño de máquinas
Ingeniero_de_diseño_de_personal	Ingeniero de diseño de personal
Ingeniero_de_diseño_de_pruebas	Ingeniero de diseño de pruebas
Ingeniero_de_diseño_principal	Ingeniero de diseño principal
Ingeniero_de_escritorio	Ingeniero de escritorio
Ingeniero_de_estación	Ingeniero de estación
Ingeniero_de_grabación	Ingeniero de grabación
Ingeniero_de_hardware_del_personal	Ingeniero de hardware del personal
Ingeniero_de_implementación	Ingeniero de implementación
Ingeniero_de_integridad_de_señal	Ingeniero de integridad de señal
Ingeniero_de_interruptores	Ingeniero de interruptores
Ingeniero_de_lanzamiento_de_diseño	Ingeniero de lanzamiento de diseño
Ingeniero_de_mesa_de_ayuda	Ingeniero de mesa de ayuda
Ingeniero_de_minas	Ingeniero de minas
Ingeniero_de_naves_espaciales	Ingeniero de naves espaciales
Ingeniero_de_paquetes	Ingeniero de paquetes
Ingeniero_de_pila_completa	Ingeniero de pila completa
Ingeniero_de_pruebas	Ingeniero de pruebas
Ingeniero_de_pruebas_de_manejo	Ingeniero de pruebas de manejo
Ingeniero_de_pruebas_de_vuelo	Ingeniero de pruebas de vuelo
Ingeniero_de_puentes	Ingeniero de puentes
Ingeniero_de_radio	Ingeniero de radio
Ingeniero_de_red_central	Ingeniero de red central
Ingeniero_de_redes	Ingeniero de redes
Ingeniero_de_redes_VoIP	Ingeniero de redes VoIP
Ingeniero_de_redes_de_datos	Ingeniero de redes de datos
Ingeniero_de_redes_empresariales	Ingeniero de redes empresariales
Ingeniero_de_redes_inalámbricas	Ingeniero de redes inalámbricas
Ingeniero_de_rendimiento_de_red	Ingeniero de rendimiento de red
Ingeniero_de_rendimiento_del_sistema	Ingeniero de rendimiento del sistema
Ingeniero_de_reparación	Ingeniero de reparación
Ingeniero_de_servicios_de_construcción	Ingeniero de servicios de construcción
Ingeniero_de_simulación	Ingeniero de simulación
Ingeniero_de_sistemas	Ingeniero de sistemas
Ingeniero_de_sistemas_de_Microsoft	Ingeniero de sistemas de Microsoft
Ingeniero_de_sistemas_de_hardware	Ingeniero de sistemas de hardware
Ingeniero_de_sistemas_de_red	Ingeniero de sistemas de red
Ingeniero_de_sistemas_de_soporte_comercial	Ingeniero de sistemas de soporte comercial
Ingeniero_de_sistemas_de_transmisión	Ingeniero de sistemas de transmisión
Ingeniero_de_sitio	Ingeniero de sitio
Ingeniero_de_software	Ingeniero de software
Ingeniero_de_software_Java	Ingeniero de software Java
Ingeniero_de_software_distinguido	Ingeniero de software distinguido
Ingeniero_de_sonido	Ingeniero de sonido
Ingeniero_de_soporte_de_escritorio	Ingeniero de soporte de escritorio
Ingeniero_de_soporte_de_hardware	Ingeniero de soporte de hardware
Ingeniero_de_soporte_de_red	Ingeniero de soporte de red
Ingeniero_de_soporte_del_sistema	Ingeniero de soporte del sistema
Ingeniero_de_soporte_remoto	Ingeniero de soporte remoto
Ingeniero_de_soporte_técnico_al_cliente	Ingeniero de soporte técnico al cliente
Ingeniero_de_soporte_técnico_de_personal	Ingeniero de soporte técnico de personal
Ingeniero_de_soporte_técnico_de_ventas	Ingeniero de soporte técnico de ventas
Ingeniero_de_transmisión	Ingeniero de transmisión
Ingeniero_de_tren_motriz	Ingeniero de tren motriz
Ingeniero_de_ventas_de_área	Ingeniero de ventas de área
Ingeniero_de_voz	Ingeniero de voz
Ingeniero_de_vídeo	Ingeniero de vídeo
Ingeniero_eléctrico	Ingeniero eléctrico
Ingeniero_en_Alimentos	Ingeniero en Alimentos
Ingeniero_en_Diseño_Mecánico	Ingeniero en Diseño Mecánico
Ingeniero_en_Logística	Ingeniero en Logística
Ingeniero_en_hardware	Ingeniero en hardware
Ingeniero_geológico	Ingeniero geológico
Ingeniero_jefe_de_software	Ingeniero jefe de software
Ingeniero_médico	Ingeniero médico
Ingeniero_móvil	Ingeniero móvil
Ingeniero_petrolero	Ingeniero petrolero
Ingeniero_principal	Ingeniero principal
Ingeniero_principal_de_hardware	Ingeniero principal de hardware
Ingeniero_principal_de_seguridad	Ingeniero principal de seguridad
Ingeniero_profesional	Ingeniero profesional
Ingeniero_químico	Ingeniero químico
Ingeniero_residente	Ingeniero residente
Ingeniero_web	Ingeniero web
Inspector_policia	Inspector policia
Instructor_adjunto	Instructor adjunto
Instructor_clínico	Instructor clínico
Instructor_culinario	Instructor culinario
Instructor_de_Artes_Marciales	Instructor de Artes Marciales
Instructor_de_Ciclismo_Indoor	Instructor de Ciclismo Indoor
Instructor_de_Contabilidad	Instructor de Contabilidad
Instructor_de_Lanzamiento	Instructor de Lanzamiento
Instructor_de_Remo	Instructor de Remo
Instructor_de_armas_de_fuego	Instructor de armas de fuego
Instructor_de_barra	Instructor de barra
Instructor_de_campo_de_entrenamiento	Instructor de campo de entrenamiento
Instructor_de_cocina	Instructor de cocina
Instructor_de_deportes	Instructor de deportes
Instructor_de_estudiantes_graduados	Instructor de estudiantes graduados
Instructor_de_latón	Instructor de latón
Instructor_de_porristas	Instructor de porristas
Instructor_de_puntería_primaria	Instructor de puntería primaria
Instructor_de_vuelo	Instructor de vuelo
Instructor_jefe_de_vuelo	Instructor jefe de vuelo
Instructor_principal	Instructor principal
Instructor_visitante	Instructor visitante
Instructora_de_Animación	Instructora de Animación
Instructora_de_Costura	Instructora de Costura
Instructora_de_Diseño_Gráfico	Instructora de Diseño Gráfico
Instructora_de_Enfermería	Instructora de Enfermería
Instructora_de_Kinesiología	Instructora de Kinesiología
Instructora_de_acondicionamiento_físico_grupal	Instructora de acondicionamiento físico grupal
Instructora_de_aeróbicos_acuáticos	Instructora de aeróbicos acuáticos
Instructora_de_crossfit	Instructora de crossfit
Integrador_de_red	Integrador de red
Interno	Interno
Investigador	Investigador
Investigador_Corporativo	Investigador Corporativo
Investigador_Jurídico	Investigador Jurídico
Investigador_Principal	Investigador Principal
Investigador_Regional	Investigador Regional
Investigador_criminal	Investigador criminal
Investigador_de_Postgrado	Investigador de Postgrado
Investigador_de_antecedentes	Investigador de antecedentes
Investigador_de_fraude	Investigador de fraude
Investigador_de_medios	Investigador de medios
Investigador_de_planta	Investigador de planta
Investigador_privado	Investigador privado
Jefe_Jurídico_Y_Secretario_De_La_Empresa	Jefe Jurídico Y Secretario De La Empresa
Jefe_de_Asuntos_Legales	Jefe de Asuntos Legales
Jefe_de_Banca_Corporativa	Jefe de Banca Corporativa
Jefe_de_Bienes_Raíces	Jefe de Bienes Raíces
Jefe_de_Desarrollo_Estratégico	Jefe de Desarrollo Estratégico
Jefe_de_Desarrollo_Web	Jefe de Desarrollo Web
Jefe_de_Desarrollo_de_Negocios	Jefe de Desarrollo de Negocios
Jefe_de_Distribución	Jefe de Distribución
Jefe_de_Financiamiento_de_Proyectos	Jefe de Financiamiento de Proyectos
Jefe_de_Finanzas_Corporativas	Jefe de Finanzas Corporativas
Jefe_de_Finanzas_Estructuradas	Jefe de Finanzas Estructuradas
Jefe_de_Gestión_Patrimonial	Jefe de Gestión Patrimonial
Jefe_de_Gestión_de_Activos	Jefe de Gestión de Activos
Jefe_de_Gestión_de_Clientes	Jefe de Gestión de Clientes
Jefe_de_Gestión_del_Talento	Jefe de Gestión del Talento
Jefe_de_Grupo_de_Medios	Jefe de Grupo de Medios
Jefe_de_Instituciones_Financieras	Jefe de Instituciones Financieras
Jefe_de_Inversiones	Jefe de Inversiones
Jefe_de_Legal	Jefe de Legal
Jefe_de_Logística	Jefe de Logística
Jefe_de_Medios_Digitales	Jefe de Medios Digitales
Jefe_de_Oficina_Intermedia	Jefe de Oficina Intermedia
Jefe_de_Operaciones_de_Red	Jefe de Operaciones de Red
Jefe_de_Post_Producción	Jefe de Post Producción
Jefe_de_Recaudación_de_Fondos	Jefe de Recaudación de Fondos
Jefe_de_Reclutamiento	Jefe de Reclutamiento
Jefe_de_Recursos	Jefe de Recursos
Jefe_de_Recursos_Humanos	Jefe de Recursos Humanos
Jefe_de_Relaciones_Públicas	Jefe de Relaciones Públicas
Jefe_de_Seguros	Jefe de Seguros
Jefe_de_Telecomunicaciones	Jefe de Telecomunicaciones
Jefe_de_Ventas_y_Comercio	Jefe de Ventas y Comercio
Jefe_de_almacén	Jefe de almacén
Jefe_de_batallón	Jefe de batallón
Jefe_de_bomberos	Jefe de bomberos
Jefe_de_copia	Jefe de copia
Jefe_de_equipo	Jefe de equipo
Jefe_de_equipo_de_almacén	Jefe de equipo de almacén
Jefe_de_equipo_de_ingenieros_de_software	Jefe de equipo de ingenieros de software
Jefe_de_equipo_de_logística	Jefe de equipo de logística
Jefe_de_equipo_de_recepción	Jefe de equipo de recepción
Jefe_de_equipo_de_software_integrado	Jefe de equipo de software integrado
Jefe_de_equipo_de_telecomunicaciones	Jefe de equipo de telecomunicaciones
Jefe_de_equipo_del_centro_de_operaciones_de_red	Jefe de equipo del centro de operaciones de red
Jefe_de_inversiones	Jefe de inversiones
Jefe_de_investigación_de_acciones	Jefe de investigación de acciones
Jefe_de_obra	Jefe de obra
Jefe_de_partida	Jefe de partida
Jefe_de_policía	Jefe de policía
Jefe_de_producción	Jefe de producción
Jefe_de_redacción	Jefe de redacción
Jefe_de_supervisión	Jefe de supervisión
Jefe_de_turno	Jefe de turno
Jefe_del_Departamento_Jurídico	Jefe del Departamento Jurídico
Jefe_del_Departamento_de_Diseño	Jefe del Departamento de Diseño
Jefe_del_Departamento_de_Logística	Jefe del Departamento de Logística
Jefe_del_Departamento_de_Relaciones_Públicas	Jefe del Departamento de Relaciones Públicas
Juez	Juez
Juez_de_Derecho_Administrativo	Juez de Derecho Administrativo
Juez_de_distrito	Juez de distrito
Jugador	Jugador
Jugador_de_fútbol	Jugador de fútbol
Jugador_de_fútbol_profesional	Jugador de fútbol profesional
Lanza_libre	Lanza libre
Lingüista	Lingüista
Locutor	Locutor
Locutor_al_aire	Locutor al aire
Locutor_de_megafonía	Locutor de megafonía
Locutor_de_radio	Locutor de radio
Logistico	Logistico
Logística	Logística
Líder_creativo	Líder creativo
Líder_de_Adquisición_de_Talento	Líder de Adquisición de Talento
Líder_de_Desarrollo_de_Negocios	Líder de Desarrollo de Negocios
Líder_de_animación	Líder de animación
Líder_de_comunicaciones	Líder de comunicaciones
Líder_de_envío	Líder de envío
Líder_de_piso	Líder de piso
Líder_de_proyecto_de_software	Líder de proyecto de software
Líder_de_prueba_técnica	Líder de prueba técnica
Líder_del_equipo_de_Java	Líder del equipo de Java
Líder_del_equipo_de_agentes_inmobiliarios	Líder del equipo de agentes inmobiliarios
Líder_del_equipo_de_automatización	Líder del equipo de automatización
Líder_del_equipo_de_desarrollo_de_aplicaciones	Líder del equipo de desarrollo de aplicaciones
Líder_del_equipo_de_desarrollo_web	Líder del equipo de desarrollo web
Líder_del_equipo_de_diseño	Líder del equipo de diseño
Líder_del_equipo_de_hardware	Líder del equipo de hardware
Líder_del_equipo_de_implementación	Líder del equipo de implementación
Líder_del_equipo_de_la_mesa_de_servicio	Líder del equipo de la mesa de servicio
Líder_del_equipo_de_reclutamiento	Líder del equipo de reclutamiento
Líder_del_equipo_de_soporte_de_escritorio	Líder del equipo de soporte de escritorio
Líder_del_equipo_de_soporte_técnico	Líder del equipo de soporte técnico
Líder_del_módulo	Líder del módulo
Líder_técnico	Líder técnico
Líder_técnico_de_Java	Líder técnico de Java
Maestra_Asistente_de_Preescolar	Maestra Asistente de Preescolar
Maestra_de_Primera_Infancia	Maestra de Primera Infancia
Maestra_de_cuidado_de_niños	Maestra de cuidado de niños
Maestra_de_guardería	Maestra de guardería
Maestra_de_kindergarten	Maestra de kindergarten
Maestra_de_pre_kínder	Maestra de pre kínder
Maestra_de_primaria	Maestra de primaria
Maestro	Maestro
Maestro_de_la_clase	Maestro de la clase
Maestro_de_teatro	Maestro de teatro
Maestro_suplente	Maestro suplente
Manejador_de_arte	Manejador de arte
Manicuro	Manicuro
Maquillador_profesional	Maquillador profesional
Mayordomo	Mayordomo
Mayorista_interior	Mayorista interior
Mediador	Mediador
Medical_Science_Liaison	Medical Science Liaison
Merchandising_minorista	Merchandising minorista
Mesero	Mesero
Mezclador_de_audio	Mezclador de audio
Mezclador_de_regrabación	Mezclador de regrabación
Mezclador_de_sonido	Mezclador de sonido
Miembro_de_la_Junta_de_Asesores	Miembro de la Junta de Asesores
Miembro_de_la_banda	Miembro de la banda
Miembro_del_equipo_de_ventas	Miembro del equipo de ventas
Miembro_del_personal_profesional	Miembro del personal profesional
Miembro_distinguido_del_personal_técnico	Miembro distinguido del personal técnico
Modelador	Modelador
Modelador_3D	Modelador 3D
Modelador_de_personajes	Modelador de personajes
Máster_en_Asesoría_Fiscal	Máster en Asesoría Fiscal
Médico_de_Medicina_Interna	Médico de Medicina Interna
Médico_de_Urgencias	Médico de Urgencias
Médico_de_cabecera	Médico de cabecera
Médico_de_urgencias	Médico de urgencias
Médico_interno	Médico interno
Médico_residente	Médico residente
Músico	Músico
Músico_profesional	Músico profesional
Negociador_de_difusión	Negociador de difusión
Niñera	Niñera
Oficial_Ejecutivo_Superior	Oficial Ejecutivo Superior
Oficial_Legal_y_de_Cumplimiento	Oficial Legal y de Cumplimiento
Oficial_de_Administración_de_Crédito	Oficial de Administración de Crédito
Oficial_de_Banca_Privada	Oficial de Banca Privada
Oficial_de_Capacitación_y_Colocación	Oficial de Capacitación y Colocación
Oficial_de_Comunicaciones_Internas	Oficial de Comunicaciones Internas
Oficial_de_Desarrollo_Económico	Oficial de Desarrollo Económico
Oficial_de_Mercadeo_y_Relaciones_Públicas	Oficial de Mercadeo y Relaciones Públicas
Oficial_de_Prensa	Oficial de Prensa
Oficial_de_Relaciones_con_Exalumnos	Oficial de Relaciones con Exalumnos
Oficial_de_Relaciones_con_los_Donantes	Oficial de Relaciones con los Donantes
Oficial_de_Relaciones_con_los_Huéspedes	Oficial de Relaciones con los Huéspedes
Oficial_de_Relaciones_con_los_Medios	Oficial de Relaciones con los Medios
Oficial_de_aseguramiento_de_la_información	Oficial de aseguramiento de la información
Oficial_de_audiencia	Oficial de audiencia
Oficial_de_cadena_de_suministro	Oficial de cadena de suministro
Oficial_de_corrección	Oficial de corrección
Oficial_de_crédito	Oficial de crédito
Oficial_de_desarrollo_de_negocios	Oficial de desarrollo de negocios
Oficial_de_exportación	Oficial de exportación
Oficial_de_la_ley	Oficial de la ley
Oficial_de_policía	Oficial de policía
Oficial_de_policía_de_reserva	Oficial de policía de reserva
Oficial_de_proyecto	Oficial de proyecto
Oficial_de_préstamos_hipotecarios	Oficial de préstamos hipotecarios
Oficial_de_préstamos_inmobiliarios	Oficial de préstamos inmobiliarios
Oficial_de_préstamos_residenciales	Oficial de préstamos residenciales
Oficial_de_red	Oficial de red
Oficial_de_relaciones_Publicas	Oficial de relaciones Publicas
Oficial_de_relación	Oficial de relación
Oficial_de_servicio_al_huésped	Oficial de servicio al huésped
Oficial_principal_de_políticas	Oficial principal de políticas
Operador_Técnico	Operador Técnico
Operador_de_Renta_Fija	Operador de Renta Fija
Operador_de_almacén	Operador de almacén
Operador_de_autoedición	Operador de autoedición
Operador_de_centro_de_datos	Operador de centro de datos
Operador_de_cinta	Operador de cinta
Operador_de_control_de_calidad	Operador de control de calidad
Operador_de_control_maestro	Operador de control maestro
Operador_de_cámara	Operador de cámara
Operador_de_derivados	Operador de derivados
Operador_de_derivados_de_acciones	Operador de derivados de acciones
Operador_de_tablero	Operador de tablero
Operador_del_centro_de_operaciones_de_red	Operador del centro de operaciones de red
Operador_telefónico	Operador telefónico
Organista	Organista
Organizador_de_eventos	Organizador de eventos
Originador_de_préstamos_hipotecarios	Originador de préstamos hipotecarios
Ortodoncista	Ortodoncista
Paisajista	Paisajista
Panadero	Panadero
Paralegal_Corporativo	Paralegal Corporativo
Participante_de_MBA	Participante de MBA
Pasante_Multimedia	Pasante Multimedia
Pasante_de_Adquisición_de_Talento	Pasante de Adquisición de Talento
Pasante_de_Alimentos_y_Bebidas	Pasante de Alimentos y Bebidas
Pasante_de_Animación	Pasante de Animación
Pasante_de_Archivos	Pasante de Archivos
Pasante_de_Banca_de_Inversión	Pasante de Banca de Inversión
Pasante_de_Capital_Privado	Pasante de Capital Privado
Pasante_de_Colecciones	Pasante de Colecciones
Pasante_de_Diseño_Gráfico	Pasante de Diseño Gráfico
Pasante_de_Diseño_de_Moda	Pasante de Diseño de Moda
Pasante_de_Finanzas_Corporativas	Pasante de Finanzas Corporativas
Pasante_de_Gestión_de_Riesgos	Pasante de Gestión de Riesgos
Pasante_de_Ingeniería_Civil	Pasante de Ingeniería Civil
Pasante_de_Ingeniería_Mecánica	Pasante de Ingeniería Mecánica
Pasante_de_Ingeniería_de_Diseño	Pasante de Ingeniería de Diseño
Pasante_de_Ingeniería_de_Sistemas	Pasante de Ingeniería de Sistemas
Pasante_de_Ingeniería_de_Software	Pasante de Ingeniería de Software
Pasante_de_arquitectura_del_paisaje	Pasante de arquitectura del paisaje
Pasante_de_desarrollo_web	Pasante de desarrollo web
Pasante_de_diseño	Pasante de diseño
Pasante_de_investigación_de_acciones	Pasante de investigación de acciones
Pasante_de_música	Pasante de música
Pasante_de_recepción	Pasante de recepción
Pasante_de_servicios_creativos	Pasante de servicios creativos
Pasante_de_soporte_de_escritorio	Pasante de soporte de escritorio
Pasante_del_Programa_de_Gestión_Financiera	Pasante del Programa de Gestión Financiera
Pasante_del_programa_universitario	Pasante del programa universitario
Pasante_deportivo	Pasante deportivo
Pasante_legal_certificado	Pasante legal certificado
Pasantía_de_desarrollador_de_software	Pasantía de desarrollador de software
Paseador_de_perros	Paseador de perros
Pastelero	Pastelero
Payaso	Payaso
Pediatra	Pediatra
Peluquero	Peluquero
Peluquero_y_maquillador	Peluquero y maquillador
Periodista_Financiero	Periodista Financiero
Periodista_de_radiodifusión	Periodista de radiodifusión
Periodista_de_televisión	Periodista de televisión
Periodista_multimedia	Periodista multimedia
Periodista_web	Periodista web
Personal_de_cocina	Personal de cocina
Personal_de_contabilidad	Personal de contabilidad
Personalidad_en_el_aire	Personalidad en el aire
Piloto_Corporativo	Piloto Corporativo
Piloto_comercial	Piloto comercial
Piloto_de_contrato	Piloto de contrato
Piloto_de_línea	Piloto de línea
Pintor	Pintor
Plan_de_ventas	Plan de ventas
Planificador	Planificador
Planificador_Logístico	Planificador Logístico
Planificador_de_bodas_y_eventos	Planificador de bodas y eventos
Planificador_de_conferencias	Planificador de conferencias
Planificador_de_eventos_corporativos	Planificador de eventos corporativos
Planificador_de_eventos_especiales	Planificador de eventos especiales
Planificador_de_marca	Planificador de marca
Planificador_de_medios	Planificador de medios
Planificador_de_medios_digitales	Planificador de medios digitales
Planificador_de_vacaciones	Planificador de vacaciones
Planificador_digital	Planificador digital
Planificador_hipotecario_certificado	Planificador hipotecario certificado
Planificador_urbano	Planificador urbano
Policía	Policía
Policía_Estatal	Policía Estatal
Portavoz	Portavoz
Posadero	Posadero
Postproductor	Postproductor
Practica_privada	Practica privada
Practicante_Departamento_Jurídico	Practicante Departamento Jurídico
Practicante_de_Visual_Merchandising	Practicante de Visual Merchandising
Practicante_de_enfermería	Practicante de enfermería
Preboste	Preboste
Preparador_de_impuestos	Preparador de impuestos
Presentador	Presentador
Presentador_de_noticias_matutinas	Presentador de noticias matutinas
Presentador_de_programa_de_entrevistas	Presentador de programa de entrevistas
Presentador_de_programa_de_entrevistas_de_radio	Presentador de programa de entrevistas de radio
Presentador_de_televisión	Presentador de televisión
Presentador_del_programa_matutino	Presentador del programa matutino
Prestamista_hipotecario	Prestamista hipotecario
Primer_Asistente_de_Redacción	Primer Asistente de Redacción
Primer_asistente_de_cámara	Primer asistente de cámara
Primer_oficial	Primer oficial
Probador_de_aplicaciones	Probador de aplicaciones
Procesador_de_correo	Procesador de correo
Procesador_de_préstamos	Procesador de préstamos
Productor	Productor
Productor_Comercial	Productor Comercial
Productor_Digital	Productor Digital
Productor_Web	Productor Web
Productor_asistente	Productor asistente
Productor_cinematográfico	Productor cinematográfico
Productor_creativo	Productor creativo
Productor_de_Promociones	Productor de Promociones
Productor_de_audio	Productor de audio
Productor_de_casting	Productor de casting
Productor_de_contenido	Productor de contenido
Productor_de_desarrollo	Productor de desarrollo
Productor_de_impresión	Productor de impresión
Productor_de_línea_comercial	Productor de línea comercial
Productor_de_medios_digitales	Productor de medios digitales
Productor_de_música	Productor de música
Productor_de_noticias	Productor de noticias
Productor_de_noticias_de_televisión	Productor de noticias de televisión
Productor_de_nuevos_medios	Productor de nuevos medios
Productor_de_programa	Productor de programa
Productor_de_programas_matutinos	Productor de programas matutinos
Productor_de_radio	Productor de radio
Productor_de_seguros	Productor de seguros
Productor_de_servicios_creativos	Productor de servicios creativos
Productor_de_talentos	Productor de talentos
Productor_de_televisión	Productor de televisión
Productor_de_vídeo	Productor de vídeo
Productor_deportivo	Productor deportivo
Productor_ejecutivo	Productor ejecutivo
Productor_en_línea	Productor en línea
Productor_interactivo	Productor interactivo
Productor_multimedia	Productor multimedia
Productor_técnico	Productor técnico
Profesional_Inmobiliario_Licenciado	Profesional Inmobiliario Licenciado
Profesional_de_la_música	Profesional de la música
Profesor	Profesor
Profesor_Asistente_Visitante	Profesor Asistente Visitante
Profesor_Asistente_de_Filosofía	Profesor Asistente de Filosofía
Profesor_Asociado_Clínico	Profesor Asociado Clínico
Profesor_Emeritus	Profesor Emeritus
Profesor_Inglés_Lengua_Extranjera	Profesor Inglés Lengua Extranjera
Profesor_Universitario	Profesor Universitario
Profesor_adjunto_de_finanzas	Profesor adjunto de finanzas
Profesor_adjunto_de_historia	Profesor adjunto de historia
Profesor_asistente	Profesor asistente
Profesor_asistente_de_administración	Profesor asistente de administración
Profesor_asistente_de_derecho	Profesor asistente de derecho
Profesor_asistente_de_educación	Profesor asistente de educación
Profesor_asistente_de_historia	Profesor asistente de historia
Profesor_asistente_de_inglés	Profesor asistente de inglés
Profesor_asistente_de_medicina	Profesor asistente de medicina
Profesor_auxiliar	Profesor auxiliar
Profesor_bilingüe	Profesor bilingüe
Profesor_de_Antropología	Profesor de Antropología
Profesor_de_Artes_del_Lenguaje	Profesor de Artes del Lenguaje
Profesor_de_Ciencias_Políticas	Profesor de Ciencias Políticas
Profesor_de_Ciencias_de_Secundaria	Profesor de Ciencias de Secundaria
Profesor_de_Diseño_Gráfico	Profesor de Diseño Gráfico
Profesor_de_Historia	Profesor de Historia
Profesor_de_Matemáticas_de_Secundaria	Profesor de Matemáticas de Secundaria
Profesor_de_Secundaria	Profesor de Secundaria
Profesor_de_Sociología	Profesor de Sociología
Profesor_de_Título_1	Profesor de Título 1
Profesor_de_apoyo_al_aprendizaje	Profesor de apoyo al aprendizaje
Profesor_de_arte_del_idioma_inglés	Profesor de arte del idioma inglés
Profesor_de_baile	Profesor de baile
Profesor_de_biologia	Profesor de biologia
Profesor_de_deportes	Profesor de deportes
Profesor_de_diseño	Profesor de diseño
Profesor_de_educación_empresarial	Profesor de educación empresarial
Profesor_de_educación_especial	Profesor de educación especial
Profesor_de_escuela_primaria	Profesor de escuela primaria
Profesor_de_escuela_pública	Profesor de escuela pública
Profesor_de_guitarra	Profesor de guitarra
Profesor_de_instituto	Profesor de instituto
Profesor_de_la_escuela_de_verano	Profesor de la escuela de verano
Profesor_de_lectura	Profesor de lectura
Profesor_de_música	Profesor de música
Profesor_de_preescolar	Profesor de preescolar
Profesor_de_primaria	Profesor de primaria
Profesor_de_secundaria	Profesor de secundaria
Profesor_de_universidad	Profesor de universidad
Profesor_invitado	Profesor invitado
Profesor_jefe_adjunto	Profesor jefe adjunto
Profesora_de_Educación_Primaria	Profesora de Educación Primaria
Profesora_de_ingles_de_secundaria	Profesora de ingles de secundaria
Programa_de_desarrollo_de_ingeniería_de_Edison	Programa de desarrollo de ingeniería de Edison
Programador_de_aplicaciones_web	Programador de aplicaciones web
Programador_multimedia	Programador multimedia
Programador_web	Programador web
Propietario_de_la_agencia	Propietario de la agencia
Propietario_de_salón	Propietario de salón
Préstamo_más_cerca	Préstamo más cerca
Psicoanalista	Psicoanalista
Psicologo_clínico	Psicologo clínico
Psicoterapeuta_en_Práctica_Privada	Psicoterapeuta en Práctica Privada
Psicólogo	Psicólogo
Psicólogo_Clínico_Licenciado	Psicólogo Clínico Licenciado
Psicólogo_Consultor	Psicólogo Consultor
Psicólogo_Jefe	Psicólogo Jefe
Psicólogo_Licenciado	Psicólogo Licenciado
Psicólogo_forense	Psicólogo forense
Publicador_de_escritorio	Publicador de escritorio
Publicar_más_cerca	Publicar más cerca
Publicista	Publicista
Radiógrafo	Radiógrafo
Realizador_de_documentales	Realizador de documentales
Reclutador	Reclutador
Reclutador_Ejecutivo	Reclutador Ejecutivo
Reclutador_Nacional	Reclutador Nacional
Reclutador_científico	Reclutador científico
Reclutador_de_adquisición_de_talentos	Reclutador de adquisición de talentos
Reclutador_de_agencias	Reclutador de agencias
Reclutador_de_atención_médica	Reclutador de atención médica
Reclutador_de_ingeniería	Reclutador de ingeniería
Reclutador_de_recursos_humanos	Reclutador de recursos humanos
Reclutador_de_tecnología	Reclutador de tecnología
Reclutador_de_ventas	Reclutador de ventas
Reclutador_internacional	Reclutador internacional
Reclutador_interno	Reclutador interno
Reclutador_por_contrato	Reclutador por contrato
Reclutador_principal	Reclutador principal
Reclutador_técnico_de_TI	Reclutador técnico de TI
Recogedor	Recogedor
Recursos_ejecutivos	Recursos ejecutivos
Redactor_Creativo	Redactor Creativo
Redactor_Jurídico	Redactor Jurídico
Redactor_Metro	Redactor Metro
Redactor_consultor	Redactor consultor
Redactor_de_Deportes	Redactor de Deportes
Redactor_de_Postproducción	Redactor de Postproducción
Redactor_de_contenido_web	Redactor de contenido web
Redactor_de_contratos	Redactor de contratos
Redactor_de_diseño	Redactor de diseño
Redactor_de_estilo_de_vida	Redactor de estilo de vida
Redactor_de_la_ciudad	Redactor de la ciudad
Redactor_de_publicaciones	Redactor de publicaciones
Redactor_de_viajes	Redactor de viajes
Redactor_editorial	Redactor editorial
Redactor_mecánico	Redactor mecánico
Redactor_publicitario	Redactor publicitario
Redactor_publicitario_de_marketing	Redactor publicitario de marketing
Registrador	Registrador
Relaciones_públicas	Relaciones públicas
Reportero_de_noticias	Reportero de noticias
Reportero_de_noticias_de_televisión	Reportero de noticias de televisión
Reportero_de_tráfico	Reportero de tráfico
Repostero	Repostero
Representante_Financiero	Representante Financiero
Representante_de_Reclamos	Representante de Reclamos
Representante_de_Reclamos_Especiales	Representante de Reclamos Especiales
Representante_de_Relaciones_Públicas	Representante de Relaciones Públicas
Representante_de_Servicio_al_Cliente	Representante de Servicio al Cliente
Representante_de_banca_personal	Representante de banca personal
Representante_de_crédito	Representante de crédito
Representante_de_cuenta_de_publicidad	Representante de cuenta de publicidad
Representante_de_cuenta_de_seguros	Representante de cuenta de seguros
Representante_de_la_agencia	Representante de la agencia
Representante_de_país	Representante de país
Representante_de_préstamos	Representante de préstamos
Representante_de_recepción	Representante de recepción
Representante_de_servicio_al_huésped	Representante de servicio al huésped
Representante_de_soporte_técnico	Representante de soporte técnico
Representante_de_ventas	Representante de ventas
Representante_de_ventas_de_exportación	Representante de ventas de exportación
Representante_de_ventas_de_seguros	Representante de ventas de seguros
Representante_técnico_de_atención_al_cliente	Representante técnico de atención al cliente
Residente	Residente
Residente_de_Anestesiología	Residente de Anestesiología
Residente_de_Farmacia	Residente de Farmacia
Residente_de_Medicina_Interna	Residente de Medicina Interna
Residente_de_práctica_de_farmacia	Residente de práctica de farmacia
Responsable_de_Banca_Privada	Responsable de Banca Privada
Retocador	Retocador
Revisor_Fiscal	Revisor Fiscal
Saborista	Saborista
Saludador	Saludador
Salvavidas	Salvavidas
Sargento	Sargento
Sargento_de_Patrulla	Sargento de Patrulla
Sargento_de_Policia	Sargento de Policia
Secretaria_Ejecutiva_Bilingue	Secretaria Ejecutiva Bilingue
Secretaria_Jurídica_Ejecutiva	Secretaria Jurídica Ejecutiva
Secretaria_legal	Secretaria legal
Secretario_de_Producción	Secretario de Producción
Secretario_de_cortesía	Secretario de cortesía
Seguidor	Seguidor
Segundo_asistente_de_dirección	Segundo asistente de dirección
Segundo_de_a_bordo	Segundo de a bordo
Segundo_oficial	Segundo oficial
Selector_de_pedidos	Selector de pedidos
Servicio_ahora_Desarrollador	Servicio ahora Desarrollador
Servicios_para_clientes_privados	Servicios para clientes privados
Servidor	Servidor
Servidor_de_banquetes	Servidor de banquetes
Servidor_de_comida	Servidor de comida
Servidor_de_cócteles	Servidor de cócteles
Servidor_de_restaurante	Servidor de restaurante
Servidor_principal	Servidor principal
Socio_Litigante	Socio Litigante
Socio_comercial_de_recursos_humanos	Socio comercial de recursos humanos
Socio_de_capital	Socio de capital
Socio_director	Socio director
Socio_director_de_la_oficina	Socio director de la oficina
Socio_fundador	Socio fundador
Soldado	Soldado
Soporte_de_escritorio	Soporte de escritorio
Soporte_de_primera_línea	Soporte de primera línea
Sous_Chef_ejecutivo	Sous Chef ejecutivo
Subastador	Subastador
Subdirector	Subdirector
Subdirector_de_Admisiones_de_Pregrado	Subdirector de Admisiones de Pregrado
Subdirector_de_Comunicaciones	Subdirector de Comunicaciones
Subdirector_de_Desarrollo_de_Negocios	Subdirector de Desarrollo de Negocios
Subdirector_de_Farmacia	Subdirector de Farmacia
Subdirector_de_Noticias	Subdirector de Noticias
Subdirector_de_Seguridad	Subdirector de Seguridad
Subdirector_de_limpieza	Subdirector de limpieza
Subdirector_del_Fondo_Anual	Subdirector del Fondo Anual
Subdirectora_de_Enfermería	Subdirectora de Enfermería
Subgerente	Subgerente
Subgerente_Jurídico	Subgerente Jurídico
Subgerente_de_Alimentos_y_Bebidas	Subgerente de Alimentos y Bebidas
Subgerente_de_Banco	Subgerente de Banco
Subgerente_de_Cartera	Subgerente de Cartera
Subgerente_de_Comunicaciones_Corporativas	Subgerente de Comunicaciones Corporativas
Subgerente_de_Construcción	Subgerente de Construcción
Subgerente_de_Fondos	Subgerente de Fondos
Subgerente_de_Reclutamiento	Subgerente de Reclutamiento
Subgerente_de_Servicios_al_Huésped	Subgerente de Servicios al Huésped
Subgerente_de_barra	Subgerente de barra
Subgerente_de_catering	Subgerente de catering
Subgerente_de_limpieza	Subgerente de limpieza
Subgerente_de_puntos_de_venta	Subgerente de puntos de venta
Subgerente_de_recepción	Subgerente de recepción
Subgerente_de_terminal	Subgerente de terminal
Subgerente_de_ubicación	Subgerente de ubicación
Subjefe_de_Bomberos	Subjefe de Bomberos
Subprofesor	Subprofesor
Subsecretario	Subsecretario
Subsecretario_Corporativo	Subsecretario Corporativo
Superintendente_de_Perforación	Superintendente de Perforación
Superintendente_de_Proyectos	Superintendente de Proyectos
Superintendente_del_sitio	Superintendente del sitio
Superintendente_técnico	Superintendente técnico
Supervisor_Clínico	Supervisor Clínico
Supervisor_Digital	Supervisor Digital
Supervisor_de_Cuenta	Supervisor de Cuenta
Supervisor_de_Implementación	Supervisor de Implementación
Supervisor_de_Imágenes	Supervisor de Imágenes
Supervisor_de_Infraestructura	Supervisor de Infraestructura
Supervisor_de_Ingeniería_de_Producto	Supervisor de Ingeniería de Producto
Supervisor_de_Labores_Domésticas	Supervisor de Labores Domésticas
Supervisor_de_Operaciones_Aeroportuarias	Supervisor de Operaciones Aeroportuarias
Supervisor_de_Operaciones_de_Sucursal	Supervisor de Operaciones de Sucursal
Supervisor_de_Perforación	Supervisor de Perforación
Supervisor_de_Planificación_de_Medios	Supervisor de Planificación de Medios
Supervisor_de_Radiología	Supervisor de Radiología
Supervisor_de_Telecomunicaciones	Supervisor de Telecomunicaciones
Supervisor_de_arte_grupal	Supervisor de arte grupal
Supervisor_de_centro_de_datos	Supervisor de centro de datos
Supervisor_de_control_de_inventario	Supervisor de control de inventario
Supervisor_de_copia_de_grupo	Supervisor de copia de grupo
Supervisor_de_copias	Supervisor de copias
Supervisor_de_interfaz	Supervisor de interfaz
Supervisor_de_logistica	Supervisor de logistica
Supervisor_de_mesa_de_ayuda	Supervisor de mesa de ayuda
Supervisor_de_reclutamiento	Supervisor de reclutamiento
Supervisor_de_soporte_del_sistema	Supervisor de soporte del sistema
Supervisor_de_transmisión	Supervisor de transmisión
Supervisor_guionista	Supervisor guionista
Supervisora_de_Alimentos_y_Bebidas	Supervisora de Alimentos y Bebidas
Supervisora_de_Animación	Supervisora de Animación
Supervisora_de_Diseño_Gráfico	Supervisora de Diseño Gráfico
Supervisora_de_Educación_Especial	Supervisora de Educación Especial
Supervisora_de_Medios_Digitales	Supervisora de Medios Digitales
Supervisora_de_Post_Producción	Supervisora de Post Producción
Supervisora_de_Relaciones_Públicas	Supervisora de Relaciones Públicas
Supervisora_de_Relaciones_con_los_Huéspedes	Supervisora de Relaciones con los Huéspedes
Supervisora_de_Servicios_Creativos	Supervisora de Servicios Creativos
Supervisora_de_Servicios_al_Huésped	Supervisora de Servicios al Huésped
Supervisora_de_Soporte_Técnico	Supervisora de Soporte Técnico
Supervisora_de_Trade_Marketing	Supervisora de Trade Marketing
Supervisora_del_Centro_de_Distribución	Supervisora del Centro de Distribución
Suscriptor_de_Líneas_Personales	Suscriptor de Líneas Personales
Suscriptor_de_campo	Suscriptor de campo
Suscriptor_de_hipotecas	Suscriptor de hipotecas
Suscriptor_de_producción	Suscriptor de producción
Suscriptor_de_préstamos_al_consumidor	Suscriptor de préstamos al consumidor
Suscriptor_de_vida	Suscriptor de vida
Taladrador	Taladrador
Tasador_Certificado_de_Bienes_Raíces	Tasador Certificado de Bienes Raíces
Tasador_de_bienes_raíces	Tasador de bienes raíces
Tasador_residencial_certificado	Tasador residencial certificado
Tecnología	Tecnología
Tecnólogo_Vascular	Tecnólogo Vascular
Tecnólogo_de_Desarrollo	Tecnólogo de Desarrollo
Tecnólogo_de_Garantía_de_Calidad	Tecnólogo de Garantía de Calidad
Tecnólogo_de_Investigación_y_Desarrollo	Tecnólogo de Investigación y Desarrollo
Tecnólogo_de_Procesos	Tecnólogo de Procesos
Tecnólogo_de_Producto	Tecnólogo de Producto
Tecnólogo_de_aplicaciones	Tecnólogo de aplicaciones
Tecnólogo_en_Medicina_Nuclear	Tecnólogo en Medicina Nuclear
Tecnólogo_en_Radiología	Tecnólogo en Radiología
Tecnólogo_en_Ultrasonido	Tecnólogo en Ultrasonido
Tecnólogo_en_desarrollo_de_productos	Tecnólogo en desarrollo de productos
Teniente	Teniente
Terapeuta	Terapeuta
Terapeuta_Clínico	Terapeuta Clínico
Terapeuta_Educativo	Terapeuta Educativo
Terapeuta_Matrimonial_y_Familiar	Terapeuta Matrimonial y Familiar
Terapeuta_basado_en_la_escuela	Terapeuta basado en la escuela
Terapeuta_de_arte	Terapeuta de arte
Terapeuta_matrimonial_y_familiar_con_licencia	Terapeuta matrimonial y familiar con licencia
Trabajador_de_apoyo_familiar	Trabajador de apoyo familiar
Trabajador_del_servicio_de_alimentos	Trabajador del servicio de alimentos
Trabajador_social	Trabajador social
Trabajador_social_clínico	Trabajador social clínico
Trabajador_social_clínico_con_licencia	Trabajador social clínico con licencia
Trader_de_ventas_institucionales	Trader de ventas institucionales
Traductor_de_español	Traductor de español
Traductor_de_ingles	Traductor de ingles
Traductor_interno	Traductor interno
Traductor_japonés	Traductor japonés
Traductor_técnico	Traductor técnico
Transportista_rural	Transportista rural
Tutor_de_Informática	Tutor de Informática
Tutor_de_alfabetización	Tutor de alfabetización
Tutora_de_Lectura	Tutora de Lectura
Tutora_de_español	Tutora de español
Técnico	Técnico
Técnico_Ambiental	Técnico Ambiental
Técnico_Certificado_en_Farmacia	Técnico Certificado en Farmacia
Técnico_Geólogo	Técnico Geólogo
Técnico_Gráfico	Técnico Gráfico
Técnico_IT	Técnico IT
Técnico_Inalámbrico	Técnico Inalámbrico
Técnico_Tributario	Técnico Tributario
Técnico_Veterinario	Técnico Veterinario
Técnico_Veterinario_Colegiado	Técnico Veterinario Colegiado
Técnico_de_Anestesia	Técnico de Anestesia
Técnico_de_Archivos	Técnico de Archivos
Técnico_de_Atención_al_Usuario	Técnico de Atención al Usuario
Técnico_de_Comunicaciones	Técnico de Comunicaciones
Técnico_de_Configuración	Técnico de Configuración
Técnico_de_Control_de_Redes	Técnico de Control de Redes
Técnico_de_Despliegue	Técnico de Despliegue
Técnico_de_Laboratorio_de_Computación	Técnico de Laboratorio de Computación
Técnico_de_Mantenimiento_de_Equipos	Técnico de Mantenimiento de Equipos
Técnico_de_Operaciones_de_Campo	Técnico de Operaciones de Campo
Técnico_de_Permisos	Técnico de Permisos
Técnico_de_Redacción	Técnico de Redacción
Técnico_de_Redes	Técnico de Redes
Técnico_de_Redes_Informáticas	Técnico de Redes Informáticas
Técnico_de_Servicio_Informático	Técnico de Servicio Informático
Técnico_de_Soporte_Informático	Técnico de Soporte Informático
Técnico_de_Soporte_Tecnológico	Técnico de Soporte Tecnológico
Técnico_de_TI_de_campo	Técnico de TI de campo
Técnico_de_Telecomunicaciones	Técnico de Telecomunicaciones
Técnico_de_Urgencias	Técnico de Urgencias
Técnico_de_atención_al_cliente	Técnico de atención al cliente
Técnico_de_aviónica	Técnico de aviónica
Técnico_de_ayuda_informática	Técnico de ayuda informática
Técnico_de_banco	Técnico de banco
Técnico_de_emergencias_médicas	Técnico de emergencias médicas
Técnico_de_ferretería	Técnico de ferretería
Técnico_de_fotografía	Técnico de fotografía
Técnico_de_la_mesa_de_servicio	Técnico de la mesa de servicio
Técnico_de_laboratorio_fotográfico	Técnico de laboratorio fotográfico
Técnico_de_medios	Técnico de medios
Técnico_de_piano	Técnico de piano
Técnico_de_piso	Técnico de piso
Técnico_de_reparación	Técnico de reparación
Técnico_de_salud_conductual	Técnico de salud conductual
Técnico_de_soporte	Técnico de soporte
Técnico_de_soporte_de_TI	Técnico de soporte de TI
Técnico_de_soporte_de_aplicaciones	Técnico de soporte de aplicaciones
Técnico_de_soporte_de_campo	Técnico de soporte de campo
Técnico_de_soporte_de_escritorio	Técnico de soporte de escritorio
Técnico_de_soporte_de_mesa_de_ayuda	Técnico de soporte de mesa de ayuda
Técnico_de_soporte_de_productos	Técnico de soporte de productos
Técnico_de_soporte_de_red	Técnico de soporte de red
Técnico_de_soporte_de_software	Técnico de soporte de software
Técnico_de_soporte_del_sistema	Técnico de soporte del sistema
Técnico_de_transmisión	Técnico de transmisión
Técnico_en_Automatización	Técnico en Automatización
Técnico_en_Computación_Personal	Técnico en Computación Personal
Técnico_en_Equipos_Biomédicos	Técnico en Equipos Biomédicos
Técnico_en_Hardware_Informático	Técnico en Hardware Informático
Técnico_en_Imagen_Digital	Técnico en Imagen Digital
Técnico_en_Ingeniería_Civil	Técnico en Ingeniería Civil
Técnico_en_Ingeniería_Mecánica	Técnico en Ingeniería Mecánica
Técnico_en_Radiología	Técnico en Radiología
Técnico_en_Reparación_de_Computadoras_Personales	Técnico en Reparación de Computadoras Personales
Técnico_en_Sistemas_Informáticos	Técnico en Sistemas Informáticos
Técnico_en_computación	Técnico en computación
Técnico_en_cuidado_de_animales	Técnico en cuidado de animales
Técnico_en_sitio	Técnico en sitio
Vendedor_minorista	Vendedor minorista
Ventas_de_Derivados_de_Renta_Variable	Ventas de Derivados de Renta Variable
Ventas_de_acciones	Ventas de acciones
Vicecanciller	Vicecanciller
Vicedecano_de_Admisiones	Vicedecano de Admisiones
Viceministra	Viceministra
Vicepresidenta_Asistente_de_Desarrollo_de_Negocios	Vicepresidenta Asistente de Desarrollo de Negocios
Vicepresidente_Ejecutivo_de_Desarrollo_de_Negocios	Vicepresidente Ejecutivo de Desarrollo de Negocios
Vicepresidente_Junta_Directiva	Vicepresidente Junta Directiva
Vicepresidente_asistente	Vicepresidente asistente
Vicepresidente_asistente_de_suscripción	Vicepresidente asistente de suscripción
Vicepresidente_de_Adquisición_de_Talento	Vicepresidente de Adquisición de Talento
Vicepresidente_de_Alimentos_y_Bebidas	Vicepresidente de Alimentos y Bebidas
Vicepresidente_de_Desarrollo_Organizacional	Vicepresidente de Desarrollo Organizacional
Vicepresidente_de_Desarrollo_de_Negocios	Vicepresidente de Desarrollo de Negocios
Vicepresidente_de_Gestión_del_Talento	Vicepresidente de Gestión del Talento
Vicepresidente_de_Iniciativas_Estratégicas	Vicepresidente de Iniciativas Estratégicas
Vicepresidente_de_Reclutamiento	Vicepresidente de Reclutamiento
Vicepresidente_de_Relaciones_Externas	Vicepresidente de Relaciones Externas
Vicepresidente_de_Ventas_Institucionales	Vicepresidente de Ventas Institucionales
Vicepresidente_de_Ventas_de_Capital_Institucional	Vicepresidente de Ventas de Capital Institucional
Vicepresidente_de_gestión_de_activos	Vicepresidente de gestión de activos
Vicepresidente_de_operaciones_comerciales	Vicepresidente de operaciones comerciales
Vicepresidente_de_préstamos_hipotecarios	Vicepresidente de préstamos hipotecarios
Vicepresidente_de_préstamos_residenciales	Vicepresidente de préstamos residenciales
Vicepresidente_de_recursos_humanos_globales	Vicepresidente de recursos humanos globales
Vicepresidente_de_servicios_creativos	Vicepresidente de servicios creativos
Videoperiodista	Videoperiodista
Visitador_médico	Visitador médico
Vocalista	Vocalista
Webmaster_Corporativo	Webmaster Corporativo
abogado_corporativo	abogado corporativo
abogado_de_contrato	abogado de contrato
abogado_de_la_corte	abogado de la corte
abogado_de_planta	abogado de planta
abogado_especial	abogado especial
abogado_fiscal	abogado fiscal
abogado_litigante	abogado litigante
abogado_principal	abogado principal
actor_profesional	actor profesional
agente_hipotecario	agente hipotecario
almacenista	almacenista
analista_de_fondos	analista de fondos
analista_de_marketing	analista de marketing
analista_de_materias_primas	analista de materias primas
analista_de_políticas	analista de políticas
analista_de_recursos_humanos	analista de recursos humanos
analista_de_software	analista de software
analista_de_transacciones	analista de transacciones
ancla_deportiva	ancla deportiva
aprendiz_de_software	aprendiz de software
artista	artista
asistente_comercial	asistente comercial
asistente_de_Logistica	asistente de Logistica
asistente_de_animador	asistente de animador
asistente_de_aula	asistente de aula
asistente_de_banquero_privado	asistente de banquero privado
asistente_de_conferencias	asistente de conferencias
asistente_de_corredor	asistente de corredor
asistente_de_instrucción	asistente de instrucción
asistente_de_moda	asistente de moda
asistente_de_reclutamiento	asistente de reclutamiento
asistente_de_suscripción	asistente de suscripción
asistente_del_planificador	asistente del planificador
asistente_judicial	asistente judicial
asociado_de_contabilidad	asociado de contabilidad
asociado_de_recursos_humanos	asociado de recursos humanos
bailarina_principal	bailarina principal
banquero_comercial	banquero comercial
banquero_de_relaciones	banquero de relaciones
banquero_hipotecario	banquero hipotecario
banquero_principal	banquero principal
banquero_universal	banquero universal
becario_creativo	becario creativo
bibliotecario	bibliotecario
bibliotecario_corporativo	bibliotecario corporativo
bibliotecario_de_investigación	bibliotecario de investigación
bibliotecario_jefe	bibliotecario jefe
bibliotecario_universitario	bibliotecario universitario
bloguero	bloguero
camarera_de_cócteles	camarera de cócteles
capataz_de_trabajo	capataz de trabajo
capitán_de_bomberos	capitán de bomberos
capitán_de_línea_aérea	capitán de línea aérea
capitán_de_policía	capitán de policía
catalogador	catalogador
chef_de_banquetes	chef de banquetes
chef_de_catering	chef de catering
chef_de_restaurante	chef de restaurante
comercializador_en_línea	comercializador en línea
comerciante_de_futuros	comerciante de futuros
comerciante_propietario	comerciante propietario
consultor_de_personal	consultor de personal
contador_de_nómina	contador de nómina
copiloto	copiloto
corredor_de_finanzas	corredor de finanzas
corredor_de_piso	corredor de piso
cosmetóloga	cosmetóloga
crítico_de_arte	crítico de arte
decorador	decorador
dentista_general	dentista general
director_de_banda	director de banda
director_de_fotografía	director de fotografía
director_de_gira	director de gira
director_de_hospital	director de hospital
director_de_operaciones	director de operaciones
director_de_préstamos	director de préstamos
director_de_talento	director de talento
director_del_juego	director del juego
director_dental	director dental
director_deportivo	director deportivo
director_médico	director médico
directora_de_cartera	directora de cartera
directora_de_educación	directora de educación
directora_de_preescolar	directora de preescolar
directora_de_teatro	directora de teatro
directora_editorial	directora editorial
diseñador_civil	diseñador civil
diseñador_de_calzado	diseñador de calzado
diseñador_de_productos	diseñador de productos
diseñador_de_ropa	diseñador de ropa
diseñador_floral	diseñador floral
diseñador_visual	diseñador visual
dueño_del_restaurante	dueño del restaurante
editor_ávido	editor ávido
educador_especial	educador especial
empleado_de_alimentos	empleado de alimentos
empleado_de_asistencia	empleado de asistencia
empleado_de_auditoría	empleado de auditoría
empleado_de_cobranzas	empleado de cobranzas
empleado_de_importación	empleado de importación
empleado_de_mariscos	empleado de mariscos
empleado_de_panadería	empleado de panadería
empleado_de_producción	empleado de producción
empleado_de_préstamo	empleado de préstamo
endodoncista	endodoncista
enfermera_quirúrgica	enfermera quirúrgica
enlace_clínico	enlace clínico
ensacadora	ensacadora
entrenador_de_instrucción	entrenador de instrucción
escritor_creativo	escritor creativo
escritor_de_negocios	escritor de negocios
especialista_en_relaciones_publicas	especialista en relaciones publicas
estilista_de_fotos	estilista de fotos
estratega_de_acciones	estratega de acciones
estratega_de_contenido	estratega de contenido
estratega_de_cuentas	estratega de cuentas
estratega_de_inversiones	estratega de inversiones
estratega_de_marketing	estratega de marketing
estratega_de_medios	estratega de medios
estratega_de_producto	estratega de producto
estudiante_reportero	estudiante reportero
estudiante_voluntario	estudiante voluntario
examinador_de_banco	examinador de banco
examinador_externo	examinador externo
financiador	financiador
fotógrafo_de_moda	fotógrafo de moda
fuente	fuente
funcionario	funcionario
geocientífico	geocientífico
gerente_de_comisión	gerente de comisión
hidrólogo	hidrólogo
ilustrador	ilustrador
ingeniero_de_interfaz_de_usuario	ingeniero de interfaz de usuario
ingeniero_de_pozos	ingeniero de pozos
ingeniero_de_soporte_técnico	ingeniero de soporte técnico
ingeniero_de_terminación	ingeniero de terminación
ingeniero_empresarial	ingeniero empresarial
inspector_de_construccion	inspector de construccion
inspector_de_correos	inspector de correos
instructor_de_vuelo	instructor de vuelo
intensivista	intensivista
investigador_de_campo	investigador de campo
investigador_especial	investigador especial
investigador_jefe	investigador jefe
jefe_de_camareros	jefe de camareros
jefe_de_comercio	jefe de comercio
jefe_de_contenido	jefe de contenido
jefe_de_grupo_de_recursos_humanos	jefe de grupo de recursos humanos
jefe_de_política	jefe de política
jefe_de_publicación	jefe de publicación
jefe_de_publicidad	jefe de publicidad
jefe_de_residentes	jefe de residentes
lingüista_ruso	lingüista ruso
líder_de_personal	líder de personal
líder_del_grupo	líder del grupo
maestro_carpintero	maestro carpintero
maestro_estilista	maestro estilista
maestro_fontanero	maestro fontanero
manipulador_de_materiales	manipulador de materiales
mayor_jubilado	mayor jubilado
medico_general	medico general
metalúrgico_de_plantas	metalúrgico de plantas
miembro_del_cuerpo	miembro del cuerpo
miembro_del_personal_técnico	miembro del personal técnico
mixólogo	mixólogo
muralista	muralista
médico_de_planta	médico de planta
médico_tratante	médico tratante
neonatólogo	neonatólogo
oficial_de_bomberos	oficial de bomberos
oficial_de_defensa	oficial de defensa
oficial_de_efectivo	oficial de efectivo
oficial_de_ex_alumnos	oficial de ex alumnos
oficial_de_guardia	oficial de guardia
oficial_de_investigaciones	oficial de investigaciones
oficial_de_la_ley	oficial de la ley
oficial_de_operaciones	oficial de operaciones
oficial_de_paz	oficial de paz
oficial_de_recaudación_de_fondos	oficial de recaudación de fondos
oficial_de_telecomunicaciones	oficial de telecomunicaciones
oficial_de_título	oficial de título
oficial_marino	oficial marino
oficial_marítimo	oficial marítimo
oficial_medio	oficial medio
oficina_de_reclutamiento	oficina de reclutamiento
paraeducador	paraeducador
pasante_de_admisiones	pasante de admisiones
pasante_de_construcción	pasante de construcción
peluquero	peluquero
perfusionista	perfusionista
personal_de_piso	personal de piso
piloto_jefe	piloto jefe
planificador_de_cuentas	planificador de cuentas
practicante_legal	practicante legal
primer_asistente_de_dirección	primer asistente de dirección
primer_ingeniero	primer ingeniero
producir_asociado	producir asociado
profesor_de_arquitectura	profesor de arquitectura
profesor_de_arte	profesor de arte
profesor_de_cirugia	profesor de cirugia
profesor_de_educación	profesor de educación
profesor_de_filosofia	profesor de filosofia
profesor_de_ingles	profesor de ingles
profesor_de_matematicas	profesor de matematicas
profesor_de_sociología	profesor de sociología
profesora_de_ingles	profesora de ingles
profesora_de_italiano	profesora de italiano
programador_php	programador php
reclutador	reclutador
reclutador_financiero	reclutador financiero
reclutador_medico	reclutador medico
recogepedidos	recogepedidos
redactor	redactor
registrador_universitario	registrador universitario
reportero_de_mercado	reportero de mercado
reportero_deportivo	reportero deportivo
reportero_jefe	reportero jefe
secretario_de_caso	secretario de caso
secretario_judicial	secretario judicial
segundo_asistente	segundo asistente
segundo_chef	segundo chef
segundo_subgerente	segundo subgerente
subjefe_de_policía	subjefe de policía
superintendente_de_construcción	superintendente de construcción
superintendente_general	superintendente general
superintendente_marino	superintendente marino
supervisor_civil	supervisor civil
supervisor_comercial	supervisor comercial
supervisor_de_barra	supervisor de barra
supervisor_de_catering	supervisor de catering
supervisor_de_cocina	supervisor de cocina
supervisor_de_contabilidad_general	supervisor de contabilidad general
supervisor_de_contenido	supervisor de contenido
supervisor_de_credito	supervisor de credito
supervisor_de_despacho	supervisor de despacho
supervisor_de_estrategia	supervisor de estrategia
supervisor_de_impuestos	supervisor de impuestos
supervisor_de_la_casa	supervisor de la casa
supervisor_de_medios	supervisor de medios
supervisor_de_nómina	supervisor de nómina
supervisor_de_publicidad	supervisor de publicidad
supervisor_de_recepción	supervisor de recepción
supervisor_de_spa	supervisor de spa
supervisor_de_transporte	supervisor de transporte
supervisor_del_restaurante	supervisor del restaurante
supervisor_editorial	supervisor editorial
supervisor_gerente	supervisor gerente
supervisora_de_banquetes	supervisora de banquetes
supervisora_de_cierre	supervisora de cierre
supervisora_de_clínica	supervisora de clínica
supervisora_de_farmacia	supervisora de farmacia
supervisora_de_precios	supervisora de precios
supervisora_de_recepción	supervisora de recepción
supervisora_de_reclutamiento	supervisora de reclutamiento
suscriptor_de_seguros	suscriptor de seguros
tecladista	tecladista
tecnólogo_del_personal	tecnólogo del personal
teniente_de_bomberos	teniente de bomberos
teniente_de_policia	teniente de policia
titular_de_la_llave	titular de la llave
vicepresidente	vicepresidente
vicepresidente_de_reclutamiento	vicepresidente de reclutamiento
vicepresidente_ejecutivo	vicepresidente ejecutivo
videógrafo	videógrafo
visualizador	visualizador
Árbitro	Árbitro
