Absolwent_MBA	Absolwent MBA
Administrator_bezpieczeństwa_IT	Administrator bezpieczeństwa IT
Administrator_sieci	Administrator sieci
Administrator_systemu	Administrator systemu
Agent_ubezpieczeniowy	Agent ubezpieczeniowy
Analityk_HR	Analityk HR
Analityk_Kredytowy	Analityk Kredytowy
Analityk_bezpieczeństwa_IT	Analityk bezpieczeństwa IT
Analityk_ds._Badań_Rynku	Analityk ds. Badań Rynku
Analityk_systemu	Analityk systemu
Analityk_systemów_informatycznych_HR	Analityk systemów informatycznych HR
Animator_postaci_3D	Animator postaci 3D
Architekt_techniczny	Architekt techniczny
Artysta_3D	Artysta 3D
Artysta_środowiska_3D	Artysta środowiska 3D
Asystent_rekrutacji_HR	Asystent rekrutacji HR
Biuro_kierownika_zespołu	Biuro kierownika zespołu
Cukiernik	Cukiernik
Dyrektor_Rozwoju_Biznesu	Dyrektor Rozwoju Biznesu
Dyrektor_ds._Budowy	Dyrektor ds. Budowy
Edytor_wideo	Edytor wideo
Edytor_zdjęć	Edytor zdjęć
Eksploracja_VP	Eksploracja VP
Generalista_3D	Generalista 3D
Generalista_HR	Generalista HR
Generalista_IT	Generalista IT
HR_partner_biznesowy	HR partner biznesowy
Inicjatywy_strategiczne_wiceprezesa	Inicjatywy strategiczne wiceprezesa
Inspektor_policji	Inspektor policji
Inżynier_Produkcji	Inżynier Produkcji
Inżynier_VoIP	Inżynier VoIP
Inżynier_bezpieczeństwa_IT	Inżynier bezpieczeństwa IT
Inżynier_budowy	Inżynier budowy
Inżynier_interfejsu_użytkownika	Inżynier interfejsu użytkownika
Inżynier_mechanik	Inżynier mechanik
Inżynier_sieci_VoIP	Inżynier sieci VoIP
Inżynier_systemów_informatycznych	Inżynier systemów informatycznych
Inżynier_systemów_wsparcia_biznesu	Inżynier systemów wsparcia biznesu
Inżynier_wsparcia_technicznego	Inżynier wsparcia technicznego
Inżynieria_elektryczna	Inżynieria elektryczna
Kandydat_MBA	Kandydat MBA
Kierownik_Działu_Rozwoju_Biznesu	Kierownik Działu Rozwoju Biznesu
Kierownik_działu	Kierownik działu
Kierownik_eksportu	Kierownik eksportu
Konsultant_HR	Konsultant HR
Konsultant_IT	Konsultant IT
Konsultant_ds._rekrutacji_IT	Konsultant ds. rekrutacji IT
Koordynator_rekrutacji_HR	Koordynator rekrutacji HR
Koordynator_zasobów_ludzkich	Koordynator zasobów ludzkich
Księgowi	Księgowi
Logistyka	Logistyka
Medical_Science_Liaison	Medical Science Liaison
Menedżer_HR	Menedżer HR
Menedżer_ds._Rozwoju_Rynkowego	Menedżer ds. Rozwoju Rynkowego
Menedżer_lokalizacji	Menedżer lokalizacji
Menedżer_produktywności	Menedżer produktywności
Menedżer_relacji	Menedżer relacji
Menedżer_talentów	Menedżer talentów
Mikser_dźwięku	Mikser dźwięku
Modelarz_3D	Modelarz 3D
Nauczyciel_dramatu	Nauczyciel dramatu
Nauczyciel_szkoły_podstawowej	Nauczyciel szkoły podstawowej
Oficer_prasowy	Oficer prasowy
Opiekun_konta	Opiekun konta
Posterunkowy	Posterunkowy
Pośrednik_nieruchomości	Pośrednik nieruchomości
Pracownik_gastronomii	Pracownik gastronomii
Praktyka_prywatna	Praktyka prywatna
Prawnik_procesu	Prawnik procesu
Programista_PHP	Programista PHP
Programista_stron_internetowych_PHP	Programista stron internetowych PHP
Projektant_interfejsu_użytkownika	Projektant interfejsu użytkownika
Projektant_strony_internetowej	Projektant strony internetowej
Przedstawiciel_Biura_Obsługi_Klienta	Przedstawiciel Biura Obsługi Klienta
Rekruter_HR	Rekruter HR
Rekruter_IT	Rekruter IT
Rekruter_techniczny_IT	Rekruter techniczny IT
Reporter	Reporter
Rzeczoznawca_majątkowy	Rzeczoznawca majątkowy
Specjalista_do_spraw_IT	Specjalista do spraw IT
Specjalista_ds._rekrutacji	Specjalista ds. rekrutacji
Specjalista_ds._rekrutacji_HR	Specjalista ds. rekrutacji HR
Specjalista_od_Mediów_Społecznościowych	Specjalista od Mediów Społecznościowych
Specjalista_wsparcia_IT	Specjalista wsparcia IT
Steward	Steward
Strategia_wiceprezesa	Strategia wiceprezesa
Stylista_mody	Stylista mody
Szef_policji	Szef policji
Sędzia_okręgowy	Sędzia okręgowy
Technik_terenowy_IT	Technik terenowy IT
Technik_wsparcia_IT	Technik wsparcia IT
Twórca_aplikacji	Twórca aplikacji
Twórca_aplikacji_na_iOS	Twórca aplikacji na iOS
Twórca_produktu	Twórca produktu
Uczestnik_MBA	Uczestnik MBA
Uprzejmym_urzędnikiem	Uprzejmym urzędnikiem
Urzędnik_poczty	Urzędnik poczty
Wiceprezes_ds._kredytów_hipotecznych	Wiceprezes ds. kredytów hipotecznych
Wiceprezes_ds._kredytów_mieszkaniowych	Wiceprezes ds. kredytów mieszkaniowych
Wiceprezes_ds._operacji_biznesowych	Wiceprezes ds. operacji biznesowych
Wiceprezes_ds._pozyskiwania_talentów	Wiceprezes ds. pozyskiwania talentów
Wiceprezes_ds._rekrutacji	Wiceprezes ds. rekrutacji
Wiceprezes_ds._rozwoju_biznesu	Wiceprezes ds. rozwoju biznesu
Wiceprezes_ds._rozwoju_organizacyjnego	Wiceprezes ds. rozwoju organizacyjnego
Wiceprezes_ds._sprzedaży_akcji_instytucjonalnych	Wiceprezes ds. sprzedaży akcji instytucjonalnych
Wiceprezes_ds._sprzedaży_instytucjonalnej	Wiceprezes ds. sprzedaży instytucjonalnej
Wiceprezes_ds._stosunków_zewnętrznych	Wiceprezes ds. stosunków zewnętrznych
Wiceprezes_ds._usług_kreatywnych	Wiceprezes ds. usług kreatywnych
Wiceprezes_ds._zarządzania_aktywami	Wiceprezes ds. zarządzania aktywami
Wiceprezes_ds._zarządzania_talentami	Wiceprezes ds. zarządzania talentami
Wiceprezes_ds._żywności_i_napojów	Wiceprezes ds. żywności i napojów
Wiceprezes_globalnego_HR	Wiceprezes globalnego HR
Wiceprezes_wykonawczy	Wiceprezes wykonawczy
Wiceprezes_wykonawczy_ds._rozwoju_biznesu	Wiceprezes wykonawczy ds. rozwoju biznesu
Współpracownik_HR	Współpracownik HR
Zarządzający_funduszem	Zarządzający funduszem
Zespół_ołowiu	Zespół ołowiu
absolwent_architekta	absolwent architekta
absolwent_inżynier_mechanik	absolwent inżynier mechanik
absolwent_inżyniera_budownictwa	absolwent inżyniera budownictwa
absolwent_inżynierii_lądowej	absolwent inżynierii lądowej
adiunkt	adiunkt
adiunkt_filozofii	adiunkt filozofii
adiunkt_finansów	adiunkt finansów
adiunkt_historii	adiunkt historii
adiunkt_języka_angielskiego	adiunkt języka angielskiego
adiunkt_medycyny	adiunkt medycyny
adiunkt_pedagogiki	adiunkt pedagogiki
adiunkt_prawa	adiunkt prawa
adiunkt_zarządzania	adiunkt zarządzania
administrator_bezpieczeństwa	administrator bezpieczeństwa
administrator_bezpieczeństwa_danych	administrator bezpieczeństwa danych
administrator_bezpieczeństwa_informacji	administrator bezpieczeństwa informacji
administrator_bezpieczeństwa_sieci	administrator bezpieczeństwa sieci
administrator_biura_obsługi	administrator biura obsługi
administrator_centrum_danych	administrator centrum danych
administrator_centrum_pomocy	administrator centrum pomocy
administrator_giełdy	administrator giełdy
administrator_internetu	administrator internetu
administrator_kadr	administrator kadr
administrator_logistyki	administrator logistyki
administrator_podatkowy	administrator podatkowy
administrator_pulpitu	administrator pulpitu
administrator_rachunków	administrator rachunków
administrator_serwera	administrator serwera
administrator_sieci_lokalnej	administrator sieci lokalnej
administrator_sieci_systemowej	administrator sieci systemowej
administrator_systemu_Microsoftu	administrator systemu Microsoftu
adwokat	adwokat
adwokat_sądowy	adwokat sądowy
agencja_rekrutacyjna	agencja rekrutacyjna
agent_biletowy	agent biletowy
agent_działu_obsługi	agent działu obsługi
agent_federalny	agent federalny
agent_frontowy	agent frontowy
agent_hipoteczny	agent hipoteczny
agent_kupujących	agent kupujących
agent_logistyczny	agent logistyczny
agent_nieruchomości	agent nieruchomości
agent_nieruchomości_komercyjnych	agent nieruchomości komercyjnych
agent_nieruchomości_mieszkaniowych	agent nieruchomości mieszkaniowych
agent_polecający	agent polecający
agent_rezerwacji	agent rezerwacji
agent_skarbowy	agent skarbowy
agent_specjalny	agent specjalny
agent_sprzedaży_nieruchomości	agent sprzedaży nieruchomości
agent_sprzedaży_rezerwacji	agent sprzedaży rezerwacji
agent_wynajmu	agent wynajmu
akcjonariusz	akcjonariusz
akcjonariusz_zarządzający	akcjonariusz zarządzający
akompaniator	akompaniator
ambasador_przyjęć	ambasador przyjęć
analityk_Biznesowy	analityk Biznesowy
analityk_administracyjny	analityk administracyjny
analityk_akcji	analityk akcji
analityk_bankowości_inwestycyjnej	analityk bankowości inwestycyjnej
analityk_bankowości_korporacyjnej	analityk bankowości korporacyjnej
analityk_bankowości_prywatnej	analityk bankowości prywatnej
analityk_banku_prywatnego	analityk banku prywatnego
analityk_bezpieczeństwa_informacji	analityk bezpieczeństwa informacji
analityk_bezpieczeństwa_sieci	analityk bezpieczeństwa sieci
analityk_centrum_danych	analityk centrum danych
analityk_centrum_operacji_sieciowych	analityk centrum operacji sieciowych
analityk_centrum_serwisowego	analityk centrum serwisowego
analityk_centrum_wsparcia	analityk centrum wsparcia
analityk_danych_rynkowych	analityk danych rynkowych
analityk_dochodów_stałych	analityk dochodów stałych
analityk_drugiej_linii_wsparcia	analityk drugiej linii wsparcia
analityk_ds._badań_inwestycyjnych	analityk ds. badań inwestycyjnych
analityk_ds._badań_kapitałowych	analityk ds. badań kapitałowych
analityk_ds._badań_kredytowych	analityk ds. badań kredytowych
analityk_ds._rekrutacji	analityk ds. rekrutacji
analityk_ds._wsparcia_sporów_sądowych	analityk ds. wsparcia sporów sądowych
analityk_działu_pomocy_technicznej	analityk działu pomocy technicznej
analityk_finansowy	analityk finansowy
analityk_finansów_lewarowanych	analityk finansów lewarowanych
analityk_finansów_przedsiębiorstw	analityk finansów przedsiębiorstw
analityk_finansów_strukturalnych	analityk finansów strukturalnych
analityk_funduszy	analityk funduszy
analityk_funduszy_hedgingowych	analityk funduszy hedgingowych
analityk_funduszy_inwestycyjnych	analityk funduszy inwestycyjnych
analityk_handlowy	analityk handlowy
analityk_importu	analityk importu
analityk_importu_i_eksportu	analityk importu i eksportu
analityk_inwestycyjny	analityk inwestycyjny
analityk_kapitału_wysokiego_ryzyka	analityk kapitału wysokiego ryzyka
analityk_kredytów_korporacyjnych	analityk kredytów korporacyjnych
analityk_logistyki	analityk logistyki
analityk_marketingowy	analityk marketingowy
analityk_marketingu_produktów	analityk marketingu produktów
analityk_marki	analityk marki
analityk_nieruchomości	analityk nieruchomości
analityk_obsługi_klienta	analityk obsługi klienta
analityk_operacji_sieciowych	analityk operacji sieciowych
analityk_oprogramowania	analityk oprogramowania
analityk_planowania_strategicznego	analityk planowania strategicznego
analityk_podatkowy	analityk podatkowy
analityk_polityki	analityk polityki
analityk_private_equity	analityk private equity
analityk_programistyczny	analityk programistyczny
analityk_ratingowy	analityk ratingowy
analityk_rozwoju_firmy	analityk rozwoju firmy
analityk_rozwoju_oprogramowania	analityk rozwoju oprogramowania
analityk_rynku_finansowego	analityk rynku finansowego
analityk_rynku_kapitałowego	analityk rynku kapitałowego
analityk_sieciowy	analityk sieciowy
analityk_stresu	analityk stresu
analityk_systemów_doradczych	analityk systemów doradczych
analityk_systemów_informatycznych	analityk systemów informatycznych
analityk_systemów_informatycznych_personelu	analityk systemów informatycznych personelu
analityk_systemów_operacyjnych	analityk systemów operacyjnych
analityk_technologii	analityk technologii
analityk_testów_automatycznych	analityk testów automatycznych
analityk_towarowy	analityk towarowy
analityk_transakcyjny	analityk transakcyjny
analityk_treści	analityk treści
analityk_wsparcia_klienta	analityk wsparcia klienta
analityk_wsparcia_komputerowego	analityk wsparcia komputerowego
analityk_wsparcia_komputerów_stacjonarnych	analityk wsparcia komputerów stacjonarnych
analityk_wsparcia_oprogramowania	analityk wsparcia oprogramowania
analityk_wsparcia_sieci	analityk wsparcia sieci
analityk_wsparcia_technicznego	analityk wsparcia technicznego
analityk_wsparcia_technicznego_helpdesku	analityk wsparcia technicznego helpdesku
analityk_wsparcia_technologicznego	analityk wsparcia technologicznego
analityk_wsparcia_terenowego	analityk wsparcia terenowego
analityk_wyceny	analityk wyceny
analityk_wyników_inwestycji	analityk wyników inwestycji
analityk_wywiadu_rynkowego	analityk wywiadu rynkowego
analityk_zarządzania_portfelem	analityk zarządzania portfelem
animator	animator
animator_flashowy	animator flashowy
animator_komputerowy	animator komputerowy
animator_postaci	animator postaci
animator_techniczny	animator techniczny
arbiter	arbiter
architekt	architekt
architekt_Javy	architekt Javy
architekt_projektu	architekt projektu
architekt_przestrzeni	architekt przestrzeni
architekt_sieci	architekt sieci
architekt_technologii	architekt technologii
architekt_średnio_zaawansowany	architekt średnio zaawansowany
archiwista_projektu	archiwista projektu
arteterapeuta	arteterapeuta
artykułowany_asystent	artykułowany asystent
artysta	artysta
artysta_animacji	artysta animacji
artysta_efektów_wizualnych	artysta efektów wizualnych
artysta_gier	artysta gier
artysta_gościnny	artysta gościnny
artysta_grafik	artysta grafik
artysta_grafik_komputerowy	artysta grafik komputerowy
artysta_koncepcyjny	artysta koncepcyjny
artysta_malujący	artysta malujący
artysta_plastyk	artysta plastyk
artysta_postaci	artysta postaci
artysta_produkcyjny	artysta produkcyjny
artysta_płomieni	artysta płomieni
artysta_rezydent	artysta rezydent
artysta_rozwoju_wizualnego	artysta rozwoju wizualnego
artysta_studyjny	artysta studyjny
artysta_techniczny	artysta techniczny
artysta_tekstur	artysta tekstur
artysta_układu	artysta układu
artysta_występujący	artysta występujący
artysta_zajmujący_się_produkcją_graficzną	artysta zajmujący się produkcją graficzną
asystent_analityka_systemowego	asystent analityka systemowego
asystent_animatora	asystent animatora
asystent_architekta	asystent architekta
asystent_archiwisty	asystent archiwisty
asystent_bankowości_prywatnej	asystent bankowości prywatnej
asystent_brokera	asystent brokera
asystent_depozytowy	asystent depozytowy
asystent_ds._marketingu_handlowego	asystent ds. marketingu handlowego
asystent_ds._relacji_społecznych	asystent ds. relacji społecznych
asystent_ds._rozwoju_produktu	asystent ds. rozwoju produktu
asystent_edytora_wideo	asystent edytora wideo
asystent_eksportu_importu	asystent eksportu importu
asystent_fotografa	asystent fotografa
asystent_galerii	asystent galerii
asystent_handlowy	asystent handlowy
asystent_hodowli	asystent hodowli
asystent_instruktorski	asystent instruktorski
asystent_inżyniera_mechanika	asystent inżyniera mechanika
asystent_inżyniera_projektu	asystent inżyniera projektu
asystent_kamery	asystent kamery
asystent_kierownika_lokalizacji	asystent kierownika lokalizacji
asystent_kierownika_rezerwacji	asystent kierownika rezerwacji
asystent_konferencji	asystent konferencji
asystent_kredytu_komercyjnego	asystent kredytu komercyjnego
asystent_księgowego_zarządu	asystent księgowego zarządu
asystent_kuchenny	asystent kuchenny
asystent_lekarza	asystent lekarza
asystent_logistyki	asystent logistyki
asystent_medyczny	asystent medyczny
asystent_menadżera	asystent menadżera
asystent_menedżera_ds._relacji	asystent menedżera ds. relacji
asystent_menedżera_marki	asystent menedżera marki
asystent_menedżera_portfela	asystent menedżera portfela
asystent_menedżera_przychodów	asystent menedżera przychodów
asystent_menedżera_treści	asystent menedżera treści
asystent_mody	asystent mody
asystent_nauczyciela_przedszkola	asystent nauczyciela przedszkola
asystent_opieki_nad_dziećmi	asystent opieki nad dziećmi
asystent_pedagoga_specjalnego	asystent pedagoga specjalnego
asystent_pedagogiki_specjalnej	asystent pedagogiki specjalnej
asystent_planisty	asystent planisty
asystent_planowania_wydarzeń	asystent planowania wydarzeń
asystent_postprodukcji	asystent postprodukcji
asystent_prawnika	asystent prawnika
asystent_prawny_firmy	asystent prawny firmy
asystent_prawny_korporacyjny	asystent prawny korporacyjny
asystent_procesowy	asystent procesowy
asystent_producenta	asystent producenta
asystent_produkcji_biurowej	asystent produkcji biurowej
asystent_produkcji_zestawu	asystent produkcji zestawu
asystent_projektanta	asystent projektanta
asystent_projektanta_graficznego	asystent projektanta graficznego
asystent_projektanta_technicznego	asystent projektanta technicznego
asystent_projektu	asystent projektu
asystent_prywatnego_bankiera	asystent prywatnego bankiera
asystent_psychologiczny	asystent psychologiczny
asystent_publikacji	asystent publikacji
asystent_radcy_prawnego	asystent radcy prawnego
asystent_radcy_prawnego_korporacji	asystent radcy prawnego korporacji
asystent_redakcji	asystent redakcji
asystent_redaktora	asystent redaktora
asystent_rekrutacji	asystent rekrutacji
asystent_sprzedaży_detalicznej	asystent sprzedaży detalicznej
asystent_szefa_kuchni	asystent szefa kuchni
asystent_sędziego	asystent sędziego
asystent_telekomunikacyjny	asystent telekomunikacyjny
asystent_transmisji	asystent transmisji
asystent_trenera_piłki_nożnej	asystent trenera piłki nożnej
asystent_trenera_siły_i_kondycji	asystent trenera siły i kondycji
asystent_underwritingu	asystent underwritingu
asystent_w_klasie	asystent w klasie
asystent_weterynaryjny	asystent weterynaryjny
asystent_wiceprezesa	asystent wiceprezesa
asystent_wiceprezesa_ds._rozwoju_biznesu	asystent wiceprezesa ds. rozwoju biznesu
asystentka_przedszkola	asystentka przedszkola
audytor_podatkowy	audytor podatkowy
autor_treści	autor treści
autor_treści_internetowych	autor treści internetowych
badacz	badacz
badacz_korporacyjny	badacz korporacyjny
badacz_mediów	badacz mediów
badacz_oszustw	badacz oszustw
badacz_prawa	badacz prawa
badacz_regionalny	badacz regionalny
badacz_terenowy	badacz terenowy
badacz_tła	badacz tła
bagrownica	bagrownica
bankier_hipoteczny	bankier hipoteczny
bankier_komercyjny	bankier komercyjny
bankier_relacji	bankier relacji
bankier_uniwersalny	bankier uniwersalny
barman	barman
basista	basista
bibliotekarz	bibliotekarz
bibliotekarz_badawczy	bibliotekarz badawczy
bibliotekarz_korporacyjny	bibliotekarz korporacyjny
bibliotekarz_medialny	bibliotekarz medialny
bibliotekarz_uniwersytecki	bibliotekarz uniwersytecki
bibliotekarz_usług_publicznych	bibliotekarz usług publicznych
bloger	bloger
broker_finansowy	broker finansowy
broker_frachtowy	broker frachtowy
broker_instrumentów_pochodnych	broker instrumentów pochodnych
broker_instrumentów_pochodnych_na_akcje	broker instrumentów pochodnych na akcje
broker_kontraktów_futures	broker kontraktów futures
broker_partnerski	broker partnerski
broker_podłogowy	broker podłogowy
broker_reasekuracyjny	broker reasekuracyjny
broker_zarządzający	broker zarządzający
brygadzista_pracy	brygadzista pracy
brygadzista_projektu	brygadzista projektu
budowniczy	budowniczy
błazen	błazen
certyfikowana_asystentka_pielęgniarska	certyfikowana asystentka pielęgniarska
certyfikowany_doradca_hipoteczny	certyfikowany doradca hipoteczny
certyfikowany_koordynator_badań_klinicznych	certyfikowany koordynator badań klinicznych
certyfikowany_księgowy	certyfikowany księgowy
certyfikowany_rzeczoznawca_majątkowy	certyfikowany rzeczoznawca majątkowy
certyfikowany_rzeczoznawca_mieszkaniowy	certyfikowany rzeczoznawca mieszkaniowy
certyfikowany_specjalista_planowania_kredytu_hipotecznego	certyfikowany specjalista planowania kredytu hipotecznego
certyfikowany_stażysta_prawniczy	certyfikowany stażysta prawniczy
certyfikowany_trener_personalny	certyfikowany trener personalny
chirurg	chirurg
chirurg_jamy_ustnej_i_szczękowo-twarzowej	chirurg jamy ustnej i szczękowo-twarzowej
chirurg_zwierzęcy	chirurg zwierzęcy
choreograf	choreograf
chudy_instruktor	chudy instruktor
concierge	concierge
copywriter	copywriter
copywriter_kontraktowy	copywriter kontraktowy
copywriter_marketingowy	copywriter marketingowy
copywriter_reklamowy	copywriter reklamowy
cukiernik	cukiernik
cyfrowy_nadzorca	cyfrowy nadzorca
cyfrowy_planista	cyfrowy planista
członek_korpusu	członek korpusu
członek_personelu_technicznego	członek personelu technicznego
członek_rady_doradców	członek rady doradców
członek_zespołu	członek zespołu
członek_zespołu_sprzedaży	członek zespołu sprzedaży
cóż,_inżynier	cóż, inżynier
dealer_akcji	dealer akcji
dekorator_zestawów	dekorator zestawów
dentysta_ogólny	dentysta ogólny
detektyw_policyjny	detektyw policyjny
deweloper	deweloper
deweloper_biznesowy	deweloper biznesowy
diagnosta_pedagogiczny	diagnosta pedagogiczny
dobry_artysta	dobry artysta
dokumentalista	dokumentalista
domowy_scenarzysta	domowy scenarzysta
doradca	doradca
doradca_bankowy_osobisty	doradca bankowy osobisty
doradca_ds._edukacji	doradca ds. edukacji
doradca_ds._kredytów_hipotecznych_na_dom	doradca ds. kredytów hipotecznych na dom
doradca_ds._kredytów_mieszkaniowych	doradca ds. kredytów mieszkaniowych
doradca_ds._podatków_od_osób_prawnych	doradca ds. podatków od osób prawnych
doradca_ds._podróży	doradca ds. podróży
doradca_ds._rekrutacji_prawników	doradca ds. rekrutacji prawników
doradca_ds._studiów_za_granicą	doradca ds. studiów za granicą
doradca_kliniczny	doradca kliniczny
doradca_kontaktowy	doradca kontaktowy
doradca_korporacyjny	doradca korporacyjny
doradca_kosmetyczny	doradca kosmetyczny
doradca_personalny	doradca personalny
doradca_podatkowy	doradca podatkowy
doradca_procesowy	doradca procesowy
doradca_regulacyjny	doradca regulacyjny
doradca_rodzinny	doradca rodzinny
doradca_szkolny_w_szkole_podstawowej	doradca szkolny w szkole podstawowej
doradca_wydziałowy	doradca wydziałowy
doradca_zdrowia_psychicznego	doradca zdrowia psychicznego
doradca_zewnętrzny	doradca zewnętrzny
dorosła_pielęgniarka	dorosła pielęgniarka
dostawca_sieci	dostawca sieci
dozorca	dozorca
drugi_asystent	drugi asystent
drugi_asystent_reżysera	drugi asystent reżysera
drugi_kolega	drugi kolega
drugi_oficer	drugi oficer
drugi_zastępca_menedżera	drugi zastępca menedżera
dwujęzyczny_sekretarz_wykonawczy	dwujęzyczny sekretarz wykonawczy
dyplomowana_higienistka_stomatologiczna	dyplomowana higienistka stomatologiczna
dyplomowanego_technika_farmacji	dyplomowanego technika farmacji
dyplomowany_analityk_finansowy	dyplomowany analityk finansowy
dyrektor	dyrektor
dyrektor_artystyczny	dyrektor artystyczny
dyrektor_artystyczny_techniczny	dyrektor artystyczny techniczny
dyrektor_bankowości_korporacyjnej	dyrektor bankowości korporacyjnej
dyrektor_biura	dyrektor biura
dyrektor_centrum_operacji_sieciowych	dyrektor centrum operacji sieciowych
dyrektor_cukierniczy	dyrektor cukierniczy
dyrektor_ds._badań_kapitałowych	dyrektor ds. badań kapitałowych
dyrektor_ds._finansów_korporacyjnych	dyrektor ds. finansów korporacyjnych
dyrektor_ds._finansów_strukturalnych	dyrektor ds. finansów strukturalnych
dyrektor_ds._importu	dyrektor ds. importu
dyrektor_ds._importu_i_eksportu	dyrektor ds. importu i eksportu
dyrektor_ds._kredytów	dyrektor ds. kredytów
dyrektor_ds._logistyki	dyrektor ds. logistyki
dyrektor_ds._marketingu_i_komunikacji	dyrektor ds. marketingu i komunikacji
dyrektor_ds._mediów	dyrektor ds. mediów
dyrektor_ds._operacji_biznesowych	dyrektor ds. operacji biznesowych
dyrektor_ds._partnerstwa_korporacyjnego	dyrektor ds. partnerstwa korporacyjnego
dyrektor_ds._podróży	dyrektor ds. podróży
dyrektor_ds._postępowań_sądowych	dyrektor ds. postępowań sądowych
dyrektor_ds._poszukiwań_wykonawczych	dyrektor ds. poszukiwań wykonawczych
dyrektor_ds._pozyskiwania_talentów	dyrektor ds. pozyskiwania talentów
dyrektor_ds._prawnych	dyrektor ds. prawnych
dyrektor_ds._projektowania_i_rozwoju	dyrektor ds. projektowania i rozwoju
dyrektor_ds._public_relations	dyrektor ds. public relations
dyrektor_ds._rekrutacji	dyrektor ds. rekrutacji
dyrektor_ds._relacji	dyrektor ds. relacji
dyrektor_ds._relacji_korporacyjnych_i_fundacyjnych	dyrektor ds. relacji korporacyjnych i fundacyjnych
dyrektor_ds._relacji_z_gośćmi	dyrektor ds. relacji z gośćmi
dyrektor_ds._relacji_z_mediami	dyrektor ds. relacji z mediami
dyrektor_ds._rozwoju_biznesu	dyrektor ds. rozwoju biznesu
dyrektor_ds._rozwoju_funduszu	dyrektor ds. rozwoju funduszu
dyrektor_ds._rozwoju_i_public_relations	dyrektor ds. rozwoju i public relations
dyrektor_ds._rozwoju_sprzętu	dyrektor ds. rozwoju sprzętu
dyrektor_ds._rozwoju_strategicznego	dyrektor ds. rozwoju strategicznego
dyrektor_ds._rozwoju_talentów	dyrektor ds. rozwoju talentów
dyrektor_ds._rozwoju_widowni	dyrektor ds. rozwoju widowni
dyrektor_ds._sprzedaży_eksportowej	dyrektor ds. sprzedaży eksportowej
dyrektor_ds._stałych_dochodów	dyrektor ds. stałych dochodów
dyrektor_ds._strategii_i_operacji	dyrektor ds. strategii i operacji
dyrektor_ds._ubezpieczeń	dyrektor ds. ubezpieczeń
dyrektor_ds._usług_członkowskich	dyrektor ds. usług członkowskich
dyrektor_ds._zarządzania_rekrutacją	dyrektor ds. zarządzania rekrutacją
dyrektor_ds._żywności_i_napojów	dyrektor ds. żywności i napojów
dyrektor_edukacji_medycznej	dyrektor edukacji medycznej
dyrektor_elektrotechniki	dyrektor elektrotechniki
dyrektor_fitness	dyrektor fitness
dyrektor_fizjoterapii	dyrektor fizjoterapii
dyrektor_fundraisingu	dyrektor fundraisingu
dyrektor_gastronomii	dyrektor gastronomii
dyrektor_generalny_obszaru	dyrektor generalny obszaru
dyrektor_generalny_restauracji	dyrektor generalny restauracji
dyrektor_gry	dyrektor gry
dyrektor_handlowy	dyrektor handlowy
dyrektor_imprezy_prywatnej	dyrektor imprezy prywatnej
dyrektor_inwestycyjny	dyrektor inwestycyjny
dyrektor_kapitału_ludzkiego	dyrektor kapitału ludzkiego
dyrektor_konta	dyrektor konta
dyrektor_konta_cyfrowego	dyrektor konta cyfrowego
dyrektor_kopii	dyrektor kopii
dyrektor_logistyki	dyrektor logistyki
dyrektor_medialny_grupy	dyrektor medialny grupy
dyrektor_mediów_społecznościowych	dyrektor mediów społecznościowych
dyrektor_muzyczny	dyrektor muzyczny
dyrektor_naczelny	dyrektor naczelny
dyrektor_obsługi_klienta	dyrektor obsługi klienta
dyrektor_operacji_lotniczych	dyrektor operacji lotniczych
dyrektor_operacji_nadawczych	dyrektor operacji nadawczych
dyrektor_operacji_produkcyjnych	dyrektor operacji produkcyjnych
dyrektor_operacji_sieciowych	dyrektor operacji sieciowych
dyrektor_operacyjny	dyrektor operacyjny
dyrektor_oświaty	dyrektor oświaty
dyrektor_personalny	dyrektor personalny
dyrektor_piętra	dyrektor piętra
dyrektor_planowanego_dawania	dyrektor planowanego dawania
dyrektor_planowania_grupowego	dyrektor planowania grupowego
dyrektor_podatkowy	dyrektor podatkowy
dyrektor_podstawówki	dyrektor podstawówki
dyrektor_portfela	dyrektor portfela
dyrektor_postprodukcji	dyrektor postprodukcji
dyrektor_produkcji_telewizyjnej	dyrektor produkcji telewizyjnej
dyrektor_przedbudowy	dyrektor przedbudowy
dyrektor_przedszkola	dyrektor przedszkola
dyrektor_przeprowadzki	dyrektor przeprowadzki
dyrektor_przyjęć	dyrektor przyjęć
dyrektor_radiologii	dyrektor radiologii
dyrektor_redakcyjny	dyrektor redakcyjny
dyrektor_ryzyka	dyrektor ryzyka
dyrektor_sportowy	dyrektor sportowy
dyrektor_sprzedaży_cateringu	dyrektor sprzedaży cateringu
dyrektor_sprzedaży_czasu_wolnego	dyrektor sprzedaży czasu wolnego
dyrektor_sprzedaży_i_marketingu	dyrektor sprzedaży i marketingu
dyrektor_sprzedaży_instytucjonalnej	dyrektor sprzedaży instytucjonalnej
dyrektor_studiów	dyrektor studiów
dyrektor_szkoły	dyrektor szkoły
dyrektor_szkoły_podstawowej	dyrektor szkoły podstawowej
dyrektor_szpitala	dyrektor szpitala
dyrektor_służb_medialnych	dyrektor służb medialnych
dyrektor_służb_rodzinnych	dyrektor służb rodzinnych
dyrektor_służb_specjalnych	dyrektor służb specjalnych
dyrektor_talentów	dyrektor talentów
dyrektor_techniczny_postaci	dyrektor techniczny postaci
dyrektor_terenowy_agencji	dyrektor terenowy agencji
dyrektor_treningu_personalnego	dyrektor treningu personalnego
dyrektor_underwritingu	dyrektor underwritingu
dyrektor_usług_gastronomicznych	dyrektor usług gastronomicznych
dyrektor_usług_obrazowania	dyrektor usług obrazowania
dyrektor_uwielbienia	dyrektor uwielbienia
dyrektor_w_miejscu_zamieszkania	dyrektor w miejscu zamieszkania
dyrektor_wiadomości	dyrektor wiadomości
dyrektor_wycieczki	dyrektor wycieczki
dyrektor_wydarzenia	dyrektor wydarzenia
dyrektor_wydarzeń_specjalnych	dyrektor wydarzeń specjalnych
dyrektor_wydawniczy	dyrektor wydawniczy
dyrektor_wywiadu_rynkowego	dyrektor wywiadu rynkowego
dyrektor_zapisów	dyrektor zapisów
dyrektor_zarządzający	dyrektor zarządzający
dyrektor_zarządzający_wydarzeniami	dyrektor zarządzający wydarzeniami
dyrektor_zbiorów	dyrektor zbiorów
dyrektor_zespołu	dyrektor zespołu
dyrektor_śledczy	dyrektor śledczy
dyspozytor	dyspozytor
dyspozytor_pogotowia	dyspozytor pogotowia
dział_importu	dział importu
dziekan	dziekan
dziekan_ds._przyjęć	dziekan ds. przyjęć
dziennikarz	dziennikarz
dziennikarz_finansowy	dziennikarz finansowy
dziennikarz_internetowy	dziennikarz internetowy
dziennikarz_multimedialny	dziennikarz multimedialny
dziennikarz_telewizyjny	dziennikarz telewizyjny
dziennikarz_wideo	dziennikarz wideo
efektywność_organizacyjna_dyrektora	efektywność organizacyjna dyrektora
egzaminator_bankowy	egzaminator bankowy
egzaminator_tytułowy	egzaminator tytułowy
egzaminator_zewnętrzny	egzaminator zewnętrzny
ekspert_biznesowy	ekspert biznesowy
ekspert_ds._bezpieczeństwa	ekspert ds. bezpieczeństwa
ekspert_ds._logistyki	ekspert ds. logistyki
ekspert_krajowy	ekspert krajowy
ekspert_telekomunikacji	ekspert telekomunikacji
ekspert_wsparcia_technicznego	ekspert wsparcia technicznego
emerytowany_profesor	emerytowany profesor
endodonta	endodonta
estymator_projektu	estymator projektu
facylitator_grupy	facylitator grupy
farmaceuta_ds._regulacyjnych	farmaceuta ds. regulacyjnych
farmaceuta_kliniczny	farmaceuta kliniczny
farmaceuta_personelu_klinicznego	farmaceuta personelu klinicznego
farmaceuta_produkcyjny	farmaceuta produkcyjny
federalny_menadżer_podatkowy	federalny menadżer podatkowy
felietonista	felietonista
filmowiec	filmowiec
firma_programistyczna	firma programistyczna
fotograf_eventowy	fotograf eventowy
fotograf_kontraktowy	fotograf kontraktowy
fotograf_mody	fotograf mody
fotograf_pracowniczy	fotograf pracowniczy
fotograf_sportowy	fotograf sportowy
fotograf_sztuk_pięknych	fotograf sztuk pięknych
fryzjer	fryzjer
fryzjerka_i_wizażystka	fryzjerka i wizażystka
fundator	fundator
funkcje_pisarza	funkcje pisarza
funkcjonariusz_absolwentów	funkcjonariusz absolwentów
funkcjonariusz_korekcyjny	funkcjonariusz korekcyjny
funkcjonariusz_organów_ścigania	funkcjonariusz organów ścigania
funkcjonariusz_policji_rezerwy	funkcjonariusz policji rezerwy
funkcjonariusz_prawny	funkcjonariusz prawny
funkcjonariusz_przesłuchujący	funkcjonariusz przesłuchujący
funkcjonariusz_straży_pożarnej	funkcjonariusz straży pożarnej
generalny_inżynier_terenowy	generalny inżynier terenowy
generalny_nadinspektor	generalny nadinspektor
geofizyk_przetwarzający	geofizyk przetwarzający
geolog	geolog
geolog_badawczy	geolog badawczy
geolog_kontraktowy	geolog kontraktowy
geolog_kopalniany	geolog kopalniany
geolog_projektu	geolog projektu
geolog_terenowy	geolog terenowy
geolog_zbiornikowy	geolog zbiornikowy
geolog_środowiskowy	geolog środowiskowy
gitarzysta	gitarzysta
globalny_menadżer_logistyki	globalny menadżer logistyki
globalny_menedżer_ds._komunikacji	globalny menedżer ds. komunikacji
globalny_menedżer_ds._podróży	globalny menedżer ds. podróży
globalny_menedżer_ds._public_relations	globalny menedżer ds. public relations
globalny_menedżer_ds._rozwoju_biznesu	globalny menedżer ds. rozwoju biznesu
gospodarz	gospodarz
gospodarz_porannego_programu	gospodarz porannego programu
gospodarz_talk-show	gospodarz talk-show
gospodarz_talk-show_w_radiu	gospodarz talk-show w radiu
gracz	gracz
grafik_środowiskowy	grafik środowiskowy
grupowy_radca_prawny	grupowy radca prawny
gwarant_kredytu_hipotecznego	gwarant kredytu hipotecznego
gwarant_kredytu_konsumenckiego	gwarant kredytu konsumenckiego
gwarant_produkcji	gwarant produkcji
gwarant_terenowy	gwarant terenowy
gwarant_życia	gwarant życia
główny_architekt_krajobrazu	główny architekt krajobrazu
główny_badacz	główny badacz
główny_bankier	główny bankier
główny_barman	główny barman
główny_bibliotekarz	główny bibliotekarz
główny_dentysta	główny dentysta
główny_doradca_podatkowy	główny doradca podatkowy
główny_dyrektor_artystyczny	główny dyrektor artystyczny
główny_dyrektor_kreatywny	główny dyrektor kreatywny
główny_geolog	główny geolog
główny_grafik	główny grafik
główny_handlarz	główny handlarz
główny_hydrogeolog	główny hydrogeolog
główny_instruktor	główny instruktor
główny_instruktor_lotu	główny instruktor lotu
główny_instruktor_strzelectwa	główny instruktor strzelectwa
główny_inżynier	główny inżynier
główny_inżynier_bezpieczeństwa	główny inżynier bezpieczeństwa
główny_inżynier_budownictwa	główny inżynier budownictwa
główny_inżynier_elektryk	główny inżynier elektryk
główny_inżynier_mechanik	główny inżynier mechanik
główny_inżynier_oprogramowania	główny inżynier oprogramowania
główny_inżynier_projektant	główny inżynier projektant
główny_inżynier_sprzętu	główny inżynier sprzętu
główny_kasjer	główny kasjer
główny_kelner	główny kelner
główny_korespondent	główny korespondent
główny_księgowy	główny księgowy
główny_kurator	główny kurator
główny_lekarz_medyczny	główny lekarz medyczny
główny_menadżer	główny menadżer
główny_menadżer_konta	główny menadżer konta
główny_menadżer_portfela	główny menadżer portfela
główny_menedżer_ds._prezentów	główny menedżer ds. prezentów
główny_mieszkaniec	główny mieszkaniec
główny_operator_sterujący	główny operator sterujący
główny_opiekun	główny opiekun
główny_pilot	główny pilot
główny_podatek	główny podatek
główny_prawnik	główny prawnik
główny_prawnik_i_sekretarz_firmy	główny prawnik i sekretarz firmy
główny_projektant	główny projektant
główny_psycholog	główny psycholog
główny_radca_prawny	główny radca prawny
główny_rekruter	główny rekruter
główny_reporter	główny reporter
główny_serwer	główny serwer
główny_steward	główny steward
główny_tancerz	główny tancerz
główny_trener	główny trener
główny_trener_piłki_nożnej	główny trener piłki nożnej
główny_urzędnik_ds._polityki	główny urzędnik ds. polityki
główny_wykonawca	główny wykonawca
główny_śledczy	główny śledczy
handlarz_dziełami_sztuki	handlarz dziełami sztuki
handlarz_instrumentami_pochodnymi	handlarz instrumentami pochodnymi
handlarz_kontraktami_terminowymi	handlarz kontraktami terminowymi
handlarz_opcjami	handlarz opcjami
handlarz_walutami	handlarz walutami
handlowiec	handlowiec
handlowiec_zajmujący_się_sprzedażą_akcji	handlowiec zajmujący się sprzedażą akcji
hiszpański_Tłumacz	hiszpański Tłumacz
hodowca	hodowca
hydrogeolog_projektu	hydrogeolog projektu
hydrolog	hydrolog
ilustrator	ilustrator
ilustrator_medyczny	ilustrator medyczny
indywidualny_menadżer_dawania	indywidualny menadżer dawania
inspektor_budowlany	inspektor budowlany
inspektor_pocztowy	inspektor pocztowy
inspektor_podatkowy	inspektor podatkowy
instruktor_aerobiku_w_wodzie	instruktor aerobiku w wodzie
instruktor_animacji	instruktor animacji
instruktor_aqua_aerobiku	instruktor aqua aerobiku
instruktor_bootcampu	instruktor bootcampu
instruktor_broni_palnej	instruktor broni palnej
instruktor_crossfitu	instruktor crossfitu
instruktor_fitness_grupowego	instruktor fitness grupowego
instruktor_gotowania	instruktor gotowania
instruktor_jazdy_na_rowerze_stacjonarnym	instruktor jazdy na rowerze stacjonarnym
instruktor_kinezjologii	instruktor kinezjologii
instruktor_kliniczny	instruktor kliniczny
instruktor_księgowości	instruktor księgowości
instruktor_kulinarny	instruktor kulinarny
instruktor_latania	instruktor latania
instruktor_lotu	instruktor lotu
instruktor_mosiądzu	instruktor mosiądzu
instruktor_muzyki	instruktor muzyki
instruktor_pielęgniarstwa	instruktor pielęgniarstwa
instruktor_pitchingu	instruktor pitchingu
instruktor_projektowania	instruktor projektowania
instruktor_projektowania_graficznego	instruktor projektowania graficznego
instruktor_socjologii	instruktor socjologii
instruktor_sportu	instruktor sportu
instruktor_studiów_magisterskich	instruktor studiów magisterskich
instruktor_sztuk_walki	instruktor sztuk walki
instruktor_szycia	instruktor szycia
instruktor_tańca	instruktor tańca
instruktor_uniwersytecki	instruktor uniwersytecki
instruktor_wioślarstwa	instruktor wioślarstwa
instruktor_wizytujący	instruktor wizytujący
instruktor-adiunkt	instruktor-adiunkt
instruktorka_cheerleaderek	instruktorka cheerleaderek
integrator_sieci	integrator sieci
intensywny	intensywny
interaktywny_dyrektor_artystyczny	interaktywny dyrektor artystyczny
interaktywny_menadżer_multimediów	interaktywny menadżer multimediów
interaktywny_menedżer_sprzedaży	interaktywny menedżer sprzedaży
inwestor_na_własny_rachunek	inwestor na własny rachunek
inżynier_Edisona	inżynier Edisona
inżynier_Procesu	inżynier Procesu
inżynier_Produktu	inżynier Produktu
inżynier_aerodynamiki	inżynier aerodynamiki
inżynier_aplikacji	inżynier aplikacji
inżynier_aplikacji_korporacyjnych	inżynier aplikacji korporacyjnych
inżynier_aplikacji_personelu	inżynier aplikacji personelu
inżynier_automatyk_procesowy	inżynier automatyk procesowy
inżynier_automatyk_projektowy	inżynier automatyk projektowy
inżynier_automatyk_zapewnienia_jakości	inżynier automatyk zapewnienia jakości
inżynier_badań_i_rozwoju	inżynier badań i rozwoju
inżynier_badań_personelu	inżynier badań personelu
inżynier_bezpieczeństwa	inżynier bezpieczeństwa
inżynier_bezpieczeństwa_informacji	inżynier bezpieczeństwa informacji
inżynier_bezpieczeństwa_sieci	inżynier bezpieczeństwa sieci
inżynier_bezprzewodowy	inżynier bezprzewodowy
inżynier_biura_technicznego	inżynier biura technicznego
inżynier_bsc	inżynier bsc
inżynier_budownictwa	inżynier budownictwa
inżynier_certyfikacji	inżynier certyfikacji
inżynier_chemiczny	inżynier chemiczny
inżynier_diagnosta	inżynier diagnosta
inżynier_drenażu	inżynier drenażu
inżynier_ds._wydania_projektu	inżynier ds. wydania projektu
inżynier_ds._zapewnienia_jakości_oprogramowania	inżynier ds. zapewnienia jakości oprogramowania
inżynier_działu_pomocy_technicznej	inżynier działu pomocy technicznej
inżynier_dźwięku	inżynier dźwięku
inżynier_elektromechanik	inżynier elektromechanik
inżynier_elektryczny	inżynier elektryczny
inżynier_elektryk_i_elektronik	inżynier elektryk i elektronik
inżynier_elektryk_i_oprzyrządowanie	inżynier elektryk i oprzyrządowanie
inżynier_firewalla	inżynier firewalla
inżynier_geolog	inżynier geolog
inżynier_górnictwa	inżynier górnictwa
inżynier_głosu	inżynier głosu
inżynier_infrastruktury_sieciowej	inżynier infrastruktury sieciowej
inżynier_innowacji	inżynier innowacji
inżynier_integracji_sieciowej	inżynier integracji sieciowej
inżynier_integralności_sygnału	inżynier integralności sygnału
inżynier_kalibracji	inżynier kalibracji
inżynier_kliniczny	inżynier kliniczny
inżynier_kontroli_procesu	inżynier kontroli procesu
inżynier_logistyki	inżynier logistyki
inżynier_lotniczy	inżynier lotniczy
inżynier_mechanik_kontraktowy	inżynier mechanik kontraktowy
inżynier_mechanik_procesowy	inżynier mechanik procesowy
inżynier_medyczny	inżynier medyczny
inżynier_metalurgia	inżynier metalurgia
inżynier_miejski	inżynier miejski
inżynier_mobilny	inżynier mobilny
inżynier_mostowy	inżynier mostowy
inżynier_naftowy	inżynier naftowy
inżynier_nagrań	inżynier nagrań
inżynier_naprawy	inżynier naprawy
inżynier_napędu	inżynier napędu
inżynier_nawierzchni	inżynier nawierzchni
inżynier_ogrzewania_i_klimatyzacji	inżynier ogrzewania i klimatyzacji
inżynier_okręgowy	inżynier okręgowy
inżynier_opakowań	inżynier opakowań
inżynier_operacji_sieciowych	inżynier operacji sieciowych
inżynier_operacyjny_w_terenie	inżynier operacyjny w terenie
inżynier_oprogramowania	inżynier oprogramowania
inżynier_oprogramowania_Java	inżynier oprogramowania Java
inżynier_pełnego_stosu	inżynier pełnego stosu
inżynier_planowania_radiowego	inżynier planowania radiowego
inżynier_planowania_sieci	inżynier planowania sieci
inżynier_portowy	inżynier portowy
inżynier_procesu_zakładowego	inżynier procesu zakładowego
inżynier_projektant_analogowy	inżynier projektant analogowy
inżynier_projektant_elektroniki	inżynier projektant elektroniki
inżynier_projektant_produkcji	inżynier projektant produkcji
inżynier_projektowania_cyfrowego	inżynier projektowania cyfrowego
inżynier_projektowania_i_rozwoju	inżynier projektowania i rozwoju
inżynier_projektowania_i_rozwoju_produktów	inżynier projektowania i rozwoju produktów
inżynier_projektowania_procesów	inżynier projektowania procesów
inżynier_projektu	inżynier projektu
inżynier_projektu_budowlanego	inżynier projektu budowlanego
inżynier_projektu_elektrycznego	inżynier projektu elektrycznego
inżynier_projektu_fizycznego	inżynier projektu fizycznego
inżynier_projektu_mechanik	inżynier projektu mechanik
inżynier_projektu_układu	inżynier projektu układu
inżynier_projektujący_obwody	inżynier projektujący obwody
inżynier_projektujący_oprogramowanie_sprzętowe	inżynier projektujący oprogramowanie sprzętowe
inżynier_projektujący_sieć	inżynier projektujący sieć
inżynier_projektujący_sprzęt	inżynier projektujący sprzęt
inżynier_projektujący_sygnały_mieszane	inżynier projektujący sygnały mieszane
inżynier_projektujący_systemy	inżynier projektujący systemy
inżynier_projektujący_testy	inżynier projektujący testy
inżynier_projektów_telekomunikacyjnych	inżynier projektów telekomunikacyjnych
inżynier_przedsiębiorstwa	inżynier przedsiębiorstwa
inżynier_radiowy	inżynier radiowy
inżynier_rezydent	inżynier rezydent
inżynier_rolnictwa	inżynier rolnictwa
inżynier_rozwoju_elektroniki	inżynier rozwoju elektroniki
inżynier_rozwoju_mechanicznego	inżynier rozwoju mechanicznego
inżynier_rozwoju_oprogramowania	inżynier rozwoju oprogramowania
inżynier_rozwoju_oprogramowania_w_teście	inżynier rozwoju oprogramowania w teście
inżynier_rozwoju_sprzętu	inżynier rozwoju sprzętu
inżynier_scada	inżynier scada
inżynier_sekcji	inżynier sekcji
inżynier_sieci	inżynier sieci
inżynier_sieci_Cisco	inżynier sieci Cisco
inżynier_sieci_bezprzewodowej	inżynier sieci bezprzewodowej
inżynier_sieci_danych	inżynier sieci danych
inżynier_sieci_komputerowych	inżynier sieci komputerowych
inżynier_sieci_korporacyjnej	inżynier sieci korporacyjnej
inżynier_sieci_szkieletowej	inżynier sieci szkieletowej
inżynier_sieciowy	inżynier sieciowy
inżynier_skrzyni_biegów	inżynier skrzyni biegów
inżynier_sprzętu	inżynier sprzętu
inżynier_sprzętu_komputerowego	inżynier sprzętu komputerowego
inżynier_stacji	inżynier stacji
inżynier_stacjonarny	inżynier stacjonarny
inżynier_statku_kosmicznego	inżynier statku kosmicznego
inżynier_stresu	inżynier stresu
inżynier_symulacji	inżynier symulacji
inżynier_systemowy	inżynier systemowy
inżynier_systemowy_Microsoftu	inżynier systemowy Microsoftu
inżynier_systemu_nadawczego	inżynier systemu nadawczego
inżynier_systemów_automatyki	inżynier systemów automatyki
inżynier_systemów_elektronicznych	inżynier systemów elektronicznych
inżynier_systemów_mechanicznych	inżynier systemów mechanicznych
inżynier_systemów_sieciowych	inżynier systemów sieciowych
inżynier_systemów_sprzętowych	inżynier systemów sprzętowych
inżynier_systemów_sterowania	inżynier systemów sterowania
inżynier_systemów_telekomunikacyjnych	inżynier systemów telekomunikacyjnych
inżynier_systemów_wbudowanych	inżynier systemów wbudowanych
inżynier_telefonii	inżynier telefonii
inżynier_telekomunikacji	inżynier telekomunikacji
inżynier_terenowy	inżynier terenowy
inżynier_terenowy_zajmujący_się_liniami_przewodowymi	inżynier terenowy zajmujący się liniami przewodowymi
inżynier_testów	inżynier testów
inżynier_testów_elektrycznych	inżynier testów elektrycznych
inżynier_testów_jazdy	inżynier testów jazdy
inżynier_testów_w_locie	inżynier testów w locie
inżynier_transmisji	inżynier transmisji
inżynier_tworzenia_stron_internetowych	inżynier tworzenia stron internetowych
inżynier_układu	inżynier układu
inżynier_układu_napędowego	inżynier układu napędowego
inżynier_usług_budowlanych	inżynier usług budowlanych
inżynier_wdrażania	inżynier wdrażania
inżynier_wdrożenia	inżynier wdrożenia
inżynier_wideo	inżynier wideo
inżynier_wsparcia_komputerów_stacjonarnych	inżynier wsparcia komputerów stacjonarnych
inżynier_wsparcia_sieci	inżynier wsparcia sieci
inżynier_wsparcia_sprzętowego	inżynier wsparcia sprzętowego
inżynier_wsparcia_systemowego	inżynier wsparcia systemowego
inżynier_wsparcia_technicznego_klienta	inżynier wsparcia technicznego klienta
inżynier_wsparcia_technicznego_personelu	inżynier wsparcia technicznego personelu
inżynier_wsparcia_technicznego_sprzedaży	inżynier wsparcia technicznego sprzedaży
inżynier_wsparcia_zdalnego	inżynier wsparcia zdalnego
inżynier_wydajności_sieci	inżynier wydajności sieci
inżynier_wydajności_systemu	inżynier wydajności systemu
inżynier_wykończenia	inżynier wykończenia
inżynier_własności_intelektualnej	inżynier własności intelektualnej
inżynier_zmiany	inżynier zmiany
inżynier_środowiska	inżynier środowiska
inżynier_żywności	inżynier żywności
inżynier-konstruktor_maszyn	inżynier-konstruktor maszyn
inżynier-konsultant	inżynier-konsultant
inżynier-projektant	inżynier-projektant
inżynier-projektant_personelu	inżynier-projektant personelu
inżynieria_sieci_menedżerskiej	inżynieria sieci menedżerskiej
językoznawca	językoznawca
językoznawca_rosyjski	językoznawca rosyjski
kamerzysta	kamerzysta
kamerzysta_oświetleniowy	kamerzysta oświetleniowy
kapitan	kapitan
kapitan_bankietowy	kapitan bankietowy
kapitan_linii_lotniczej	kapitan linii lotniczej
kapitan_policji	kapitan policji
kapitan_straży_pożarnej	kapitan straży pożarnej
kapitan_szkolenia	kapitan szkolenia
kapral	kapral
kardiolog	kardiolog
kasjer	kasjer
kasjer_bankowy	kasjer bankowy
kataloger	kataloger
kelner	kelner
kelnerka_koktajlowa	kelnerka koktajlowa
kibic	kibic
kierowca	kierowca
kierowca_drogowy	kierowca drogowy
kierowca_firmowy	kierowca firmowy
kierownik	kierownik
kierownik_Logistyki	kierownik Logistyki
kierownik_Sprzedaży	kierownik Sprzedaży
kierownik_animacji	kierownik animacji
kierownik_apteki	kierownik apteki
kierownik_apteki_klinicznej	kierownik apteki klinicznej
kierownik_baru	kierownik baru
kierownik_basenu	kierownik basenu
kierownik_biura_technicznego	kierownik biura technicznego
kierownik_budowy	kierownik budowy
kierownik_cateringu	kierownik cateringu
kierownik_centrum_biznesowego	kierownik centrum biznesowego
kierownik_centrum_dystrybucyjnego	kierownik centrum dystrybucyjnego
kierownik_centrum_konferencyjnego	kierownik centrum konferencyjnego
kierownik_centrum_logistycznego	kierownik centrum logistycznego
kierownik_centrum_projektowego	kierownik centrum projektowego
kierownik_centrum_serwisowego	kierownik centrum serwisowego
kierownik_dokumentacji	kierownik dokumentacji
kierownik_ds._bezpieczeństwa_żywności	kierownik ds. bezpieczeństwa żywności
kierownik_ds._datków_rocznych	kierownik ds. datków rocznych
kierownik_ds._inżynierii_grupy	kierownik ds. inżynierii grupy
kierownik_ds._inżynierii_produktu	kierownik ds. inżynierii produktu
kierownik_ds._operacji_inwestycyjnych	kierownik ds. operacji inwestycyjnych
kierownik_ds._projektowania_marki	kierownik ds. projektowania marki
kierownik_ds._relacji_z_gośćmi	kierownik ds. relacji z gośćmi
kierownik_ds._zgodności_podatkowej	kierownik ds. zgodności podatkowej
kierownik_ds._żywności_i_napojów	kierownik ds. żywności i napojów
kierownik_działu_artystycznego	kierownik działu artystycznego
kierownik_działu_elektrycznego	kierownik działu elektrycznego
kierownik_działu_logistyki	kierownik działu logistyki
kierownik_działu_pomocy_technicznej	kierownik działu pomocy technicznej
kierownik_działu_prawnego	kierownik działu prawnego
kierownik_działu_projektowego	kierownik działu projektowego
kierownik_działu_sali	kierownik działu sali
kierownik_elektrotechniki	kierownik elektrotechniki
kierownik_frontendu	kierownik frontendu
kierownik_galerii	kierownik galerii
kierownik_grantów	kierownik grantów
kierownik_inwentaryzacji	kierownik inwentaryzacji
kierownik_inżynierii_terenowej	kierownik inżynierii terenowej
kierownik_jednostki_produkcyjnej	kierownik jednostki produkcyjnej
kierownik_kadr	kierownik kadr
kierownik_kawiarni	kierownik kawiarni
kierownik_kliniczny	kierownik kliniczny
kierownik_kliniki	kierownik kliniki
kierownik_konferencji	kierownik konferencji
kierownik_konta	kierownik konta
kierownik_koordynacji_projektu	kierownik koordynacji projektu
kierownik_kopiowania	kierownik kopiowania
kierownik_kopiowania_grupowego	kierownik kopiowania grupowego
kierownik_kuchni	kierownik kuchni
kierownik_kwiaciarni	kierownik kwiaciarni
kierownik_logistyki_grupy	kierownik logistyki grupy
kierownik_logistyki_krajowej	kierownik logistyki krajowej
kierownik_magazynu	kierownik magazynu
kierownik_magazynu_i_dystrybucji	kierownik magazynu i dystrybucji
kierownik_magazynu_i_logistyki	kierownik magazynu i logistyki
kierownik_nocy	kierownik nocy
kierownik_obiektu	kierownik obiektu
kierownik_obsługi_gości	kierownik obsługi gości
kierownik_obsługi_konferencyjnej	kierownik obsługi konferencyjnej
kierownik_oddziału	kierownik oddziału
kierownik_operacji_i_logistyki	kierownik operacji i logistyki
kierownik_operacji_lotniczych	kierownik operacji lotniczych
kierownik_operacji_magazynowych	kierownik operacji magazynowych
kierownik_operacji_morskich	kierownik operacji morskich
kierownik_operacji_naziemnych	kierownik operacji naziemnych
kierownik_operacji_rekrutacyjnych	kierownik operacji rekrutacyjnych
kierownik_operacyjny_apteki	kierownik operacyjny apteki
kierownik_operacyjny_oddziału	kierownik operacyjny oddziału
kierownik_piekarni	kierownik piekarni
kierownik_planowania_mediów	kierownik planowania mediów
kierownik_planowania_strategicznego	kierownik planowania strategicznego
kierownik_pokazu	kierownik pokazu
kierownik_pomocy	kierownik pomocy
kierownik_postprodukcji	kierownik postprodukcji
kierownik_produkcji	kierownik produkcji
kierownik_produkcji_poligraficznej	kierownik produkcji poligraficznej
kierownik_produkcji_redakcyjnej	kierownik produkcji redakcyjnej
kierownik_produkcji_wideo	kierownik produkcji wideo
kierownik_programu_lokalizacyjnego	kierownik programu lokalizacyjnego
kierownik_programu_ochrony_środowiska	kierownik programu ochrony środowiska
kierownik_programu_technicznego_personelu	kierownik programu technicznego personelu
kierownik_projektu	kierownik projektu
kierownik_projektu_fizycznego	kierownik projektu fizycznego
kierownik_projektu_graficznego	kierownik projektu graficznego
kierownik_projektu_mechanicznego	kierownik projektu mechanicznego
kierownik_projektu_oprogramowania	kierownik projektu oprogramowania
kierownik_projektu_redakcyjnego	kierownik projektu redakcyjnego
kierownik_projektu_rekrutacyjnego	kierownik projektu rekrutacyjnego
kierownik_projektu_sieci	kierownik projektu sieci
kierownik_projektu_środowiskowego	kierownik projektu środowiskowego
kierownik_projektów_graficznych	kierownik projektów graficznych
kierownik_radiologii	kierownik radiologii
kierownik_recepcji	kierownik recepcji
kierownik_redakcji	kierownik redakcji
kierownik_rekrutacji	kierownik rekrutacji
kierownik_rekrutacji_absolwentów	kierownik rekrutacji absolwentów
kierownik_restauracji	kierownik restauracji
kierownik_restauracji_i_baru	kierownik restauracji i baru
kierownik_rozwoju_tras	kierownik rozwoju tras
kierownik_ruchu	kierownik ruchu
kierownik_salonu	kierownik salonu
kierownik_scenariusza	kierownik scenariusza
kierownik_serwisu	kierownik serwisu
kierownik_sprzedaży_kredytów_hipotecznych	kierownik sprzedaży kredytów hipotecznych
kierownik_sprzątania	kierownik sprzątania
kierownik_studia_projektowego	kierownik studia projektowego
kierownik_techniczny	kierownik techniczny
kierownik_techniczny_Java	kierownik techniczny Java
kierownik_testów_technicznych	kierownik testów technicznych
kierownik_transmisji	kierownik transmisji
kierownik_uruchomienia	kierownik uruchomienia
kierownik_usług_kreatywnych	kierownik usług kreatywnych
kierownik_uzdrowiska	kierownik uzdrowiska
kierownik_wierceń	kierownik wierceń
kierownik_wsparcia_systemu	kierownik wsparcia systemu
kierownik_wsparcia_technicznego	kierownik wsparcia technicznego
kierownik_wysyłki	kierownik wysyłki
kierownik_wysyłki_i_odbioru	kierownik wysyłki i odbioru
kierownik_zakupów_międzynarodowych	kierownik zakupów międzynarodowych
kierownik_zamknięcia	kierownik zamknięcia
kierownik_zbiorów_terenowych	kierownik zbiorów terenowych
kierownik_zbiórki	kierownik zbiórki
kierownik_zespołu_centrum_operacji_sieciowych	kierownik zespołu centrum operacji sieciowych
kierownik_zespołu_magazynowego	kierownik zespołu magazynowego
kierownik_zespołu_projektowego	kierownik zespołu projektowego
kierownik_zespołu_telekomunikacyjnego	kierownik zespołu telekomunikacyjnego
klawiszowiec	klawiszowiec
kliniczny_pracownik_socjalny	kliniczny pracownik socjalny
komandytariusz	komandytariusz
komendant_straży_pożarnej	komendant straży pożarnej
komercyjnego_pilota	komercyjnego pilota
komercyjny_agent_ubezpieczeniowy	komercyjny agent ubezpieczeniowy
komercyjny_broker_ubezpieczeniowy	komercyjny broker ubezpieczeniowy
komik	komik
kompletna_komoda	kompletna komoda
kompozytor_filmowy	kompozytor filmowy
kompozytor_muzyki	kompozytor muzyki
komunikacja_strategiczna	komunikacja strategiczna
konsultacja_psychologiczna	konsultacja psychologiczna
konsultant	konsultant
konsultant_Java	konsultant Java
konsultant_artystyczny	konsultant artystyczny
konsultant_bezprzewodowy	konsultant bezprzewodowy
konsultant_biznesowy	konsultant biznesowy
konsultant_ds._automatyki	konsultant ds. automatyki
konsultant_ds._automatyzacji_testów	konsultant ds. automatyzacji testów
konsultant_ds._bezpieczeństwa_sieci	konsultant ds. bezpieczeństwa sieci
konsultant_ds._członkostwa	konsultant ds. członkostwa
konsultant_ds._dekoracji	konsultant ds. dekoracji
konsultant_ds._inżynierii_mechanicznej	konsultant ds. inżynierii mechanicznej
konsultant_ds._inżynierii_sieci	konsultant ds. inżynierii sieci
konsultant_ds._komunikacji	konsultant ds. komunikacji
konsultant_ds._logistyki	konsultant ds. logistyki
konsultant_ds._marketingu_i_public_relations	konsultant ds. marketingu i public relations
konsultant_ds._marketingu_w_mediach_społecznościowych	konsultant ds. marketingu w mediach społecznościowych
konsultant_ds._mody	konsultant ds. mody
konsultant_ds._nieruchomości_komercyjnych	konsultant ds. nieruchomości komercyjnych
konsultant_ds._opalania	konsultant ds. opalania
konsultant_ds._podróży_międzynarodowych	konsultant ds. podróży międzynarodowych
konsultant_ds._postępowań_sądowych	konsultant ds. postępowań sądowych
konsultant_ds._poszukiwań_kadry_kierowniczej	konsultant ds. poszukiwań kadry kierowniczej
konsultant_ds._pozycjonowania	konsultant ds. pozycjonowania
konsultant_ds._pozyskiwania_funduszy	konsultant ds. pozyskiwania funduszy
konsultant_ds._pozyskiwania_talentów	konsultant ds. pozyskiwania talentów
konsultant_ds._projektowania_graficznego	konsultant ds. projektowania graficznego
konsultant_ds._projektowania_produktów	konsultant ds. projektowania produktów
konsultant_ds._projektowania_sieci	konsultant ds. projektowania sieci
konsultant_ds._public_relations	konsultant ds. public relations
konsultant_ds._public_relations_i_komunikacji	konsultant ds. public relations i komunikacji
konsultant_ds._rekrutacji	konsultant ds. rekrutacji
konsultant_ds._rozwoju_biznesu	konsultant ds. rozwoju biznesu
konsultant_ds._rozwoju_biznesu_międzynarodowego	konsultant ds. rozwoju biznesu międzynarodowego
konsultant_ds._rozwoju_organizacji	konsultant ds. rozwoju organizacji
konsultant_ds._rozwoju_przywództwa	konsultant ds. rozwoju przywództwa
konsultant_ds._sieci_danych	konsultant ds. sieci danych
konsultant_ds._strategii	konsultant ds. strategii
konsultant_ds._underwritingu	konsultant ds. underwritingu
konsultant_ds._wydarzeń	konsultant ds. wydarzeń
konsultant_ds._zarządzania_talentami	konsultant ds. zarządzania talentami
konsultant_fitness	konsultant fitness
konsultant_geolog	konsultant geolog
konsultant_językowy	konsultant językowy
konsultant_marketingowy	konsultant marketingowy
konsultant_morski	konsultant morski
konsultant_muzyczny	konsultant muzyczny
konsultant_nieruchomości	konsultant nieruchomości
konsultant_oprogramowania	konsultant oprogramowania
konsultant_personalny	konsultant personalny
konsultant_podatkowy	konsultant podatkowy
konsultant_procesowy	konsultant procesowy
konsultant_redakcyjny	konsultant redakcyjny
konsultant_sieciowy	konsultant sieciowy
konsultant_stylu	konsultant stylu
konsultant_telekomunikacyjny	konsultant telekomunikacyjny
konsultant_ubezpieczeniowy	konsultant ubezpieczeniowy
konsultant_wiertniczy	konsultant wiertniczy
konsultant_wydawniczy	konsultant wydawniczy
konsultant_wyszukiwania	konsultant wyszukiwania
konsultant_zarządzania	konsultant zarządzania
konsultant_zarządzania_biznesem	konsultant zarządzania biznesem
konsultant_zdrowia_psychicznego	konsultant zdrowia psychicznego
konsultant_ślubny	konsultant ślubny
kontrakt_na_programistę_Java	kontrakt na programistę Java
kontraktowy_programista_stron_internetowych	kontraktowy programista stron internetowych
kontroler_logistyki	kontroler logistyki
kontroler_produktu	kontroler produktu
kontroler_ryzyka	kontroler ryzyka
koordynator_automatyzacji	koordynator automatyzacji
koordynator_badań_klinicznych	koordynator badań klinicznych
koordynator_badań_naukowych	koordynator badań naukowych
koordynator_bankietów	koordynator bankietów
koordynator_cateringu	koordynator cateringu
koordynator_cen	koordynator cen
koordynator_ds._importu	koordynator ds. importu
koordynator_ds._importu_i_eksportu	koordynator ds. importu i eksportu
koordynator_ds._komunikacji	koordynator ds. komunikacji
koordynator_ds._komunikacji_korporacyjnej	koordynator ds. komunikacji korporacyjnej
koordynator_ds._komunikacji_wewnętrznej	koordynator ds. komunikacji wewnętrznej
koordynator_ds._kredytów	koordynator ds. kredytów
koordynator_ds._marketingu_handlowego	koordynator ds. marketingu handlowego
koordynator_ds._marketingu_i_komunikacji	koordynator ds. marketingu i komunikacji
koordynator_ds._partnerstw	koordynator ds. partnerstw
koordynator_ds._public_relations	koordynator ds. public relations
koordynator_ds._public_relations_i_komunikacji	koordynator ds. public relations i komunikacji
koordynator_ds._płac_i_benefitów	koordynator ds. płac i benefitów
koordynator_ds._relacji_z_darczyńcami	koordynator ds. relacji z darczyńcami
koordynator_ds._relacji_z_gośćmi	koordynator ds. relacji z gośćmi
koordynator_ds._wynagrodzeń_i_świadczeń	koordynator ds. wynagrodzeń i świadczeń
koordynator_działu_artystycznego	koordynator działu artystycznego
koordynator_działu_pomocy_technicznej	koordynator działu pomocy technicznej
koordynator_fitness	koordynator fitness
koordynator_galerii	koordynator galerii
koordynator_gościnności	koordynator gościnności
koordynator_handlowy	koordynator handlowy
koordynator_konferencji_i_wydarzeń	koordynator konferencji i wydarzeń
koordynator_konwencji	koordynator konwencji
koordynator_kredytów_hipotecznych	koordynator kredytów hipotecznych
koordynator_lekkoatletyczny	koordynator lekkoatletyczny
koordynator_logistyczny	koordynator logistyczny
koordynator_logistyki_międzynarodowej	koordynator logistyki międzynarodowej
koordynator_marketingu_internetowego	koordynator marketingu internetowego
koordynator_obsługi_gości	koordynator obsługi gości
koordynator_obsługi_konferencyjnej	koordynator obsługi konferencyjnej
koordynator_polityki	koordynator polityki
koordynator_poprawy_wydajności	koordynator poprawy wydajności
koordynator_postprodukcji	koordynator postprodukcji
koordynator_praktyk_studenckich	koordynator praktyk studenckich
koordynator_prawny	koordynator prawny
koordynator_produkcji	koordynator produkcji
koordynator_produkcji_poligraficznej	koordynator produkcji poligraficznej
koordynator_produkcji_reklamowej	koordynator produkcji reklamowej
koordynator_programu_akademickiego	koordynator programu akademickiego
koordynator_programu_studiów_podyplomowych	koordynator programu studiów podyplomowych
koordynator_projektu	koordynator projektu
koordynator_projektów_graficznych	koordynator projektów graficznych
koordynator_przejścia	koordynator przejścia
koordynator_przygotowania_do_druku	koordynator przygotowania do druku
koordynator_redakcji	koordynator redakcji
koordynator_reklamy	koordynator reklamy
koordynator_rezerwacji	koordynator rezerwacji
koordynator_rezerwacji_grupowych	koordynator rezerwacji grupowych
koordynator_rozwoju_funduszu	koordynator rozwoju funduszu
koordynator_salonu	koordynator salonu
koordynator_sportowy	koordynator sportowy
koordynator_telekomunikacji	koordynator telekomunikacji
koordynator_transmisji	koordynator transmisji
koordynator_tłumaczeń	koordynator tłumaczeń
koordynator_usług_marketingowych	koordynator usług marketingowych
koordynator_usług_terenowych	koordynator usług terenowych
koordynator_wsparcia_technicznego	koordynator wsparcia technicznego
koordynator_wycieczek	koordynator wycieczek
koordynator_wydarzenia	koordynator wydarzenia
koordynator_wydawniczy	koordynator wydawniczy
koordynator_wysyłki_i_odbioru	koordynator wysyłki i odbioru
koordynator_zarządzania_kryzysowego	koordynator zarządzania kryzysowego
koordynator_zbiórek	koordynator zbiórek
koordynatorka_mody	koordynatorka mody
koordynatorka_ślubów	koordynatorka ślubów
korektor	korektor
korespondent_krajowy	korespondent krajowy
korporacyjna_stewardesa	korporacyjna stewardesa
korporacyjne_biuro_podróży	korporacyjne biuro podróży
korporacyjny_radca_prawny	korporacyjny radca prawny
korporacyjny_szef_kuchni	korporacyjny szef kuchni
kosmetolog	kosmetolog
kotwica	kotwica
kotwica_sportowa	kotwica sportowa
krajowy_menadżer_HR	krajowy menadżer HR
krajowy_menadżer_biznesowy	krajowy menadżer biznesowy
krajowy_rekruter	krajowy rekruter
kreatywny_copywriter	kreatywny copywriter
kreatywny_grafik	kreatywny grafik
kreatywny_kierownik_projektu	kreatywny kierownik projektu
kreatywny_lider	kreatywny lider
kreatywny_menadżer_ds._projektowania	kreatywny menadżer ds. projektowania
kreatywny_pisarz	kreatywny pisarz
kreatywny_programista	kreatywny programista
kreatywny_stażysta	kreatywny stażysta
kredytodawca_hipoteczny	kredytodawca hipoteczny
krytyk_sztuki	krytyk sztuki
księgowy	księgowy
księgowy_ds._podatków_pracowniczych	księgowy ds. podatków pracowniczych
księgowy_ds._podatków_płacowych	księgowy ds. podatków płacowych
księgowy_klienta	księgowy klienta
księgowy_nieruchomości	księgowy nieruchomości
księgowy_personelu	księgowy personelu
księgowy_płac	księgowy płac
kucharz	kucharz
kucharz_liniowy	kucharz liniowy
kurator	kurator
kurator_wystawy	kurator wystawy
lekarz	lekarz
lekarz_chorób_wewnętrznych	lekarz chorób wewnętrznych
lekarz_medycyny_ratunkowej	lekarz medycyny ratunkowej
lekarz_ogólny	lekarz ogólny
lekarz_pogotowia	lekarz pogotowia
lekarz_prowadzący	lekarz prowadzący
lekarz_rezydent	lekarz rezydent
lekarz_rodzinny	lekarz rodzinny
lekarz_sztabowy	lekarz sztabowy
letni_analityk_bankowości_inwestycyjnej	letni analityk bankowości inwestycyjnej
letni_urzędnik_prawniczy	letni urzędnik prawniczy
licencjonowana_pielęgniarka	licencjonowana pielęgniarka
licencjonowanego_agenta_nieruchomości	licencjonowanego agenta nieruchomości
licencjonowanego_agenta_ubezpieczeniowego	licencjonowanego agenta ubezpieczeniowego
licencjonowany_agent_sprzedaży	licencjonowany agent sprzedaży
licencjonowany_akupunkturzysta	licencjonowany akupunkturzysta
licencjonowany_broker_kredytów_hipotecznych	licencjonowany broker kredytów hipotecznych
licencjonowany_doradca_kliniczny	licencjonowany doradca kliniczny
licencjonowany_doradca_zawodowy	licencjonowany doradca zawodowy
licencjonowany_doradca_zdrowia_psychicznego	licencjonowany doradca zdrowia psychicznego
licencjonowany_kliniczny_pracownik_socjalny	licencjonowany kliniczny pracownik socjalny
licencjonowany_pośrednik_w_obrocie_nieruchomościami	licencjonowany pośrednik w obrocie nieruchomościami
licencjonowany_profesjonalista_z_branży_nieruchomości	licencjonowany profesjonalista z branży nieruchomości
licencjonowany_psycholog	licencjonowany psycholog
licencjonowany_psycholog_kliniczny	licencjonowany psycholog kliniczny
licencjonowany_terapeuta_małżeński_i_rodzinny	licencjonowany terapeuta małżeński i rodzinny
licytator	licytator
lider_animacji	lider animacji
lider_kadrowy	lider kadrowy
lider_klastra	lider klastra
lider_komunikacji	lider komunikacji
lider_pozyskiwania_talentów	lider pozyskiwania talentów
lider_rozwoju_biznesu	lider rozwoju biznesu
lider_zespołu_Java	lider zespołu Java
lider_zespołu_automatyki	lider zespołu automatyki
lider_zespołu_inżynierów_oprogramowania	lider zespołu inżynierów oprogramowania
lider_zespołu_logistyki	lider zespołu logistyki
lider_zespołu_obsługi_klienta	lider zespołu obsługi klienta
lider_zespołu_oprogramowania_wbudowanego	lider zespołu oprogramowania wbudowanego
lider_zespołu_pośredników_w_handlu_nieruchomościami	lider zespołu pośredników w handlu nieruchomościami
lider_zespołu_rekrutacyjnego	lider zespołu rekrutacyjnego
lider_zespołu_sprzętowego	lider zespołu sprzętowego
lider_zespołu_tworzącego_aplikacje	lider zespołu tworzącego aplikacje
lider_zespołu_tworzącego_strony_internetowe	lider zespołu tworzącego strony internetowe
lider_zespołu_wdrożeniowego	lider zespołu wdrożeniowego
lider_zespołu_wsparcia_komputerów_stacjonarnych	lider zespołu wsparcia komputerów stacjonarnych
lider_zespołu_wsparcia_technicznego	lider zespołu wsparcia technicznego
likwidator_roszczeń_majątkowych	likwidator roszczeń majątkowych
likwidator_szkód_powypadkowych	likwidator szkód powypadkowych
logistyk	logistyk
lokalny_asystent_sprzedaży	lokalny asystent sprzedaży
lokalny_menadżer_sprzedaży	lokalny menadżer sprzedaży
lotnik	lotnik
magazynier	magazynier
major_na_emeryturze	major na emeryturze
majster	majster
majster_budowy	majster budowy
makler	makler
malarz	malarz
manicurzysta	manicurzysta
marketingowiec_internetowy	marketingowiec internetowy
marszałek_straży_pożarnej	marszałek straży pożarnej
mediator	mediator
menadżer_HR_grupy	menadżer HR grupy
menadżer_agencji	menadżer agencji
menadżer_bankowości_prywatnej	menadżer bankowości prywatnej
menadżer_banku	menadżer banku
menadżer_bazy	menadżer bazy
menadżer_biura_podróży	menadżer biura podróży
menadżer_ds._diety	menadżer ds. diety
menadżer_ds._komunikacji_zewnętrznej	menadżer ds. komunikacji zewnętrznej
menadżer_ds._konsultingu	menadżer ds. konsultingu
menadżer_ds._marketingu_mediów_społecznościowych	menadżer ds. marketingu mediów społecznościowych
menadżer_ds._marketingu_treści	menadżer ds. marketingu treści
menadżer_ds._mediów_i_komunikacji	menadżer ds. mediów i komunikacji
menadżer_ds._ogłoszeń_drobnych	menadżer ds. ogłoszeń drobnych
menadżer_ds._podatków_od_osób_prawnych	menadżer ds. podatków od osób prawnych
menadżer_ds._postępowań_sądowych	menadżer ds. postępowań sądowych
menadżer_ds._prasy_i_public_relations	menadżer ds. prasy i public relations
menadżer_ds._public_relations	menadżer ds. public relations
menadżer_ds._public_relations_międzynarodowego	menadżer ds. public relations międzynarodowego
menadżer_ds._reklamy	menadżer ds. reklamy
menadżer_ds._reklamy_internetowej	menadżer ds. reklamy internetowej
menadżer_ds._rekrutacji_technicznej	menadżer ds. rekrutacji technicznej
menadżer_ds._relacji_bankowości_prywatnej	menadżer ds. relacji bankowości prywatnej
menadżer_ds._relacji_z_absolwentami	menadżer ds. relacji z absolwentami
menadżer_ds._rozwoju_stron_internetowych	menadżer ds. rozwoju stron internetowych
menadżer_ds._wymiany_walut	menadżer ds. wymiany walut
menadżer_fitness	menadżer fitness
menadżer_fotografii	menadżer fotografii
menadżer_fundacji	menadżer fundacji
menadżer_gościnności	menadżer gościnności
menadżer_imprez_cateringowych	menadżer imprez cateringowych
menadżer_informacji_medycznej	menadżer informacji medycznej
menadżer_klienta_prywatnego	menadżer klienta prywatnego
menadżer_konta	menadżer konta
menadżer_konta_logistycznego	menadżer konta logistycznego
menadżer_konta_rekrutacyjnego	menadżer konta rekrutacyjnego
menadżer_kosztów	menadżer kosztów
menadżer_kreatywny	menadżer kreatywny
menadżer_kulinarny	menadżer kulinarny
menadżer_logistyki_korporacyjnej	menadżer logistyki korporacyjnej
menadżer_logistyki_międzynarodowej	menadżer logistyki międzynarodowej
menadżer_mediów	menadżer mediów
menadżer_mediów_społecznościowych	menadżer mediów społecznościowych
menadżer_obszaru_eksportu	menadżer obszaru eksportu
menadżer_operacji_informacyjnych	menadżer operacji informacyjnych
menadżer_outsourcingu	menadżer outsourcingu
menadżer_podatku_od_nieruchomości	menadżer podatku od nieruchomości
menadżer_podróży	menadżer podróży
menadżer_polityki_publicznej	menadżer polityki publicznej
menadżer_portfela	menadżer portfela
menadżer_portfela_akcji	menadżer portfela akcji
menadżer_portfela_nieruchomości	menadżer portfela nieruchomości
menadżer_portfela_o_stałym_dochodzie	menadżer portfela o stałym dochodzie
menadżer_portfela_produktów	menadżer portfela produktów
menadżer_procesu	menadżer procesu
menadżer_publikacji	menadżer publikacji
menadżer_reklamy	menadżer reklamy
menadżer_rekrutacji	menadżer rekrutacji
menadżer_rekrutacji_i_selekcji	menadżer rekrutacji i selekcji
menadżer_rekrutacji_i_szkoleń	menadżer rekrutacji i szkoleń
menadżer_restauracji	menadżer restauracji
menadżer_rynku_detalicznego	menadżer rynku detalicznego
menadżer_ryzyka_rynkowego	menadżer ryzyka rynkowego
menadżer_skarbca	menadżer skarbca
menadżer_sportowy	menadżer sportowy
menadżer_sprzedaży_cyfrowej	menadżer sprzedaży cyfrowej
menadżer_sprzedaży_społeczności	menadżer sprzedaży społeczności
menadżer_strony_internetowej	menadżer strony internetowej
menadżer_szkoleń_personalnych	menadżer szkoleń personalnych
menadżer_terminala	menadżer terminala
menadżer_transmisji	menadżer transmisji
menadżer_usług_gastronomicznych	menadżer usług gastronomicznych
menadżer_usług_graficznych	menadżer usług graficznych
menadżer_usług_kreatywnych	menadżer usług kreatywnych
menadżer_wydarzeń	menadżer wydarzeń
menadżer_wydawniczy	menadżer wydawniczy
menadżer_zasobów	menadżer zasobów
menadżer_zespołu	menadżer zespołu
menadżer_świadczeń	menadżer świadczeń
menedżer_aktywów_i_pasywów	menedżer aktywów i pasywów
menedżer_bankowości_osobistej	menedżer bankowości osobistej
menedżer_ds._importu_i_eksportu	menedżer ds. importu i eksportu
menedżer_ds._klientów_na_rynku_średnim	menedżer ds. klientów na rynku średnim
menedżer_ds._marketingu_cyfrowego	menedżer ds. marketingu cyfrowego
menedżer_ds._marketingu_przejęć	menedżer ds. marketingu przejęć
menedżer_ds._marketingu_wtórnego	menedżer ds. marketingu wtórnego
menedżer_ds._marketingu_zintegrowanego	menedżer ds. marketingu zintegrowanego
menedżer_ds._podróży_służbowych	menedżer ds. podróży służbowych
menedżer_ds._pozyskiwania_lokalizacji	menedżer ds. pozyskiwania lokalizacji
menedżer_ds._pozyskiwania_talentów	menedżer ds. pozyskiwania talentów
menedżer_ds._rekrutacji_kont	menedżer ds. rekrutacji kont
menedżer_ds._relacji_w_bankowości_komercyjnej	menedżer ds. relacji w bankowości komercyjnej
menedżer_ds._relacji_z_darczyńcami	menedżer ds. relacji z darczyńcami
menedżer_ds._strategii_i_operacji	menedżer ds. strategii i operacji
menedżer_ds._wdrażania_sieci	menedżer ds. wdrażania sieci
menedżer_importu	menedżer importu
menedżer_konta_cyfrowego	menedżer konta cyfrowego
menedżer_konta_reklamowego	menedżer konta reklamowego
menedżer_kopiowania	menedżer kopiowania
menedżer_operacji_sieciowych	menedżer operacji sieciowych
menedżer_podatkowy	menedżer podatkowy
menedżer_produktu_bezprzewodowego	menedżer produktu bezprzewodowego
menedżer_przesyłek	menedżer przesyłek
menedżer_relacji_z_klientem	menedżer relacji z klientem
menedżer_sieci_rdzeniowej	menedżer sieci rdzeniowej
menedżer_treści	menedżer treści
menedżer_treści_cyfrowych	menedżer treści cyfrowych
menedżer_treści_witryny	menedżer treści witryny
metalurg_roślin	metalurg roślin
miejski_listonosz	miejski listonosz
mieszkaniec_apteki	mieszkaniec apteki
mikser_audio	mikser audio
mikser_do_ponownego_nagrania	mikser do ponownego nagrania
miksolog	miksolog
mistrz_hydraulik	mistrz hydraulik
mistrz_produktu	mistrz produktu
mistrz_stolarski	mistrz stolarski
mistrz_stylisty	mistrz stylisty
mistrz_żeglarski	mistrz żeglarski
międzynarodowy_rekruter	międzynarodowy rekruter
modelarz	modelarz
modelarz_postaci	modelarz postaci
montażysta_filmowy	montażysta filmowy
montażysta_filmów_i_wideo	montażysta filmów i wideo
muralista	muralista
muzyk	muzyk
nabywca_transmisji	nabywca transmisji
naczelnik_poczty	naczelnik poczty
nadawca	nadawca
nadawca_radiowy	nadawca radiowy
nadzorca_bankietu	nadzorca bankietu
nadzorca_cen	nadzorca cen
nadzorca_centrum_danych	nadzorca centrum danych
nadzorca_cywilny	nadzorca cywilny
nadzorca_domu	nadzorca domu
nadzorca_handlowy	nadzorca handlowy
nadzorca_infrastruktury	nadzorca infrastruktury
nadzorca_kontroli_zapasów	nadzorca kontroli zapasów
nadzorca_kredytowy	nadzorca kredytowy
nadzorca_księgi_głównej	nadzorca księgi głównej
nadzorca_logistyki	nadzorca logistyki
nadzorca_mediów_cyfrowych	nadzorca mediów cyfrowych
nadzorca_morski	nadzorca morski
nadzorca_obrazu	nadzorca obrazu
nadzorca_płac	nadzorca płac
nadzorca_reklamy	nadzorca reklamy
nadzorca_ruchu_lotniczego	nadzorca ruchu lotniczego
nadzorca_strategii	nadzorca strategii
nadzorca_telekomunikacji	nadzorca telekomunikacji
nadzorca_transportu	nadzorca transportu
nadzorca_wdrożeniowy	nadzorca wdrożeniowy
nadzorca_zarządzający	nadzorca zarządzający
nadzorczy_agent_specjalny	nadzorczy agent specjalny
nagrywający_artysta	nagrywający artysta
napisz_bliżej	napisz bliżej
narrator	narrator
nauczyciel	nauczyciel
nauczyciel_Specjalnego_nauczania	nauczyciel Specjalnego nauczania
nauczyciel_biologii	nauczyciel biologii
nauczyciel_czytania	nauczyciel czytania
nauczyciel_czytania_i_pisania	nauczyciel czytania i pisania
nauczyciel_dwujęzyczny	nauczyciel dwujęzyczny
nauczyciel_edukacji_biznesowej	nauczyciel edukacji biznesowej
nauczyciel_edukacji_podstawowej	nauczyciel edukacji podstawowej
nauczyciel_gimnazjum	nauczyciel gimnazjum
nauczyciel_gościnny	nauczyciel gościnny
nauczyciel_gry_na_gitarze	nauczyciel gry na gitarze
nauczyciel_historii	nauczyciel historii
nauczyciel_hiszpańskiego	nauczyciel hiszpańskiego
nauczyciel_informatyki	nauczyciel informatyki
nauczyciel_języka_angielskiego	nauczyciel języka angielskiego
nauczyciel_języka_angielskiego_w_szkole_średniej	nauczyciel języka angielskiego w szkole średniej
nauczyciel_języków_obcych	nauczyciel języków obcych
nauczyciel_klasowy	nauczyciel klasowy
nauczyciel_matematyki_w_gimnazjum	nauczyciel matematyki w gimnazjum
nauczyciel_matematyki_w_liceum	nauczyciel matematyki w liceum
nauczyciel_opieki_dziennej	nauczyciel opieki dziennej
nauczyciel_opieki_nad_dziećmi	nauczyciel opieki nad dziećmi
nauczyciel_plastyki_języka_angielskiego	nauczyciel plastyki języka angielskiego
nauczyciel_podrzędny	nauczyciel podrzędny
nauczyciel_projektowania_graficznego	nauczyciel projektowania graficznego
nauczyciel_przedmiotów_ścisłych_w_szkole_średniej	nauczyciel przedmiotów ścisłych w szkole średniej
nauczyciel_przedszkola	nauczyciel przedszkola
nauczyciel_sportu	nauczyciel sportu
nauczyciel_szkoły_podstawowej	nauczyciel szkoły podstawowej
nauczyciel_szkoły_publicznej	nauczyciel szkoły publicznej
nauczyciel_szkoły_średniej	nauczyciel szkoły średniej
nauczyciel_tańca	nauczyciel tańca
nauczyciel_w_liceum	nauczyciel w liceum
nauczyciel_wczesnego_dzieciństwa	nauczyciel wczesnego dzieciństwa
nauczyciel_wspomagający_naukę	nauczyciel wspomagający naukę
nauczyciel_włoskiego	nauczyciel włoskiego
nauczyciel_zaopatrzeniowy	nauczyciel zaopatrzeniowy
nauczyciel_zastępczy	nauczyciel zastępczy
nauczycielka_przedszkola	nauczycielka przedszkola
nauczycielka_szkoły_letniej	nauczycielka szkoły letniej
naukowiec_zajmujący_się_badaniami_i_rozwojem	naukowiec zajmujący się badaniami i rozwojem
naukowiec_zajmujący_się_żywnością	naukowiec zajmujący się żywnością
naukowiec_środowiska	naukowiec środowiska
negocjator_transmisji	negocjator transmisji
neonatolog	neonatolog
nocny_audytor	nocny audytor
nocny_magazynier	nocny magazynier
nowy_doradca_domowy	nowy doradca domowy
nowy_doradca_ds._sprzedaży_domów	nowy doradca ds. sprzedaży domów
nowy_konsultant_sprzedaży_domów	nowy konsultant sprzedaży domów
nowy_producent_medialny	nowy producent medialny
nowy_specjalista_ds._biznesu	nowy specjalista ds. biznesu
oberżysta	oberżysta
obrońca_w_sprawach_karnych	obrońca w sprawach karnych
obsługa_klienta_kasjerskiego	obsługa klienta kasjerskiego
obsługa_klientów_prywatnych	obsługa klientów prywatnych
oficer_dochodzeniowy	oficer dochodzeniowy
oficer_morski	oficer morski
oficer_operacyjny	oficer operacyjny
oficer_pokojowy	oficer pokojowy
oficer_polityczny	oficer polityczny
oficer_rekrutacyjny	oficer rekrutacyjny
oficer_wachtowy	oficer wachtowy
oficer_średni	oficer średni
okręgowy_kierownik_ochrony_mienia	okręgowy kierownik ochrony mienia
operator	operator
operator_DTP	operator DTP
operator_centrum_danych	operator centrum danych
operator_centrum_operacji_sieciowych	operator centrum operacji sieciowych
operator_kamery	operator kamery
operator_kontroli_jakości	operator kontroli jakości
operator_magazynu	operator magazynu
operator_tablicy	operator tablicy
operator_taśmy	operator taśmy
operator_techniczny	operator techniczny
operator_telefoniczny	operator telefoniczny
opiekun_artystyczny_grupy	opiekun artystyczny grupy
opiekun_do_dzieci	opiekun do dzieci
opiekun_mediów	opiekun mediów
opiekun_merytoryczny	opiekun merytoryczny
opiekun_obozu_dziennego	opiekun obozu dziennego
opiekun_obozów_letnich	opiekun obozów letnich
opiekun_pedagogiki_specjalnej	opiekun pedagogiki specjalnej
opiekunka_do_zwierząt	opiekunka do zwierząt
opiekunka_dziecięca	opiekunka dziecięca
organista	organista
ortodonta	ortodonta
osoba_zajmująca_się_materiałami	osoba zajmująca się materiałami
osoba_zajmująca_się_sztuką	osoba zajmująca się sztuką
osobisty_asystent_dyrektora_generalnego	osobisty asystent dyrektora generalnego
osobisty_asystent_prawny	osobisty asystent prawny
osobisty_menedżer_linii	osobisty menedżer linii
osobisty_szef_kuchni	osobisty szef kuchni
osobowość_powietrzna	osobowość powietrzna
osoby_zatrudnione_w_kuchni	osoby zatrudnione w kuchni
ołów_wysyłkowy	ołów wysyłkowy
parapedagog	parapedagog
partner	partner
partner_zarządzający	partner zarządzający
pedagog_specjalny	pedagog specjalny
pedagog_wczesnoszkolny	pedagog wczesnoszkolny
pediatra	pediatra
perfuzjonista	perfuzjonista
perkusista	perkusista
personel_anestezjolog	personel anestezjolog
personel_piętra	personel piętra
pełnomocnik_kontraktowy	pełnomocnik kontraktowy
pełnomocnik_zarządzający	pełnomocnik zarządzający
piekarz	piekarz
pielęgniarka	pielęgniarka
pielęgniarka_chirurgiczna	pielęgniarka chirurgiczna
pielęgniarka_dentystyczna	pielęgniarka dentystyczna
pielęgniarka_intensywnej_terapii	pielęgniarka intensywnej terapii
pielęgniarka_medycyny_pracy	pielęgniarka medycyny pracy
pielęgniarka_pediatryczna	pielęgniarka pediatryczna
pielęgniarka_podróżująca	pielęgniarka podróżująca
pielęgniarka_psychiatryczna_zajmująca_się_zdrowiem_psychicznym	pielęgniarka psychiatryczna zajmująca się zdrowiem psychicznym
pielęgniarka_rejonowa	pielęgniarka rejonowa
pielęgniarka_stażystka	pielęgniarka stażystka
pielęgniarka_z_zaawansowaną_praktyką	pielęgniarka z zaawansowaną praktyką
pielęgniarka_zdrowia_domowego	pielęgniarka zdrowia domowego
pielęgniarka_zdrowia_publicznego	pielęgniarka zdrowia publicznego
pielęgniarka_środowiskowa	pielęgniarka środowiskowa
pierwsza_kamera_pomocnicza	pierwsza kamera pomocnicza
pierwszy_asystent_redaktora	pierwszy asystent redaktora
pierwszy_inżynier	pierwszy inżynier
pierwszy_oficer	pierwszy oficer
pierwszy_zastępca_reżysera	pierwszy zastępca reżysera
pilot_liniowy	pilot liniowy
pilota_kontraktowego	pilota kontraktowego
pilota_korporacyjnego	pilota korporacyjnego
piosenkarz	piosenkarz
pisarz	pisarz
pisarz_biznesowy	pisarz biznesowy
pisarz_finansowy	pisarz finansowy
pisarz_kontraktowy	pisarz kontraktowy
pisarz_podróżniczy	pisarz podróżniczy
pisarz_redakcyjny	pisarz redakcyjny
piłkarz	piłkarz
planista	planista
planista_konferencji	planista konferencji
planista_konta	planista konta
planista_logistyki	planista logistyki
planista_marki	planista marki
planista_mediów	planista mediów
planista_mediów_cyfrowych	planista mediów cyfrowych
planista_sprzedaży	planista sprzedaży
planista_wakacji	planista wakacji
planista_wydarzeń	planista wydarzeń
planista_wydarzeń_firmowych	planista wydarzeń firmowych
planista_wydarzeń_specjalnych	planista wydarzeń specjalnych
planista_ślubów_i_wydarzeń	planista ślubów i wydarzeń
planowanie_strategiczne_menedżera	planowanie strategiczne menedżera
podmiot_świadczący_opiekę_nad_dziećmi	podmiot świadczący opiekę nad dziećmi
policjant	policjant
pomoc_nauczyciela	pomoc nauczyciela
pomoc_techniczna	pomoc techniczna
pomocnik_badawczy	pomocnik badawczy
pomocnik_cukiernika	pomocnik cukiernika
pomocnik_kelnera	pomocnik kelnera
pomocnik_kucharza	pomocnik kucharza
pomysłodawca_kredytu_hipotecznego	pomysłodawca kredytu hipotecznego
porucznik	porucznik
porucznik_policji	porucznik policji
porucznik_straży_pożarnej	porucznik straży pożarnej
pozdrawiacz	pozdrawiacz
pozyskiwanie_talentów_menedżerskich	pozyskiwanie talentów menedżerskich
pośredni_księgowy	pośredni księgowy
pośrednik	pośrednik
pośrednik_kredytów_hipotecznych	pośrednik kredytów hipotecznych
pośrednik_sprzedaży	pośrednik sprzedaży
pośrednik_w_handlu_nieruchomościami	pośrednik w handlu nieruchomościami
pośrednik_w_obrocie_nieruchomościami_mieszkaniowymi	pośrednik w obrocie nieruchomościami mieszkaniowymi
pożyczka_bliżej	pożyczka bliżej
pracownik_banku	pracownik banku
pracownik_baru	pracownik baru
pracownik_geofizyka	pracownik geofizyka
pracownik_geolog	pracownik geolog
pracownik_inżynier_elektryk	pracownik inżynier elektryk
pracownik_magazynu	pracownik magazynu
pracownik_naukowy	pracownik naukowy
pracownik_naukowy_studiów_podyplomowych	pracownik naukowy studiów podyplomowych
pracownik_obsługi_gości	pracownik obsługi gości
pracownik_pomocy_rodzinie	pracownik pomocy rodzinie
pracownik_socjalny	pracownik socjalny
prawnik	prawnik
prawnik_ds._badań	prawnik ds. badań
prawnik_firmy	prawnik firmy
prawnik_handlowy	prawnik handlowy
prawnik_korporacyjny	prawnik korporacyjny
prawnik_międzynarodowy	prawnik międzynarodowy
prawnik_nieruchomości	prawnik nieruchomości
prawnik_podatkowy	prawnik podatkowy
prawnik_pracowniczy	prawnik pracowniczy
prawnik_pracy_i_zatrudnienia	prawnik pracy i zatrudnienia
prawnik_specjalizujący_się_w_prawie_rodzinnym	prawnik specjalizujący się w prawie rodzinnym
prawnik_zajmujący_się_własnością_intelektualną	prawnik zajmujący się własnością intelektualną
preferowany_bankier	preferowany bankier
prezenter	prezenter
prezenter_porannych_wiadomości	prezenter porannych wiadomości
prezenter_telewizyjny	prezenter telewizyjny
procesor_poczty	procesor poczty
procesor_pożyczki	procesor pożyczki
producent	producent
producent_cyfrowy	producent cyfrowy
producent_deweloperski	producent deweloperski
producent_druku	producent druku
producent_dźwięku	producent dźwięku
producent_filmowy	producent filmowy
producent_interaktywny	producent interaktywny
producent_komercyjny	producent komercyjny
producent_kreatywny	producent kreatywny
producent_linii_komercyjnych	producent linii komercyjnych
producent_liniowy	producent liniowy
producent_mediów_cyfrowych	producent mediów cyfrowych
producent_multimedialny	producent multimedialny
producent_muzyczny	producent muzyczny
producent_odlewów	producent odlewów
producent_porannego_programu	producent porannego programu
producent_postu	producent postu
producent_programu	producent programu
producent_promocji	producent promocji
producent_radiowy	producent radiowy
producent_sieci	producent sieci
producent_sportowy	producent sportowy
producent_talentów	producent talentów
producent_techniczny	producent techniczny
producent_telewizyjny	producent telewizyjny
producent_treści	producent treści
producent_ubezpieczeń	producent ubezpieczeń
producent_usług_kreatywnych	producent usług kreatywnych
producent_wiadomości	producent wiadomości
producent_wiadomości_telewizyjnych	producent wiadomości telewizyjnych
producent_wideo	producent wideo
producent_wykonawczy	producent wykonawczy
produkować_urzędnik	produkować urzędnik
produkować_współpracownika	produkować współpracownika
prodziekan_ds._rekrutacji	prodziekan ds. rekrutacji
profesjonalista_muzyczny	profesjonalista muzyczny
profesjonalna_makijażystka	profesjonalna makijażystka
profesjonalna_piosenkarka	profesjonalna piosenkarka
profesjonalny_aktor	profesjonalny aktor
profesjonalny_artysta	profesjonalny artysta
profesjonalny_atleta	profesjonalny atleta
profesjonalny_członek_personelu	profesjonalny członek personelu
profesjonalny_fotograf	profesjonalny fotograf
profesjonalny_inżynier	profesjonalny inżynier
profesjonalny_księgowy	profesjonalny księgowy
profesjonalny_muzyk	profesjonalny muzyk
profesjonalny_piłkarz	profesjonalny piłkarz
profesjonalny_pośrednik_w_handlu_nieruchomościami	profesjonalny pośrednik w handlu nieruchomościami
profesjonalny_tancerz	profesjonalny tancerz
profesor	profesor
profesor_antropologii	profesor antropologii
profesor_architektury	profesor architektury
profesor_chirurgii	profesor chirurgii
profesor_filozofii	profesor filozofii
profesor_języka_angielskiego	profesor języka angielskiego
profesor_matematyki	profesor matematyki
profesor_nadzwyczajny_kliniczny	profesor nadzwyczajny kliniczny
profesor_nauk_politycznych	profesor nauk politycznych
profesor_pedagogiki	profesor pedagogiki
profesor_socjologii	profesor socjologii
profesor_sztuki	profesor sztuki
profesor_uczelni	profesor uczelni
program_rozwoju_inżynierii_Edisona	program rozwoju inżynierii Edisona
programista_Androida	programista Androida
programista_HTML5	programista HTML5
programista_Java	programista Java
programista_Java/j2ee	programista Java/j2ee
programista_aplikacji	programista aplikacji
programista_aplikacji_Java	programista aplikacji Java
programista_aplikacji_internetowych	programista aplikacji internetowych
programista_aplikacji_mobilnych	programista aplikacji mobilnych
programista_automatyki	programista automatyki
programista_baz_danych	programista baz danych
programista_interaktywny	programista interaktywny
programista_interfejsu_internetowego	programista interfejsu internetowego
programista_internetowy	programista internetowy
programista_j2ee	programista j2ee
programista_multimediów	programista multimediów
programista_narzędzi	programista narzędzi
programista_open_source	programista open source
programista_personelu	programista personelu
programista_po_stronie_klienta	programista po stronie klienta
programista_sprzętu	programista sprzętu
programista_stron_internetowych_Java	programista stron internetowych Java
programista_zaplecza	programista zaplecza
projektant	projektant
projektant_akcesoriów	projektant akcesoriów
projektant_analogowy	projektant analogowy
projektant_architektury	projektant architektury
projektant_cyfrowy	projektant cyfrowy
projektant_cywilny	projektant cywilny
projektant_druku	projektant druku
projektant_elektroniki	projektant elektroniki
projektant_fizyczny	projektant fizyczny
projektant_instalacji_sanitarnych	projektant instalacji sanitarnych
projektant_inżynieryjny	projektant inżynieryjny
projektant_komunikacji	projektant komunikacji
projektant_koncepcji	projektant koncepcji
projektant_krajobrazu	projektant krajobrazu
projektant_marki	projektant marki
projektant_mechanik	projektant mechanik
projektant_mediów_cyfrowych	projektant mediów cyfrowych
projektant_mody	projektant mody
projektant_multimediów	projektant multimediów
projektant_obuwia	projektant obuwia
projektant_obwodów	projektant obwodów
projektant_odzieży	projektant odzieży
projektant_odzieży_męskiej	projektant odzieży męskiej
projektant_postaci	projektant postaci
projektant_produktu	projektant produktu
projektant_projektu	projektant projektu
projektant_publikacji	projektant publikacji
projektant_płytek_drukowanych	projektant płytek drukowanych
projektant_reklam	projektant reklam
projektant_sieci	projektant sieci
projektant_sprzętu	projektant sprzętu
projektant_stron_internetowych	projektant stron internetowych
projektant_stron_internetowych_i_grafik	projektant stron internetowych i grafik
projektant_systemów_sterowania	projektant systemów sterowania
projektant_techniczny	projektant techniczny
projektant_tekstyliów	projektant tekstyliów
projektant_transmisji	projektant transmisji
projektant_układu	projektant układu
projektant_usług	projektant usług
projektant_wizualny	projektant wizualny
projektant_wnętrz	projektant wnętrz
projektant_wydarzeń	projektant wydarzeń
projektantka_dzianin	projektantka dzianin
projektantka_kwiatów	projektantka kwiatów
projektantka_odzieży_damskiej	projektantka odzieży damskiej
prorektor	prorektor
prywatny_bankier_hipoteczny	prywatny bankier hipoteczny
prywatny_detektyw	prywatny detektyw
prywatny_szef_kuchni	prywatny szef kuchni
przed_zarządcą_domu	przed zarządcą domu
przedstawiciel_agencji	przedstawiciel agencji
przedstawiciel_bankowości_osobistej	przedstawiciel bankowości osobistej
przedstawiciel_ds._roszczeń	przedstawiciel ds. roszczeń
przedstawiciel_ds._roszczeń_specjalnych	przedstawiciel ds. roszczeń specjalnych
przedstawiciel_finansowy	przedstawiciel finansowy
przedstawiciel_handlowy	przedstawiciel handlowy
przedstawiciel_handlowy_na_eksport	przedstawiciel handlowy na eksport
przedstawiciel_handlowy_ubezpieczeń	przedstawiciel handlowy ubezpieczeń
przedstawiciel_konta_reklamowego	przedstawiciel konta reklamowego
przedstawiciel_konta_ubezpieczeniowego	przedstawiciel konta ubezpieczeniowego
przedstawiciel_kraju	przedstawiciel kraju
przedstawiciel_kredytowy	przedstawiciel kredytowy
przedstawiciel_marketingowy	przedstawiciel marketingowy
przedstawiciel_obsługi_gości	przedstawiciel obsługi gości
przedstawiciel_public_relations	przedstawiciel public relations
przedstawiciel_recepcji	przedstawiciel recepcji
przedstawiciel_wsparcia_technicznego	przedstawiciel wsparcia technicznego
przedstawiciel_wsparcia_technicznego_klienta	przedstawiciel wsparcia technicznego klienta
przedszkolanka	przedszkolanka
przesunięcie_ołowiu	przesunięcie ołowiu
przewodnik_turystyczny	przewodnik turystyczny
przewoźnik_wiejski	przewoźnik wiejski
przewód_modułu	przewód modułu
przewód_podłogowy	przewód podłogowy
przełożony_przyjmujący	przełożony przyjmujący
psychoanalityk	psychoanalityk
psycholog	psycholog
psycholog_kliniczny	psycholog kliniczny
psycholog_sądowy	psycholog sądowy
psychoterapeuta_prowadzący_prywatną_praktykę	psychoterapeuta prowadzący prywatną praktykę
public_relations	public relations
publicysta	publicysta
rada	rada
radca_prawny	radca prawny
radca_procesowy	radca procesowy
radca_regionalny	radca regionalny
radca_zarządzający	radca zarządzający
radiolog	radiolog
ratownik	ratownik
redaktor	redaktor
redaktor_internetowy	redaktor internetowy
redaktor_konsultacyjny	redaktor konsultacyjny
redaktor_metra	redaktor metra
redaktor_miasta	redaktor miasta
redaktor_naczelny	redaktor naczelny
redaktor_podróżniczy	redaktor podróżniczy
redaktor_postprodukcji	redaktor postprodukcji
redaktor_prawniczy	redaktor prawniczy
redaktor_projektu	redaktor projektu
redaktor_sportowy	redaktor sportowy
redaktor_stylu_życia	redaktor stylu życia
redaktor_uruchomienia	redaktor uruchomienia
redaktor_wydawniczy	redaktor wydawniczy
redaktor_zadań	redaktor zadań
regionalny_dyrektor_ds._zapobiegania_stratom	regionalny dyrektor ds. zapobiegania stratom
regionalny_inżynier_sprzedaży	regionalny inżynier sprzedaży
regionalny_inżynier_systemowy	regionalny inżynier systemowy
regionalny_kierownik_budowy	regionalny kierownik budowy
regionalny_kierownik_logistyki	regionalny kierownik logistyki
regionalny_kierownik_produkcji	regionalny kierownik produkcji
regionalny_kierownik_transportu	regionalny kierownik transportu
regionalny_menadżer_ds._eksportu	regionalny menadżer ds. eksportu
regionalny_menadżer_ds._rekrutacji	regionalny menadżer ds. rekrutacji
regionalny_menadżer_przychodów	regionalny menadżer przychodów
regionalny_specjalista_ds._technicznych	regionalny specjalista ds. technicznych
regionalny_zarządca_nieruchomości	regionalny zarządca nieruchomości
rejestrator	rejestrator
rejestrator_uniwersytecki	rejestrator uniwersytecki
reklama_agenta	reklama agenta
rekrutacja_asystenta_menedżera	rekrutacja asystenta menedżera
rekruter	rekruter
rekruter_finansowy	rekruter finansowy
rekruter_inżynieryjny	rekruter inżynieryjny
rekruter_kontraktowy	rekruter kontraktowy
rekruter_medyczny	rekruter medyczny
rekruter_naukowy	rekruter naukowy
rekruter_sprzedaży	rekruter sprzedaży
rekruter_technologii	rekruter technologii
rekruter_wewnętrzny	rekruter wewnętrzny
rekruter_wykonawczy	rekruter wykonawczy
rekruter_zajmujący_się_pozyskiwaniem_talentów	rekruter zajmujący się pozyskiwaniem talentów
rektor	rektor
reporter_ruchu_drogowego	reporter ruchu drogowego
reporter_rynkowy	reporter rynkowy
reporter_sportowy	reporter sportowy
reporter_studencki	reporter studencki
reporter_wiadomości_telewizyjnych	reporter wiadomości telewizyjnych
retuszer	retuszer
rewident_księgowy	rewident księgowy
rezydent	rezydent
rezydent_anestezjologii	rezydent anestezjologii
rezydent_chorób_wewnętrznych	rezydent chorób wewnętrznych
rezydent_praktyki_aptecznej	rezydent praktyki aptecznej
reżyser	reżyser
reżyser_animacji	reżyser animacji
reżyser_obsady	reżyser obsady
reżyser_produkcji_wideo	reżyser produkcji wideo
reżyser_teatralny	reżyser teatralny
reżyser_telewizyjny	reżyser telewizyjny
reżyser_zdjęć	reżyser zdjęć
rigger_postaci	rigger postaci
roczny_zarządzający_funduszem	roczny zarządzający funduszem
rysownik_cywilny	rysownik cywilny
rysownik_mechaniczny	rysownik mechaniczny
rzecznik	rzecznik
rzecznik_klienta	rzecznik klienta
rzeźbiarz	rzeźbiarz
scenarzysta	scenarzysta
sekretarz_prawny	sekretarz prawny
sekretarz_produkcji	sekretarz produkcji
selektor_zamówień	selektor zamówień
serwer	serwer
serwer_bankietowy	serwer bankietowy
serwer_koktajlowy	serwer koktajlowy
serwer_restauracji	serwer restauracji
sezonowy_sprzedawca	sezonowy sprzedawca
sierżant	sierżant
sierżant_patrolowy	sierżant patrolowy
sierżant_policji	sierżant policji
składacz	składacz
smakosz	smakosz
sorter	sorter
spacerowicz_z_psem	spacerowicz z psem
specjalista_akademicki	specjalista akademicki
specjalista_automatyk	specjalista automatyk
specjalista_bankowości_biznesowej	specjalista bankowości biznesowej
specjalista_ds._aplikacji_internetowych	specjalista ds. aplikacji internetowych
specjalista_ds._automatyzacji_testów	specjalista ds. automatyzacji testów
specjalista_ds._bankowości_prywatnej	specjalista ds. bankowości prywatnej
specjalista_ds._bezpieczeństwa_sieci	specjalista ds. bezpieczeństwa sieci
specjalista_ds._bezprzewodowych	specjalista ds. bezprzewodowych
specjalista_ds._dochodzeń	specjalista ds. dochodzeń
specjalista_ds._egzekucji	specjalista ds. egzekucji
specjalista_ds._eksportu	specjalista ds. eksportu
specjalista_ds._fotografii	specjalista ds. fotografii
specjalista_ds._funduszy_inwestycyjnych	specjalista ds. funduszy inwestycyjnych
specjalista_ds._handlu	specjalista ds. handlu
specjalista_ds._handlu_międzynarodowego	specjalista ds. handlu międzynarodowego
specjalista_ds._importu	specjalista ds. importu
specjalista_ds._instrumentów_pochodnych	specjalista ds. instrumentów pochodnych
specjalista_ds._inwestycji	specjalista ds. inwestycji
specjalista_ds._inżynierii_procesowej	specjalista ds. inżynierii procesowej
specjalista_ds._kadr	specjalista ds. kadr
specjalista_ds._kapitału_własnego	specjalista ds. kapitału własnego
specjalista_ds._komputerów_osobistych	specjalista ds. komputerów osobistych
specjalista_ds._komunikacji	specjalista ds. komunikacji
specjalista_ds._komunikacji_internetowej	specjalista ds. komunikacji internetowej
specjalista_ds._komunikacji_marketingowej	specjalista ds. komunikacji marketingowej
specjalista_ds._komunikacji_wewnętrznej	specjalista ds. komunikacji wewnętrznej
specjalista_ds._kontaktów_z_absolwentami	specjalista ds. kontaktów z absolwentami
specjalista_ds._kredytów	specjalista ds. kredytów
specjalista_ds._kredytów_hipotecznych	specjalista ds. kredytów hipotecznych
specjalista_ds._kredytów_mieszkaniowych	specjalista ds. kredytów mieszkaniowych
specjalista_ds._kredytów_na_nieruchomości	specjalista ds. kredytów na nieruchomości
specjalista_ds._lokalizacji	specjalista ds. lokalizacji
specjalista_ds._magazynu	specjalista ds. magazynu
specjalista_ds._marketingu_handlowego	specjalista ds. marketingu handlowego
specjalista_ds._marketingu_i_public_relations	specjalista ds. marketingu i public relations
specjalista_ds._mediów_bibliotecznych	specjalista ds. mediów bibliotecznych
specjalista_ds._mediów_biblioteki_szkolnej	specjalista ds. mediów biblioteki szkolnej
specjalista_ds._mikrokomputerów	specjalista ds. mikrokomputerów
specjalista_ds._nauczania	specjalista ds. nauczania
specjalista_ds._nieruchomości	specjalista ds. nieruchomości
specjalista_ds._nieruchomości_komercyjnych	specjalista ds. nieruchomości komercyjnych
specjalista_ds._obsługi_klienta	specjalista ds. obsługi klienta
specjalista_ds._ochrony_środowiska	specjalista ds. ochrony środowiska
specjalista_ds._oprogramowania	specjalista ds. oprogramowania
specjalista_ds._podróży	specjalista ds. podróży
specjalista_ds._polityki	specjalista ds. polityki
specjalista_ds._postępowań_sądowych	specjalista ds. postępowań sądowych
specjalista_ds._pozyskiwania_funduszy	specjalista ds. pozyskiwania funduszy
specjalista_ds._pozyskiwania_talentów	specjalista ds. pozyskiwania talentów
specjalista_ds._prawnych	specjalista ds. prawnych
specjalista_ds._prawnych_i_compliance	specjalista ds. prawnych i compliance
specjalista_ds._procesów	specjalista ds. procesów
specjalista_ds._produkcji_medialnej	specjalista ds. produkcji medialnej
specjalista_ds._produkcji_wideo	specjalista ds. produkcji wideo
specjalista_ds._public_relations	specjalista ds. public relations
specjalista_ds._reklamy	specjalista ds. reklamy
specjalista_ds._relacji_inwestorskich	specjalista ds. relacji inwestorskich
specjalista_ds._relacji_z_darczyńcami	specjalista ds. relacji z darczyńcami
specjalista_ds._relacji_z_gośćmi	specjalista ds. relacji z gośćmi
specjalista_ds._relacji_z_mediami	specjalista ds. relacji z mediami
specjalista_ds._rozliczeń	specjalista ds. rozliczeń
specjalista_ds._rozwoju_biznesu	specjalista ds. rozwoju biznesu
specjalista_ds._rozwoju_gospodarczego	specjalista ds. rozwoju gospodarczego
specjalista_ds._sieci_danych	specjalista ds. sieci danych
specjalista_ds._sieci_komputerowych	specjalista ds. sieci komputerowych
specjalista_ds._sprzedaży_doradztwa	specjalista ds. sprzedaży doradztwa
specjalista_ds._stałych_dochodów	specjalista ds. stałych dochodów
specjalista_ds._strategii_konta	specjalista ds. strategii konta
specjalista_ds._systemów_sterowania	specjalista ds. systemów sterowania
specjalista_ds._szkoleń_i_staży	specjalista ds. szkoleń i staży
specjalista_ds._sztuki	specjalista ds. sztuki
specjalista_ds._telekomunikacji	specjalista ds. telekomunikacji
specjalista_ds._ubezpieczeń	specjalista ds. ubezpieczeń
specjalista_ds._upadłości	specjalista ds. upadłości
specjalista_ds._wsparcia_komputerów_stacjonarnych	specjalista ds. wsparcia komputerów stacjonarnych
specjalista_ds._wsparcia_regionalnego	specjalista ds. wsparcia regionalnego
specjalista_ds._wsparcia_użytkowników	specjalista ds. wsparcia użytkowników
specjalista_ds._wsparcia_użytkowników_końcowych	specjalista ds. wsparcia użytkowników końcowych
specjalista_ds._wydarzeń	specjalista ds. wydarzeń
specjalista_ds._wzroku	specjalista ds. wzroku
specjalista_ds._własności_intelektualnej	specjalista ds. własności intelektualnej
specjalista_ds._zamykania	specjalista ds. zamykania
specjalista_ds._zapewnienia_informacji	specjalista ds. zapewnienia informacji
specjalista_ds._zarządzania_kredytami	specjalista ds. zarządzania kredytami
specjalista_ds._zarządzania_talentami	specjalista ds. zarządzania talentami
specjalista_ds._zasobów	specjalista ds. zasobów
specjalista_ds._zastosowań_klinicznych	specjalista ds. zastosowań klinicznych
specjalista_ds._zatrudnienia	specjalista ds. zatrudnienia
specjalista_ds._zdrowia_i_fitnessu	specjalista ds. zdrowia i fitnessu
specjalista_ds._łańcucha_dostaw	specjalista ds. łańcucha dostaw
specjalista_elektronik	specjalista elektronik
specjalista_farmacji_klinicznej	specjalista farmacji klinicznej
specjalista_fitness	specjalista fitness
specjalista_grafik	specjalista grafik
specjalista_kardiologii	specjalista kardiologii
specjalista_kina_domowego	specjalista kina domowego
specjalista_kredytowy	specjalista kredytowy
specjalista_mechanik	specjalista mechanik
specjalista_od_czytania	specjalista od czytania
specjalista_od_czytania_i_pisania	specjalista od czytania i pisania
specjalista_od_koloru	specjalista od koloru
specjalista_od_nieruchomości	specjalista od nieruchomości
specjalista_od_relokacji	specjalista od relokacji
specjalista_od_sprzętu	specjalista od sprzętu
specjalista_operacyjny	specjalista operacyjny
specjalista_podatkowy	specjalista podatkowy
specjalista_sieciowy	specjalista sieciowy
specjalista_terenowy_agencji	specjalista terenowy agencji
specjalista_wsparcia_serwisu	specjalista wsparcia serwisu
specjalny_badacz	specjalny badacz
specjalny_doradca	specjalny doradca
spedytor	spedytor
spiker_antenowy	spiker antenowy
spiker_publiczny	spiker publiczny
sporządzający_podatek	sporządzający podatek
sprzedawca	sprzedawca
sprzedawca_artykułów_spożywczych	sprzedawca artykułów spożywczych
sprzedawca_detaliczny	sprzedawca detaliczny
sprzedawca_elektroniki	sprzedawca elektroniki
sprzedawca_instytucjonalny	sprzedawca instytucjonalny
sprzedawca_komputerów	sprzedawca komputerów
sprzedawca_na_pół_etatu	sprzedawca na pół etatu
sprzedawca_nieruchomości	sprzedawca nieruchomości
sprzedawca_owoców_morza	sprzedawca owoców morza
sprzedawca_żywności	sprzedawca żywności
sprzedaż_akcji	sprzedaż akcji
sprzedaż_instrumentów_pochodnych_na_akcje	sprzedaż instrumentów pochodnych na akcje
stanowy_i_lokalny_doradca_podatkowy	stanowy i lokalny doradca podatkowy
stały_konsultant_ds._rekrutacji	stały konsultant ds. rekrutacji
stażysta	stażysta
stażysta_animacji	stażysta animacji
stażysta_architektury_krajobrazu	stażysta architektury krajobrazu
stażysta_archiwalny	stażysta archiwalny
stażysta_bankowości_inwestycyjnej	stażysta bankowości inwestycyjnej
stażysta_budowlany	stażysta budowlany
stażysta_ds._badań_kapitałowych	stażysta ds. badań kapitałowych
stażysta_ds._finansów_przedsiębiorstw	stażysta ds. finansów przedsiębiorstw
stażysta_ds._kolekcji	stażysta ds. kolekcji
stażysta_ds._merchandisingu_wizualnego	stażysta ds. merchandisingu wizualnego
stażysta_ds._pozyskiwania_talentów	stażysta ds. pozyskiwania talentów
stażysta_ds._projektowania	stażysta ds. projektowania
stażysta_ds._projektowania_i_produkcji	stażysta ds. projektowania i produkcji
stażysta_ds._projektowania_mody	stażysta ds. projektowania mody
stażysta_ds._przyjęć	stażysta ds. przyjęć
stażysta_ds._usług_kreatywnych	stażysta ds. usług kreatywnych
stażysta_ds._zarządzania_ryzykiem	stażysta ds. zarządzania ryzykiem
stażysta_ds._żywności_i_napojów	stażysta ds. żywności i napojów
stażysta_działu_prawnego	stażysta działu prawnego
stażysta_inżynierii_lądowej	stażysta inżynierii lądowej
stażysta_inżynierii_mechanicznej	stażysta inżynierii mechanicznej
stażysta_inżynierii_oprogramowania	stażysta inżynierii oprogramowania
stażysta_inżynierii_projektowej	stażysta inżynierii projektowej
stażysta_inżynierii_systemowej	stażysta inżynierii systemowej
stażysta_kierunku_artystycznego	stażysta kierunku artystycznego
stażysta_medyczny	stażysta medyczny
stażysta_multimedialny	stażysta multimedialny
stażysta_muzyczny	stażysta muzyczny
stażysta_oprogramowania	stażysta oprogramowania
stażysta_postprodukcji	stażysta postprodukcji
stażysta_programista	stażysta programista
stażysta_programu_uniwersyteckiego	stażysta programu uniwersyteckiego
stażysta_programu_zarządzania_finansami	stażysta programu zarządzania finansami
stażysta_sportowy	stażysta sportowy
stażysta_w_funduszach_private_equity	stażysta w funduszach private equity
stażysta_w_recepcji	stażysta w recepcji
stażysta_w_zakresie_inżynierii_oprogramowania	stażysta w zakresie inżynierii oprogramowania
stażysta_wsparcia_technicznego_komputerów_stacjonarnych	stażysta wsparcia technicznego komputerów stacjonarnych
stażysta_zajmujący_się_projektowaniem_graficznym	stażysta zajmujący się projektowaniem graficznym
stażysta_zajmujący_się_tworzeniem_stron_internetowych	stażysta zajmujący się tworzeniem stron internetowych
sterownik_skrzyni_biegów	sterownik skrzyni biegów
steward_w_kabinie	steward w kabinie
strateg_inwestycyjny	strateg inwestycyjny
strateg_kapitałowy	strateg kapitałowy
strateg_marketingowy	strateg marketingowy
strateg_medialny	strateg medialny
strateg_mediów_społecznościowych	strateg mediów społecznościowych
strateg_produktu	strateg produktu
strateg_treści	strateg treści
strategiczny_konsultant_biznesowy	strategiczny konsultant biznesowy
strażak	strażak
student_informatyki	student informatyki
student_inżynierii_mechanicznej	student inżynierii mechanicznej
student_pielęgniarstwa	student pielęgniarstwa
student-wolontariusz	student-wolontariusz
studentka_architektury	studentka architektury
studentka_projektowania_graficznego	studentka projektowania graficznego
stylista	stylista
stylista_garderoby	stylista garderoby
stylista_włosów	stylista włosów
stylista_zdjęć	stylista zdjęć
szef_agencji	szef agencji
szef_badań_kapitałowych	szef badań kapitałowych
szef_bankowości_korporacyjnej	szef bankowości korporacyjnej
szef_bankowości_prywatnej	szef bankowości prywatnej
szef_batalionu	szef batalionu
szef_biura_średniego	szef biura średniego
szef_dystrybucji	szef dystrybucji
szef_działu_kadr	szef działu kadr
szef_działu_prawnego	szef działu prawnego
szef_działu_public_relations	szef działu public relations
szef_działu_zarządzania_klientami	szef działu zarządzania klientami
szef_finansów_korporacji	szef finansów korporacji
szef_finansów_projektu	szef finansów projektu
szef_finansów_strukturalnych	szef finansów strukturalnych
szef_grupy_HR	szef grupy HR
szef_grupy_medialnej	szef grupy medialnej
szef_handlu	szef handlu
szef_instytucji_finansowych	szef instytucji finansowych
szef_inwestycji	szef inwestycji
szef_kopii	szef kopii
szef_kuchni	szef kuchni
szef_kuchni_bankietów	szef kuchni bankietów
szef_kuchni_cateringu	szef kuchni cateringu
szef_kuchni_liniowy	szef kuchni liniowy
szef_kuchni_restauracji	szef kuchni restauracji
szef_logistyki	szef logistyki
szef_mediów_cyfrowych	szef mediów cyfrowych
szef_nieruchomości	szef nieruchomości
szef_operacji_sieciowych	szef operacji sieciowych
szef_polityki	szef polityki
szef_postprodukcji	szef postprodukcji
szef_public_relations	szef public relations
szef_reklamy	szef reklamy
szef_rekrutacji	szef rekrutacji
szef_rozwoju_strategicznego	szef rozwoju strategicznego
szef_rozwoju_stron_internetowych	szef rozwoju stron internetowych
szef_spraw_prawnych	szef spraw prawnych
szef_sprzedaży_i_handlu	szef sprzedaży i handlu
szef_telekomunikacji	szef telekomunikacji
szef_treści	szef treści
szef_ubezpieczeń	szef ubezpieczeń
szef_wydawnictwa	szef wydawnictwa
szef_zarządzania_aktywami	szef zarządzania aktywami
szef_zarządzania_majątkiem	szef zarządzania majątkiem
szef_zarządzania_talentami	szef zarządzania talentami
szef_zasobów	szef zasobów
szef_zbiórek	szef zbiórek
szeryf	szeryf
szkolna_pielęgniarka	szkolna pielęgniarka
sędzia	sędzia
sędzia_prawa_administracyjnego	sędzia prawa administracyjnego
służba_cywilna	służba cywilna
technik	technik
technik_IT	technik IT
technik_anestezjolog	technik anestezjolog
technik_aparatury_biomedycznej	technik aparatury biomedycznej
technik_archiwista	technik archiwista
technik_automatyk	technik automatyk
technik_awioniki	technik awioniki
technik_bezprzewodowy	technik bezprzewodowy
technik_budownictwa	technik budownictwa
technik_fortepianowy	technik fortepianowy
technik_foto	technik foto
technik_geolog	technik geolog
technik_grafik	technik grafik
technik_komputerowy	technik komputerowy
technik_komputerów_osobistych	technik komputerów osobistych
technik_konfiguracji	technik konfiguracji
technik_konserwacji_sprzętu	technik konserwacji sprzętu
technik_kontroli_sieci	technik kontroli sieci
technik_laboratorium_fotograficznego	technik laboratorium fotograficznego
technik_laboratorium_komputerowego	technik laboratorium komputerowego
technik_mechanik	technik mechanik
technik_mediów	technik mediów
technik_na_miejscu	technik na miejscu
technik_naprawy	technik naprawy
technik_naprawy_komputerów_osobistych	technik naprawy komputerów osobistych
technik_obrazowania_cyfrowego	technik obrazowania cyfrowego
technik_obsługi_klienta	technik obsługi klienta
technik_ochrony_środowiska	technik ochrony środowiska
technik_oddziału_ratunkowego	technik oddziału ratunkowego
technik_operacji_terenowych	technik operacji terenowych
technik_opieki_nad_zwierzętami	technik opieki nad zwierzętami
technik_podatkowy	technik podatkowy
technik_podłóg	technik podłóg
technik_pomocy_technicznej	technik pomocy technicznej
technik_radiolog	technik radiolog
technik_radiowy	technik radiowy
technik_ratownictwa_medycznego	technik ratownictwa medycznego
technik_rysownik	technik rysownik
technik_serwisu	technik serwisu
technik_serwisu_komputerowego	technik serwisu komputerowego
technik_sieci_komputerowych	technik sieci komputerowych
technik_sieciowy	technik sieciowy
technik_sprzętu	technik sprzętu
technik_sprzętu_komputerowego	technik sprzętu komputerowego
technik_systemów_komputerowych	technik systemów komputerowych
technik_telekomunikacji	technik telekomunikacji
technik_wdrażania	technik wdrażania
technik_weterynarii	technik weterynarii
technik_wsparcia	technik wsparcia
technik_wsparcia_aplikacji	technik wsparcia aplikacji
technik_wsparcia_komputerowego	technik wsparcia komputerowego
technik_wsparcia_komputerów_stacjonarnych	technik wsparcia komputerów stacjonarnych
technik_wsparcia_oprogramowania	technik wsparcia oprogramowania
technik_wsparcia_produktu	technik wsparcia produktu
technik_wsparcia_przy_biurku	technik wsparcia przy biurku
technik_wsparcia_sieci	technik wsparcia sieci
technik_wsparcia_systemowego	technik wsparcia systemowego
technik_wsparcia_technologicznego	technik wsparcia technologicznego
technik_wsparcia_terenowego	technik wsparcia terenowego
technik_wsparcia_użytkowników	technik wsparcia użytkowników
technik_zdrowia_behawioralnego	technik zdrowia behawioralnego
technik_zezwolenia	technik zezwolenia
technik_ławkowy	technik ławkowy
technik_łączności	technik łączności
technolog_USG	technolog USG
technolog_aplikacji	technolog aplikacji
technolog_badań_i_rozwoju	technolog badań i rozwoju
technolog_medycyny_nuklearnej	technolog medycyny nuklearnej
technolog_naczyniowy	technolog naczyniowy
technolog_personelu	technolog personelu
technolog_procesów	technolog procesów
technolog_produktu	technolog produktu
technolog_radiologii	technolog radiologii
technolog_rozwoju	technolog rozwoju
technolog_rozwoju_produktów	technolog rozwoju produktów
technolog_zapewnienia_jakości	technolog zapewnienia jakości
technologia	technologia
tekściarz	tekściarz
terapeuta	terapeuta
terapeuta_kliniczny	terapeuta kliniczny
terapeuta_małżeństwa_i_rodziny	terapeuta małżeństwa i rodziny
terapeuta_pedagogiczny	terapeuta pedagogiczny
terapeuta_szkolny	terapeuta szkolny
tester_aplikacji	tester aplikacji
trader_instrumentów_pochodnych_na_akcje	trader instrumentów pochodnych na akcje
trader_o_stałym_dochodzie	trader o stałym dochodzie
trader_opcji_na_akcje	trader opcji na akcje
trener_czytania	trener czytania
trener_fitness	trener fitness
trener_fitnessu	trener fitnessu
trener_instruktażowy	trener instruktażowy
trener_okręgowy	trener okręgowy
trener_osobisty	trener osobisty
trener_piłkarski	trener piłkarski
trener_piłki_nożnej	trener piłki nożnej
trener_psów	trener psów
trener_pływania	trener pływania
trener_rejonowy	trener rejonowy
trener_siły_i_kondycji	trener siły i kondycji
trener_technologii	trener technologii
trener_tenisa	trener tenisa
trener_umiejętności_czytania_i_pisania	trener umiejętności czytania i pisania
trener_wokalny	trener wokalny
trener_wydajności	trener wydajności
trener_wykonawczy	trener wykonawczy
twierdzi_radca_prawny	twierdzi radca prawny
twórca_gier	twórca gier
twórca_koncepcji	twórca koncepcji
twórca_rozwiązań	twórca rozwiązań
twórca_treści	twórca treści
twórca_wzorów	twórca wzorów
twórczy_artysta	twórczy artysta
tymczasowy_księgowy	tymczasowy księgowy
tymczasowy_współpracownik	tymczasowy współpracownik
tytuł_1_nauczyciel	tytuł 1 nauczyciel
tytułowy_agent	tytułowy agent
tytułowy_oficer	tytułowy oficer
tłumacz_języka_angielskiego	tłumacz języka angielskiego
tłumacz_języka_japońskiego	tłumacz języka japońskiego
tłumacz_techniczny	tłumacz techniczny
tłumacz_wewnętrzny	tłumacz wewnętrzny
ubezpieczyciel	ubezpieczyciel
ubezpieczyciel_linii_osobistych	ubezpieczyciel linii osobistych
uczeń_nauczyciel	uczeń nauczyciel
urbanista	urbanista
urzędnik_bankowy	urzędnik bankowy
urzędnik_ds._audytu	urzędnik ds. audytu
urzędnik_ds._eksportu	urzędnik ds. eksportu
urzędnik_ds._importu	urzędnik ds. importu
urzędnik_ds._pożyczek	urzędnik ds. pożyczek
urzędnik_ds._relacji	urzędnik ds. relacji
urzędnik_ds._zbiorów	urzędnik ds. zbiorów
urzędnik_kasowy	urzędnik kasowy
urzędnik_kredytowy	urzędnik kredytowy
urzędnik_obecności	urzędnik obecności
urzędnik_piekarni	urzędnik piekarni
urzędnik_prawniczy	urzędnik prawniczy
urzędnik_prowadzący_sprawę	urzędnik prowadzący sprawę
urzędnik_sieciowy	urzędnik sieciowy
urzędnik_sądowy	urzędnik sądowy
urzędnik_telekomunikacyjny	urzędnik telekomunikacyjny
urzędnik_zajmujący_się_wysyłką_i_odbiorem	urzędnik zajmujący się wysyłką i odbiorem
usługa_jest_teraz_programistą	usługa jest teraz programistą
webmaster_korporacyjny	webmaster korporacyjny
wewnątrz_hurtowni	wewnątrz hurtowni
wewnętrzny_agent_skarbowy	wewnętrzny agent skarbowy
wiceminister	wiceminister
wiceprezes	wiceprezes
wiceprezes_zarządu	wiceprezes zarządu
wiertarka	wiertarka
wieszak_na_klucze	wieszak na klucze
wizualizator	wizualizator
wizytujący_adiunkt	wizytujący adiunkt
wokalista	wokalista
wolny_zawód	wolny zawód
wsparcie_pierwszej_linii	wsparcie pierwszej linii
wspólnik_giełdowy	wspólnik giełdowy
wspólnik_handlowy	wspólnik handlowy
wspólnik_hipoteczny	wspólnik hipoteczny
wspólnik_podatkowy	wspólnik podatkowy
wspólnik_prawny	wspólnik prawny
wspólnik_roszczeń	wspólnik roszczeń
wspólnik_w_postępowaniu_sądowym	wspólnik w postępowaniu sądowym
wspólnik_zarządzający_biurem	wspólnik zarządzający biurem
wspólnik_założyciel	wspólnik założyciel
wspólnikiem_kapitałowym	wspólnikiem kapitałowym
współautor	współautor
współgospodarz_porannego_programu	współgospodarz porannego programu
współpilot	współpilot
współpracownik	współpracownik
współpracownik_Walmartu	współpracownik Walmartu
współpracownik_absolwenta	współpracownik absolwenta
współpracownik_architektoniczny	współpracownik architektoniczny
współpracownik_bankowości_inwestycyjnej	współpracownik bankowości inwestycyjnej
współpracownik_castingu	współpracownik castingu
współpracownik_ds._badań_kapitałowych	współpracownik ds. badań kapitałowych
współpracownik_ds._kontaktów_z_mediami	współpracownik ds. kontaktów z mediami
współpracownik_ds._obsługi_gości	współpracownik ds. obsługi gości
współpracownik_ds._rekrutacji	współpracownik ds. rekrutacji
współpracownik_ds._relacji_z_klientem	współpracownik ds. relacji z klientem
współpracownik_ds._rozwoju_biznesu	współpracownik ds. rozwoju biznesu
współpracownik_ds._rozwoju_firmy	współpracownik ds. rozwoju firmy
współpracownik_ds._rozwoju_produktu	współpracownik ds. rozwoju produktu
współpracownik_ds._zarządzania_ryzykiem	współpracownik ds. zarządzania ryzykiem
współpracownik_galerii	współpracownik galerii
współpracownik_handlu_detalicznego	współpracownik handlu detalicznego
współpracownik_komunikacji_korporacyjnej	współpracownik komunikacji korporacyjnej
współpracownik_księgowy	współpracownik księgowy
współpracownik_logistyki	współpracownik logistyki
współpracownik_magazynu	współpracownik magazynu
współpracownik_marketingu_i_komunikacji	współpracownik marketingu i komunikacji
współpracownik_mediów	współpracownik mediów
współpracownik_nieruchomości	współpracownik nieruchomości
współpracownik_opieki_nad_zwierzętami	współpracownik opieki nad zwierzętami
współpracownik_portfela	współpracownik portfela
współpracownik_pośrednika_w_handlu_nieruchomościami	współpracownik pośrednika w handlu nieruchomościami
współpracownik_private_equity	współpracownik private equity
współpracownik_procesowy	współpracownik procesowy
współpracownik_przewoźnika_wiejskiego	współpracownik przewoźnika wiejskiego
współpracownik_przy_ladzie_frontowej	współpracownik przy ladzie frontowej
współpracownik_przymierzalni	współpracownik przymierzalni
współpracownik_public_relations	współpracownik public relations
współpracownik_recepcji	współpracownik recepcji
współpracownik_skarbu	współpracownik skarbu
współpracownik_sklepu_z_pamiątkami	współpracownik sklepu z pamiątkami
współpracownik_sprzedaży	współpracownik sprzedaży
współpracownik_transmisji	współpracownik transmisji
współpracownik_usług_członkowskich	współpracownik usług członkowskich
współpracownik_usług_finansowych	współpracownik usług finansowych
współpracownik_wsparcia_technicznego	współpracownik wsparcia technicznego
współpracownik_wyceny	współpracownik wyceny
współpracownik_zagraniczny	współpracownik zagraniczny
współpracownik_zbiorów	współpracownik zbiorów
wybitny_członek_personelu_technicznego	wybitny członek personelu technicznego
wybitny_inżynier_oprogramowania	wybitny inżynier oprogramowania
wydawca	wydawca
wydawca_grupowy	wydawca grupowy
wydawca_internetowy	wydawca internetowy
wydawca_komputerów_stacjonarnych	wydawca komputerów stacjonarnych
wydział_w_pełnym_wymiarze_godzin	wydział w pełnym wymiarze godzin
wykonawca	wykonawca
wykonawca_prawny	wykonawca prawny
wykonawcza_gospodyni	wykonawcza gospodyni
wykonawczy_dyrektor_artystyczny	wykonawczy dyrektor artystyczny
wykonawczy_dyrektor_kreatywny	wykonawczy dyrektor kreatywny
wykonawczy_dyrektor_medyczny	wykonawczy dyrektor medyczny
wykonawczy_sekretarz_prawny	wykonawczy sekretarz prawny
wykładowca	wykładowca
wyznaczonego_brokera	wyznaczonego brokera
wyłączny_agent	wyłączny agent
wyższy_urzędnik_wykonawczy	wyższy urzędnik wykonawczy
właściciel_agencji	właściciel agencji
właściciel_restauracji	właściciel restauracji
właściciel_salonu	właściciel salonu
właścicielski_przedsiębiorca	właścicielski przedsiębiorca
zaawansowane_usługi_menedżerskie	zaawansowane usługi menedżerskie
zaawansowany_inżynier_systemowy	zaawansowany inżynier systemowy
zagraniczny_doradca_prawny	zagraniczny doradca prawny
zapalony_redaktor	zapalony redaktor
zarejestrowana_asystentka_stomatologiczna	zarejestrowana asystentka stomatologiczna
zarejestrowany_technik_weterynarii	zarejestrowany technik weterynarii
zarządca_infrastruktury_sieciowej	zarządca infrastruktury sieciowej
zarządca_komunikacji	zarządca komunikacji
zarządca_nieruchomości	zarządca nieruchomości
zarządca_nieruchomości_mieszkalnej	zarządca nieruchomości mieszkalnej
zasada_działania	zasada działania
zasoby_wykonawcze	zasoby wykonawcze
zastępca_dyrektora_apteki	zastępca dyrektora apteki
zastępca_dyrektora_banku	zastępca dyrektora banku
zastępca_dyrektora_ds._gastronomii	zastępca dyrektora ds. gastronomii
zastępca_dyrektora_ds._komunikacji	zastępca dyrektora ds. komunikacji
zastępca_dyrektora_ds._rekrutacji_na_studia_licencjackie	zastępca dyrektora ds. rekrutacji na studia licencjackie
zastępca_dyrektora_ds._rozwoju_biznesu	zastępca dyrektora ds. rozwoju biznesu
zastępca_dyrektora_ds._sprzątania	zastępca dyrektora ds. sprzątania
zastępca_dyrektora_ds._wiadomości	zastępca dyrektora ds. wiadomości
zastępca_dyrektora_funduszu_rocznego	zastępca dyrektora funduszu rocznego
zastępca_dyrektora_generalnego	zastępca dyrektora generalnego
zastępca_dyrektora_kreatywnego	zastępca dyrektora kreatywnego
zastępca_dyrektora_ochrony	zastępca dyrektora ochrony
zastępca_dyrektora_pielęgniarstwa	zastępca dyrektora pielęgniarstwa
zastępca_dyrektora_szkoły	zastępca dyrektora szkoły
zastępca_głównego_doradcy	zastępca głównego doradcy
zastępca_głównego_pilota	zastępca głównego pilota
zastępca_głównego_radcy_prawnego	zastępca głównego radcy prawnego
zastępca_inżyniera_miejskiego	zastępca inżyniera miejskiego
zastępca_inżyniera-rezydenta	zastępca inżyniera-rezydenta
zastępca_kierownika	zastępca kierownika
zastępca_kierownika_baru	zastępca kierownika baru
zastępca_kierownika_budowy	zastępca kierownika budowy
zastępca_kierownika_cateringu	zastępca kierownika cateringu
zastępca_kierownika_ds._komunikacji_korporacyjnej	zastępca kierownika ds. komunikacji korporacyjnej
zastępca_kierownika_ds._prawnych	zastępca kierownika ds. prawnych
zastępca_kierownika_ds._żywności_i_napojów	zastępca kierownika ds. żywności i napojów
zastępca_kierownika_inwestycji	zastępca kierownika inwestycji
zastępca_kierownika_kuchni	zastępca kierownika kuchni
zastępca_kierownika_nocnej_zmiany	zastępca kierownika nocnej zmiany
zastępca_kierownika_obsługi_gości	zastępca kierownika obsługi gości
zastępca_kierownika_outletu	zastępca kierownika outletu
zastępca_kierownika_recepcji	zastępca kierownika recepcji
zastępca_kierownika_sprzątania	zastępca kierownika sprzątania
zastępca_kierownika_terminala	zastępca kierownika terminala
zastępca_komendanta_straży_pożarnej	zastępca komendanta straży pożarnej
zastępca_menadżera_frontendu	zastępca menadżera frontendu
zastępca_menadżera_funduszu	zastępca menadżera funduszu
zastępca_menadżera_rynku	zastępca menadżera rynku
zastępca_obrońcy_publicznego	zastępca obrońcy publicznego
zastępca_prokuratora_generalnego	zastępca prokuratora generalnego
zastępca_prokuratora_miejskiego	zastępca prokuratora miejskiego
zastępca_prokuratora_okręgowego	zastępca prokuratora okręgowego
zastępca_radcy_generalnego	zastępca radcy generalnego
zastępca_redaktora_naczelnego	zastępca redaktora naczelnego
zastępca_sekretarza	zastępca sekretarza
zastępca_sekretarza_korporacyjnego	zastępca sekretarza korporacyjnego
zastępca_szefa_kuchni	zastępca szefa kuchni
zastępca_szefa_policji	zastępca szefa policji
zastępca_szefa_straży_pożarnej	zastępca szefa straży pożarnej
zastępca_szeryfa	zastępca szeryfa
zastępca_wiceprezesa_ds._underwritingu	zastępca wiceprezesa ds. underwritingu
zastępca_wiceprezesa_dyrektora_ds._kont	zastępca wiceprezesa dyrektora ds. kont
zastępcą_dyrektora	zastępcą dyrektora
zawodowy_kierowca	zawodowy kierowca
zawodowy_piłkarz	zawodowy piłkarz
zbieracz	zbieracz
zbieracz_zamówień	zbieracz zamówień
zespół_wykonawczy_kieruje_doświadczeniem_gości	zespół wykonawczy kieruje doświadczeniem gości
zielarz	zielarz
ładowarka	ładowarka
łowca_lokalizacji	łowca lokalizacji
łącznik_kliniczny	łącznik kliniczny
łącznik_pielęgniarki	łącznik pielęgniarki
Śpiewak_operowy	Śpiewak operowy
śledczy_kryminalny	śledczy kryminalny
źródło	źródło
żołnierz_stanowy	żołnierz stanowy
żywieniowiec	żywieniowiec
