3dアーティスト	3dアーティスト
3dキャラクター_アニメーター	3dキャラクター アニメーター
3dジェネラリスト	3dジェネラリスト
3dモデラー	3dモデラー
3d環境アーティスト	3d環境アーティスト
AVID編集者	AVID編集者
BSCエンジニア	BSCエンジニア
DTPオペレーター	DTPオペレーター
IRアソシエイト	IRアソシエイト
ITコンサルタント	ITコンサルタント
ITサポートスペシャリスト	ITサポートスペシャリスト
ITサポート技術者	ITサポート技術者
ITシステムエンジニア	ITシステムエンジニア
ITジェネラリスト	ITジェネラリスト
ITスペシャリスト	ITスペシャリスト
ITセキュリティ_アナリスト	ITセキュリティ アナリスト
ITセキュリティ_エンジニア	ITセキュリティ エンジニア
ITセキュリティ管理者	ITセキュリティ管理者
ITリクルーター	ITリクルーター
IT分野の技術者	IT分野の技術者
IT技術採用担当者	IT技術採用担当者
IT技術者	IT技術者
IT採用コンサルタント	IT採用コンサルタント
J2EE開発者	J2EE開発者
Java/_j2ee_開発者	Java/ j2ee 開発者
Javaアプリケーション開発者	Javaアプリケーション開発者
Javaアーキテクト	Javaアーキテクト
Javaウェブ開発者	Javaウェブ開発者
Javaコンサルタント	Javaコンサルタント
Javaソフトウェアエンジニア	Javaソフトウェアエンジニア
Javaチームリーダー	Javaチームリーダー
Javaテクニカルリーダー	Javaテクニカルリーダー
Java開発者	Java開発者
MBA候補者	MBA候補者
MBA参加者	MBA参加者
MBA大学院生	MBA大学院生
PHPウェブ開発者	PHPウェブ開発者
SCADAエンジニア	SCADAエンジニア
ServiceNow開発者	ServiceNow開発者
TOEFL講師	TOEFL講師
Title_1プログラムの教師	Title 1プログラムの教師
UIエンジニア	UIエンジニア
UIデザイナー	UIデザイナー
VFXアーティスト	VFXアーティスト
VoIPエンジニア	VoIPエンジニア
VoIPネットワークエンジニア	VoIPネットワークエンジニア
Web_UI開発者	Web UI開発者
Webアプリケーション_プログラマー	Webアプリケーション プログラマー
Webアプリケーション開発者	Webアプリケーション開発者
Webアプリケーション_スペシャリスト	Webアプリケーション スペシャリスト
Webプログラマー	Webプログラマー
html5_開発者	html5 開発者
iOSアプリ開発者	iOSアプリ開発者
phpプログラマー	phpプログラマー
おもてなしコーディネーター	おもてなしコーディネーター
アウトソーシング_マネージャー	アウトソーシング マネージャー
アウトリーチ_カウンセラー	アウトリーチ カウンセラー
アカウント_エグゼクティブ	アカウント エグゼクティブ
アカウント_ストラテジスト	アカウント ストラテジスト
アカウント_スーパーバイザー	アカウント スーパーバイザー
アカウント_ディレクター	アカウント ディレクター
アカウントプランナー	アカウントプランナー
アカウントマネージャー	アカウントマネージャー
アカウント役員の副社長補佐	アカウント役員の副社長補佐
アカウント採用マネージャー	アカウント採用マネージャー
アカデミックプログラム_コーディネーター	アカデミックプログラム コーディネーター
アクアエアロビクス_インストラクター	アクアエアロビクス インストラクター
アクセサリー_デザイナー	アクセサリー デザイナー
アシスタント_アウトレット_マネージャー	アシスタント アウトレット マネージャー
アシスタント_アニメーター	アシスタント アニメーター
アシスタント_アーキビスト	アシスタント アーキビスト
アシスタント_インベストメント_マネージャー	アシスタント インベストメント マネージャー
アシスタント_キッチンマネージャー	アシスタント キッチンマネージャー
アシスタント_ケータリングマネージャー	アシスタント ケータリングマネージャー
アシスタント_コンテンツマネージャー	アシスタント コンテンツマネージャー
アシスタント_サッカーコーチ	アシスタント サッカーコーチ
アシスタント_システム_アナリスト	アシスタント システム アナリスト
アシスタント_ストレングス&コンディショニングコーチ	アシスタント ストレングス&コンディショニングコーチ
アシスタント_ゼネラルマネージャー	アシスタント ゼネラルマネージャー
アシスタント_ターミナルマネージャー	アシスタント ターミナルマネージャー
アシスタント_ニュースディレクター	アシスタント ニュースディレクター
アシスタント_バンクマネージャー	アシスタント バンクマネージャー
アシスタント_バーマネージャー	アシスタント バーマネージャー
アシスタント_パティシエ	アシスタント パティシエ
アシスタント_ハウスキーピンク_゙マネージャー	アシスタント ハウスキーピンク ゙マネージャー
アシスタント_ブランドマネージャー	アシスタント ブランドマネージャー
アシスタント_プライベートバンカー	アシスタント プライベートバンカー
アシスタント_プロジェクトエンジニア	アシスタント プロジェクトエンジニア
アシスタント_ファンドマネージャー	アシスタント ファンドマネージャー
アシスタント_フォトグラファー	アシスタント フォトグラファー
アシスタント_フロントエンド_マネージャー	アシスタント フロントエンド マネージャー
アシスタント_フロントオフィス_マネージャー	アシスタント フロントオフィス マネージャー
アシスタント_フロントマネージャー	アシスタント フロントマネージャー
アシスタント_フードサービス_ディレクター	アシスタント フードサービス ディレクター
アシスタント_ポートフォリオマネージャー	アシスタント ポートフォリオマネージャー
アシスタント_マーケットマネージャー	アシスタント マーケットマネージャー
アシスタント_メカニカルエンジニア	アシスタント メカニカルエンジニア
アシスタント_リレーションシップ_マネージャー	アシスタント リレーションシップ マネージャー
アシスタント_レベニューマネージャー	アシスタント レベニューマネージャー
アシスタント_ロケーションマネージャー	アシスタント ロケーションマネージャー
アシスタントアーキテクト	アシスタントアーキテクト
アシスタントエディター	アシスタントエディター
アシスタントクック	アシスタントクック
アシスタントシェフ	アシスタントシェフ
アシスタントチーフパイロット	アシスタントチーフパイロット
アシスタントデザイナー	アシスタントデザイナー
アシスタントプランナー	アシスタントプランナー
アシスタントプロデューサー	アシスタントプロデューサー
アシスタントマネージャー	アシスタントマネージャー
アシスタント予約マネージャー	アシスタント予約マネージャー
アシスタント動画編集者	アシスタント動画編集者
アシスタント常駐エンジニア	アシスタント常駐エンジニア
アシスタント建設マネージャー	アシスタント建設マネージャー
アシスタント技術デザイナー	アシスタント技術デザイナー
アシスタント管理会計士	アシスタント管理会計士
アシスタント設計エンジニア	アシスタント設計エンジニア
アシスタント都市エンジニア	アシスタント都市エンジニア
アシスタント飲食マネージャー	アシスタント飲食マネージャー
アスレチック_コーディネーター	アスレチック コーディネーター
アセット_ライアビリティ_マネージャー	アセット ライアビリティ マネージャー
アソシエイト	アソシエイト
アドバイザリー_セールス_スペシャリスト	アドバイザリー セールス スペシャリスト
アドバイザリーシステム_アナリスト	アドバイザリーシステム アナリスト
アドミッションアンバサダー	アドミッションアンバサダー
アナウンサー	アナウンサー
アナログデザイナー	アナログデザイナー
アナログ設計エンジニア	アナログ設計エンジニア
アニメーション_インターン	アニメーション インターン
アニメーション_スーパーバイザー	アニメーション スーパーバイザー
アニメーション_リーダー	アニメーション リーダー
アニメーションアーティスト	アニメーションアーティスト
アニメーション監督	アニメーション監督
アニメーション講師	アニメーション講師
アニメーター	アニメーター
アパレルデザイナー	アパレルデザイナー
アプリケーション_エンジニア	アプリケーション エンジニア
アプリケーション_テスター	アプリケーション テスター
アプリケーションサポート技術者	アプリケーションサポート技術者
アプリケーション開発チームのリーダー	アプリケーション開発チームのリーダー
アプリケーション開発者	アプリケーション開発者
アフィリエイトブローカー	アフィリエイトブローカー
アルバイトの販売員	アルバイトの販売員
アンドロイド開発者	アンドロイド開発者
アーカイブアシスタント	アーカイブアシスタント
アーカイブエンジニア	アーカイブエンジニア
アーカイブ_インターン	アーカイブ インターン
アーティスト	アーティスト
アートコンサルタント	アートコンサルタント
アートセラピスト	アートセラピスト
アートディレクションのインターン	アートディレクションのインターン
アートディレクター	アートディレクター
アートディレクター	アートディレクター
アートハンドラー	アートハンドラー
イタリア語教師	イタリア語教師
イノベーションエンジニア	イノベーションエンジニア
イベントコンサルタント	イベントコンサルタント
イベントコーディネーター	イベントコーディネーター
イベントスペシャリスト	イベントスペシャリスト
イベントデザイナー	イベントデザイナー
イベントプランナー	イベントプランナー
イベントフォトグラファー	イベントフォトグラファー
イベントマネージャー	イベントマネージャー
イベント企画アシスタント	イベント企画アシスタント
イベント役員	イベント役員
イベント運営ディレクター	イベント運営ディレクター
イラストレーター	イラストレーター
インタラクティブ_アートディレクター	インタラクティブ アートディレクター
インタラクティブ_プロデューサー	インタラクティブ プロデューサー
インタラクティブな開発者	インタラクティブな開発者
インタラクティブメディア_マネージャー	インタラクティブメディア マネージャー
インタラクティブ販売マネージャー	インタラクティブ販売マネージャー
インターネット_マーケティング_コーディネーター	インターネット マーケティング コーディネーター
インターネット管理者	インターネット管理者
インターン	インターン
インテリアデザイナー	インテリアデザイナー
インドアバイク_インストラクター	インドアバイク インストラクター
インフラ_スーパーバイザー	インフラ スーパーバイザー
イールドマネージャー	イールドマネージャー
ウェイター	ウェイター
ウェイターの責任者	ウェイターの責任者
ウェディング_コーディネーター	ウェディング コーディネーター
ウェディングとイベントプランナー	ウェディングとイベントプランナー
ウェディング_コンサルタント	ウェディング コンサルタント
ウェブおよびグラフィックデザイナー	ウェブおよびグラフィックデザイナー
ウェブエンジニア	ウェブエンジニア
ウェブコンテンツライター	ウェブコンテンツライター
ウェブサイト_コンテンツマネージャー	ウェブサイト コンテンツマネージャー
ウェブサイト_マネージャー	ウェブサイト マネージャー
ウェブサイトデザイナー	ウェブサイトデザイナー
ウェブジャーナリスト	ウェブジャーナリスト
ウェブデザイナー	ウェブデザイナー
ウェブパブリッシャー	ウェブパブリッシャー
ウェブプロデューサー	ウェブプロデューサー
ウェブ開発インターン	ウェブ開発インターン
ウェブ開発エンジニア	ウェブ開発エンジニア
ウェブ開発チームのリーダー	ウェブ開発チームのリーダー
ウェブ開発マネージャー	ウェブ開発マネージャー
ウェブ開発責任者	ウェブ開発責任者
ウェフ通信スペシャリスト	ウェフ通信スペシャリスト
ウェブ編集者	ウェブ編集者
ウォルマートのスタッフ	ウォルマートのスタッフ
エアロダイナミクス_エンジニア	エアロダイナミクス エンジニア
エグゼクティブ_アートディレクター	エグゼクティブ アートディレクター
エグゼクティブ_クリエイティブ_ディレクター	エグゼクティブ クリエイティブ ディレクター
エグゼクティブ_チームリーダー－ゲストエクスペリエンス	エグゼクティブ チームリーダー－ゲストエクスペリエンス
エグゼクティブ_パティシエ	エグゼクティブ パティシエ
エグゼクティブ_リクルーター	エグゼクティブ リクルーター
エグゼクティブ_リソース	エグゼクティブ リソース
エグゼクティブコーチ	エグゼクティブコーチ
エグゼクティブサーチ_コンサルタント	エグゼクティブサーチ コンサルタント
エグゼクティブサーチのディレクター	エグゼクティブサーチのディレクター
エグゼクティブ法務秘書	エグゼクティブ法務秘書
エグゼクティブ_スーシェフ	エグゼクティブ スーシェフ
エグゼクティブ_ハウスキーパー	エグゼクティブ ハウスキーパー
エグゼクティブ_バイスプレジデント	エグゼクティブ バイスプレジデント
エグゼクティブ_メディカルディレクター	エグゼクティブ メディカルディレクター
エジソンエンジニア	エジソンエンジニア
エジソン_エンジニアリング開発プログラム	エジソン エンジニアリング開発プログラム
エスクローアシスタント	エスクローアシスタント
エリアコレクション_マネージャー	エリアコレクション マネージャー
エリアセールス_エンジニア	エリアセールス エンジニア
エンジニアリング_デザイナー	エンジニアリング デザイナー
エンジニアリング採用担当者	エンジニアリング採用担当者
エンターテイナー	エンターテイナー
エンタープライズ_エンジニア	エンタープライズ エンジニア
エンドユーザー支援スペシャリスト	エンドユーザー支援スペシャリスト
オプション取引業者	オプション取引業者
オフィス制作アシスタント	オフィス制作アシスタント
オペラ歌手	オペラ歌手
オペレーティングシステム_アナリスト	オペレーティングシステム アナリスト
オペレーション_スペシャリスト	オペレーション スペシャリスト
オルガニスト	オルガニスト
オンエアパーソナリティ	オンエアパーソナリティ
オンサイト技術者	オンサイト技術者
オンライン_マーケター	オンライン マーケター
オンライン広告マネージャー	オンライン広告マネージャー
オークショニア	オークショニア
オーダーセレクター	オーダーセレクター
オーダーピッカー	オーダーピッカー
オーディオエンジニア	オーディオエンジニア
オーディオミキサー	オーディオミキサー
オーディエンス開発ディレクター	オーディエンス開発ディレクター
オートメーション_スペシャリスト	オートメーション スペシャリスト
オーバーナイト_ストッカー	オーバーナイト ストッカー
オープンソース開発者	オープンソース開発者
カウンセラー	カウンセラー
カウンター店員	カウンター店員
カクテルウェイトレス	カクテルウェイトレス
カクテルサーバー	カクテルサーバー
カスタマー_テクニカルサポート_エンジニア	カスタマー テクニカルサポート エンジニア
カスタマーサポート_アナリスト	カスタマーサポート アナリスト
カスタマーサポート技術者	カスタマーサポート技術者
カスタマーサービススペシャリスト	カスタマーサービススペシャリスト
カフェ店長	カフェ店長
カメラアシスタント	カメラアシスタント
カメラオペレーター	カメラオペレーター
カメラマン	カメラマン
カラースペシャリスト	カラースペシャリスト
カントリービジネス_マネージャー	カントリービジネス マネージャー
カンファレンス_サービス_コーディネーター	カンファレンス サービス コーディネーター
ギタリスト	ギタリスト
ギター講師	ギター講師
ギャラリー_アソシエイト	ギャラリー アソシエイト
ギャラリー_コーディネーター	ギャラリー コーディネーター
ギャラリーアシスタント	ギャラリーアシスタント
ギャラリーマネージャー	ギャラリーマネージャー
キッチン_スーパーバイザー	キッチン スーパーバイザー
キッチンスタッフ	キッチンスタッフ
キッチンマネージャー	キッチンマネージャー
キャスティングディレクター	キャスティングディレクター
キャスティングプロデューサー	キャスティングプロデューサー
キャスティング_アソシエイト	キャスティング アソシエイト
キャビンアテンダント	キャビンアテンダント
キャプテン	キャプテン
キャラクター_テクニカルディレクター	キャラクター テクニカルディレクター
キャラクター_モデラー	キャラクター モデラー
キャラクターアニメーター	キャラクターアニメーター
キャラクターアーティスト	キャラクターアーティスト
キャラクターデザイナー	キャラクターデザイナー
キャラクターリガー	キャラクターリガー
キュレーター	キュレーター
キーボーディスト	キーボーディスト
ギタープレイヤー	ギタープレイヤー
ギフトショップ店員	ギフトショップ店員
グラフィック_スペシャリスト	グラフィック スペシャリスト
グラフィック_テクニシャン	グラフィック テクニシャン
グラフィックアーティスト	グラフィックアーティスト
グラフィックサービス_マネージャー	グラフィックサービス マネージャー
グラフィックデザイン_アシスタント	グラフィックデザイン アシスタント
グラフィックデザイン_アーティスト	グラフィックデザイン アーティスト
グラフィックデザイン_コンサルタント	グラフィックデザイン コンサルタント
グラフィックデザイン_コーディネーター	グラフィックデザイン コーディネーター
グラフィックデザイン_スーパーバイザー	グラフィックデザイン スーパーバイザー
グラフィックデザイン_マネージャー	グラフィックデザイン マネージャー
グラフィックデザインのインターン	グラフィックデザインのインターン
グラフィックデザインの学生	グラフィックデザインの学生
グラフィックデザインの講師	グラフィックデザインの講師
グラフィック制作アーティスト	グラフィック制作アーティスト
グループフィットネス_インストラクター	グループフィットネス インストラクター
グループメディア_ディレクター	グループメディア ディレクター
グループ人事マネージャー	グループ人事マネージャー
グループ企画ディレクター	グループ企画ディレクター
グループ発行者	グループ発行者
グルーマー	グルーマー
グローバル_コミュニケーションマネージャー	グローバル コミュニケーションマネージャー
グローバル_トラベルマネージャー	グローバル トラベルマネージャー
グローバル事業開発マネージャー	グローバル事業開発マネージャー
グローバル広報マネージャー	グローバル広報マネージャー
クライアント_リレーションシップ_アソシエイト	クライアント リレーションシップ アソシエイト
クライアントの代弁者	クライアントの代弁者
クライアントサポート_アナリスト	クライアントサポート アナリスト
クライアントサポート_スペシャリスト	クライアントサポート スペシャリスト
クライアントサポート技術者	クライアントサポート技術者
クライアントサービス_ディレクター	クライアントサービス ディレクター
クライアント会計士	クライアント会計士
クライアント側の開発者	クライアント側の開発者
クラスの教師	クラスの教師
クラスターリーダー	クラスターリーダー
クリエイティブ_グラフィックデザイナー	クリエイティブ グラフィックデザイナー
クリエイティブ_コピーライター	クリエイティブ コピーライター
クリエイティブ_プロジェクト_マネージャー	クリエイティブ プロジェクト マネージャー
クリエイティブ_プロデューサー	クリエイティブ プロデューサー
クリエイティブサービス_インターン	クリエイティブサービス インターン
クリエイティブサービス_スーパーバイザー	クリエイティブサービス スーパーバイザー
クリエイティブサービス_プロデューサー	クリエイティブサービス プロデューサー
クリエイティブサービス_マネージャー	クリエイティブサービス マネージャー
クリエイティブサービスの副社長	クリエイティブサービスの副社長
クリエイティブライター	クリエイティブライター
クリエイティブリーダー	クリエイティブリーダー
クリエイティブ開発者	クリエイティブ開発者
クリエイティブ_インターン	クリエイティブ インターン
クリエイティブ_マネージャー	クリエイティブ マネージャー
クリエイティブな芸術家	クリエイティブな芸術家
クリエイティブデザイン_マネージャー	クリエイティブデザイン マネージャー
クリニック_スーパーバイザー	クリニック スーパーバイザー
クレジットオフィサー	クレジットオフィサー
クレジットスペシャリスト	クレジットスペシャリスト
クレジット担当者	クレジット担当者
クレジット_スーパーバイザー	クレジット スーパーバイザー
クレジットアナリスト	クレジットアナリスト
クレジットリサーチ_アナリスト	クレジットリサーチ アナリスト
クロスフィットインストラクター	クロスフィットインストラクター
クロージング_スペシャリスト	クロージング スペシャリスト
クロージング_スーパーバイザー	クロージング スーパーバイザー
グラフィックデザインの教師	グラフィックデザインの教師
グループ_アート_スーパーバイザー	グループ アート スーパーバイザー
グループ_エンジニアリング_マネージャー	グループ エンジニアリング マネージャー
グループ_コピースーパーバイザー	グループ コピースーパーバイザー
グループ_ファシリテーター	グループ ファシリテーター
グループ_ロジスティクス_マネージャー	グループ ロジスティクス マネージャー
グループ顧問弁護士	グループ顧問弁護士
グローバル人事担当副社長	グローバル人事担当副社長
グローバル物流マネージャー	グローバル物流マネージャー
ゲストアーティスト	ゲストアーティスト
ゲストサービス_アシスタントマネージャー	ゲストサービス アシスタントマネージャー
ゲストサービス_アソシエイト	ゲストサービス アソシエイト
ゲストサービス_コーディネーター	ゲストサービス コーディネーター
ゲストサービス_スーパーバイザー	ゲストサービス スーパーバイザー
ゲストサービス担当者	ゲストサービス担当者
ゲストリレーション_オフィサー	ゲストリレーション オフィサー
ゲストリレーション_コーディネーター	ゲストリレーション コーディネーター
ゲストリレーション_スーパーバイザー	ゲストリレーション スーパーバイザー
ゲストリレーションス役員	ゲストリレーションス役員
ゲスト講師	ゲスト講師
ゲームアーティスト	ゲームアーティスト
ゲームディレクター	ゲームディレクター
ゲームデザイナー	ゲームデザイナー
ケータリンク_゙コーディネーター	ケータリンク ゙コーディネーター
ケータリングのシェフ	ケータリングのシェフ
ケータリング_イベントマネージャー	ケータリング イベントマネージャー
ケータリング_スーパーバイザー	ケータリング スーパーバイザー
ケータリング営業ディレクター	ケータリング営業ディレクター
ゲストサービス担当者	ゲストサービス担当者
コア_ネットワークエンジニア	コア ネットワークエンジニア
コアエンジニア	コアエンジニア
コアネットワーク_マネージャー	コアネットワーク マネージャー
コストマネージャー	コストマネージャー
コスメトロジスト	コスメトロジスト
コピーの責任者	コピーの責任者
コピースーパーバイザー	コピースーパーバイザー
コピーディレクター	コピーディレクター
コピーマネージャー	コピーマネージャー
コピーライター	コピーライター
コマーシャル_コーディネーター	コマーシャル コーディネーター
コマーシャル_スーパーバイザー	コマーシャル スーパーバイザー
コマーシャル_ラインプロデューサー	コマーシャル ラインプロデューサー
コマーシャルアナリスト	コマーシャルアナリスト
コマーシャルバンキング関係マネージャー	コマーシャルバンキング関係マネージャー
コマーシャルパイロット	コマーシャルパイロット
コミッショニング_エディター	コミッショニング エディター
コミッショニングマネージャー	コミッショニングマネージャー
コミュニケーション_コンサルタント	コミュニケーション コンサルタント
コミュニケーション_コーディネーター	コミュニケーション コーディネーター
コミュニケーション_スペシャリスト	コミュニケーション スペシャリスト
コミュニケーション_リーダー	コミュニケーション リーダー
コミュニケーションデザイナー	コミュニケーションデザイナー
コミュニケーションマネージャー	コミュニケーションマネージャー
コミュニケーション技術者	コミュニケーション技術者
コミュニケーション部門_アシスタントディレクター	コミュニケーション部門 アシスタントディレクター
コミュニティリレーション_アシスタント	コミュニティリレーション アシスタント
コミュニティ販売マネージャー	コミュニティ販売マネージャー
コラムニスト	コラムニスト
コレクション_アソシエイト	コレクション アソシエイト
コレクション_ディレクター	コレクション ディレクター
コレクションのインターン	コレクションのインターン
コンサルタント	コンサルタント
コンサルティンク_゙マネージャー	コンサルティンク ゙マネージャー
コンサルティング_エンジニア	コンサルティング エンジニア
コンシェルジュ	コンシェルジュ
コンセプトアーティスト	コンセプトアーティスト
コンセプトデザイナー	コンセプトデザイナー
コンセプト開発者	コンセプト開発者
コンテンツ_スーパーバイザー	コンテンツ スーパーバイザー
コンテンツ_プロデューサー	コンテンツ プロデューサー
コンテンツの責任者	コンテンツの責任者
コンテンツアナリスト	コンテンツアナリスト
コンテンツマネージャー	コンテンツマネージャー
コンテンツマーケティング_マネジャー	コンテンツマーケティング マネジャー
コンテンツライター	コンテンツライター
コンテンツ戦略家	コンテンツ戦略家
コンテンツ開発者	コンテンツ開発者
コントリビューター	コントリビューター
コンピュータ_サポート_アナリスト	コンピュータ サポート アナリスト
コンピュータサイエンスの家庭教師	コンピュータサイエンスの家庭教師
コンピュータサポート技術者	コンピュータサポート技術者
コンピュータネットワーク_スペシャリスト	コンピュータネットワーク スペシャリスト
コンピューター_アニメーター	コンピューター アニメーター
コンピューター_グラフィック_アーティスト	コンピューター グラフィック アーティスト
コンピューター_ネットワークエンジニア	コンピューター ネットワークエンジニア
コンピューター_ハードウェア技術者	コンピューター ハードウェア技術者
コンピューターサイエンスの学生	コンピューターサイエンスの学生
コンピューターサービス技術者	コンピューターサービス技術者
コンピューターシステム技術者	コンピューターシステム技術者
コンピューターハードウェア_エンジニア	コンピューターハードウェア エンジニア
コンピューター技術者	コンピューター技術者
コンピューターネットワーク技術者	コンピューターネットワーク技術者
コンピューターラボ技術者	コンピューターラボ技術者
コンベンション_コーディネーター	コンベンション コーディネーター
コンポジター	コンポジター
コーポレート_エグゼクティブシェフ	コーポレート エグゼクティブシェフ
コーポレート_コミュニケーション_コーディネーター	コーポレート コミュニケーション コーディネーター
コーポレート_コミュニケーションのアシスタントマネージャー	コーポレート コミュニケーションのアシスタントマネージャー
コーポレート_コミュニケーション担当者	コーポレート コミュニケーション担当者
コーポレートバンキング責任者	コーポレートバンキング責任者
コーポレート_ファイナンス_エグゼクティブ	コーポレート ファイナンス エグゼクティブ
コーポレートバンキング_アナリスト	コーポレートバンキング アナリスト
コーポレートバンキングのディレクター	コーポレートバンキングのディレクター
サイトエンジニア	サイトエンジニア
サウンドミキサー	サウンドミキサー
サウンドエンジニア	サウンドエンジニア
サッカーのコーチ	サッカーのコーチ
サッカーのヘッドコーチ	サッカーのヘッドコーチ
サッカーコーチ	サッカーコーチ
サッカー選手	サッカー選手
サプライチェーン担当者	サプライチェーン担当者
サポーター	サポーター
サポートセンター_アナリスト	サポートセンター アナリスト
サポート技術者	サポート技術者
サマーキャンプ_カウンセラー	サマーキャンプ カウンセラー
サマースクールの先生	サマースクールの先生
サロンオーナー	サロンオーナー
サロンコーディネーター	サロンコーディネーター
サロン店長	サロン店長
サーバー	サーバー
サーバー管理者	サーバー管理者
サービスサポート_スペシャリスト	サービスサポート スペシャリスト
サービスセンター_アナリスト	サービスセンター アナリスト
サービスセンターのマネージャー	サービスセンターのマネージャー
サービスデザイナー	サービスデザイナー
サービスデスク_エージェント	サービスデスク エージェント
サービスデスク　チームリーダー	サービスデスク　チームリーダー
サービスデスク技術者	サービスデスク技術者
サービスデスク管理者	サービスデスク管理者
シェフ	シェフ
シグナル_インテグリティ_エンジニア	シグナル インテグリティ エンジニア
シスコのネットワークエンジニア	シスコのネットワークエンジニア
システムアナリスト	システムアナリスト
システムエンジニア	システムエンジニア
システムエンジニアのインターン	システムエンジニアのインターン
システムサポート_エンジニア	システムサポート エンジニア
システムサポート_スーパーバイザー	システムサポート スーパーバイザー
システムサポート技術者	システムサポート技術者
システムネットワーク管理者	システムネットワーク管理者
システムパフォーマンス_エンジニア	システムパフォーマンス エンジニア
システム管理者	システム管理者
システム設計エンジニア	システム設計エンジニア
シフトリーダー	シフトリーダー
シミュレーション_エンジニア	シミュレーション エンジニア
シューズデザイナー	シューズデザイナー
ショーマネージャー	ショーマネージャー
スイッチエンジニア	スイッチエンジニア
スクリプター	スクリプター
スタイリスト	スタイリスト
スタイルコンサルタント	スタイルコンサルタント
スタジオアーティスト	スタジオアーティスト
スタッフ_アプリケーション_エンジニア	スタッフ アプリケーション エンジニア
スタッフ_テクニカルサポート_エンジニア	スタッフ テクニカルサポート エンジニア
スタッフ_テクニカルプログラム_マネージャー	スタッフ テクニカルプログラム マネージャー
スタッフ_ハードウェアエンジニア	スタッフ ハードウェアエンジニア
スタッフフォトグラファー	スタッフフォトグラファー
スタッフ会計士	スタッフ会計士
スタッフ医師	スタッフ医師
スタッフ地球物理学者	スタッフ地球物理学者
スタッフ地質学者	スタッフ地質学者
スタッフ弁護士	スタッフ弁護士
スタッフ情報システムアナリスト	スタッフ情報システムアナリスト
スタッフ技術者	スタッフ技術者
スタッフ看護師	スタッフ看護師
スタッフ研究エンジニア	スタッフ研究エンジニア
スタッフ研究員	スタッフ研究員
スタッフ税理士	スタッフ税理士
スタッフ設計エンジニア	スタッフ設計エンジニア
スタッフ開発者	スタッフ開発者
スタッフ顧問	スタッフ顧問
スタッフ麻酔科医	スタッフ麻酔科医
スチュワード	スチュワード
ステーション_エンジニア	ステーション エンジニア
ストラクチャード_ファイナンス_アナリスト	ストラクチャード ファイナンス アナリスト
ストラクチャード_ファイナンス_ディレクター	ストラクチャード ファイナンス ディレクター
ストラクチャード_ファイナンスの責任者	ストラクチャード ファイナンスの責任者
ストレスアナリスト	ストレスアナリスト
ストレスエンジニア	ストレスエンジニア
ストレングス&コンディショニングコーチ	ストレングス&コンディショニングコーチ
スパ_スーパーバイザー	スパ スーパーバイザー
スペイン語の家庭教師	スペイン語の家庭教師
スペイン語翻訳者	スペイン語翻訳者
スポーツアナウンサー	スポーツアナウンサー
スポーツインストラクター	スポーツインストラクター
スポーツインターン	スポーツインターン
スポーツコーディネーター	スポーツコーディネーター
スポーツディレクター	スポーツディレクター
スポーツプロデューサー	スポーツプロデューサー
スポーツマネージャー	スポーツマネージャー
スポーツ写真家	スポーツ写真家
スポーツ編集者	スポーツ編集者
スポーツ記者	スポーツ記者
ゼネラルマネージャー	ゼネラルマネージャー
ゼネラルマネージャーの個人秘書	ゼネラルマネージャーの個人秘書
セカンドライン_サポート_アナリスト	セカンドライン サポート アナリスト
セカンド_アシスタントマネージャー	セカンド アシスタントマネージャー
セカンドオフィサー	セカンドオフィサー
セキュリティ_エンジニア	セキュリティ エンジニア
セキュリティのアシスタントディレクター	セキュリティのアシスタントディレクター
セキュリティの専門家	セキュリティの専門家
セキュリティ管理者	セキュリティ管理者
セクションエンジニア	セクションエンジニア
セットデコレーター	セットデコレーター
セットドレッサー	セットドレッサー
セット制作アシスタント	セット制作アシスタント
セラピスト	セラピスト
セールス_トレーダー	セールス トレーダー
セールスチームのメンバー	セールスチームのメンバー
ゼネラルコントラクター	ゼネラルコントラクター
ソフトウェア_アナリスト	ソフトウェア アナリスト
ソフトウェア_アプリケーション開発者	ソフトウェア アプリケーション開発者
ソフトウェア_コンサルタント	ソフトウェア コンサルタント
ソフトウェア_サポート技術者	ソフトウェア サポート技術者
ソフトウェア_スペシャリスト	ソフトウェア スペシャリスト
ソフトウェア_プロジェクトリーダー	ソフトウェア プロジェクトリーダー
ソフトウェアエンジニア	ソフトウェアエンジニア
ソフトウェアエンジニア_チームリーダー	ソフトウェアエンジニア チームリーダー
ソフトウェアサポート_アナリスト	ソフトウェアサポート アナリスト
ソフトウェア会社	ソフトウェア会社
ソフトウェア品質保証エンジニア	ソフトウェア品質保証エンジニア
ソフトウェア工学゙インターン	ソフトウェア工学゙インターン
ソフトウェア工学研修員	ソフトウェア工学研修員
ソフトウェア研修員	ソフトウェア研修員
ソフトウェア開発アナリスト	ソフトウェア開発アナリスト
ソフトウェア開発インターン	ソフトウェア開発インターン
ソフトウェア開発エンジニア	ソフトウェア開発エンジニア
ソリューション開発者	ソリューション開発者
ソングライター	ソングライター
ソーサー	ソーサー
ソーシャルメディア_ストラテジスト	ソーシャルメディア ストラテジスト
ソーシャルメディア_スペシャリスト	ソーシャルメディア スペシャリスト
ソーシャルメディア_ディレクター	ソーシャルメディア ディレクター
ソーシャルメディア_マネージャー	ソーシャルメディア マネージャー
ソーシャルメディア_マーケティング_コンサルタント	ソーシャルメディア マーケティング コンサルタント
ソーシャルメディア_マーケティング_マネージャー	ソーシャルメディア マーケティング マネージャー
ソーシャルワーカー	ソーシャルワーカー
ダイニングサービスのディレクター	ダイニングサービスのディレクター
ダンス講師	ダンス講師
タイトルエージェント	タイトルエージェント
タイトルオフィサー	タイトルオフィサー
タイトル審査官	タイトル審査官
タレントディレクター	タレントディレクター
タレントプロデューサー	タレントプロデューサー
タレントマネジメント_コンサルタント	タレントマネジメント コンサルタント
タレントマネジメント_スペシャリスト	タレントマネジメント スペシャリスト
タレントマネジメント副社長	タレントマネジメント副社長
タレントマネジメント責任者	タレントマネジメント責任者
タレントマネージャー	タレントマネージャー
ターミナルマネージャー	ターミナルマネージャー
ダンス講師	ダンス講師
チアリーディングコーチ	チアリーディングコーチ
チーフ_キュレーター	チーフ キュレーター
チーフ_フライトインストラクター	チーフ フライトインストラクター
チーフスチュワード	チーフスチュワード
チーフソフトウェア_エンジニア	チーフソフトウェア エンジニア
チーフパイロット	チーフパイロット
チーフレジデント	チーフレジデント
チーフ記者	チーフ記者
チームリーダー	チームリーダー
ツアーコーディネーター	ツアーコーディネーター
ツアーディレクター	ツアーディレクター
ツール開発者	ツール開発者
デイキャンフ_゚カウンセラー	デイキャンフ ゚カウンセラー
デザイナー	デザイナー
デザインアシスタント	デザインアシスタント
デザインインストラクター	デザインインストラクター
デザインインターン	デザインインターン
デザインエディター	デザインエディター
デザインコーディネーター	デザインコーディネーター
デザインスタジオ_マネージャー	デザインスタジオ マネージャー
デザインセンター_マネージャー	デザインセンター マネージャー
デザインチームのリーダー	デザインチームのリーダー
デジタルアカウント_エグゼクティブ	デジタルアカウント エグゼクティブ
デジタルアカウント_ディレクター	デジタルアカウント ディレクター
デジタルアカウント_マネージャー	デジタルアカウント マネージャー
デジタルコンテンツ_マネージャー	デジタルコンテンツ マネージャー
デジタルスーパーバイザー	デジタルスーパーバイザー
デジタルデザイナー	デジタルデザイナー
デジタルプランナー	デジタルプランナー
デジタルプロデューサー	デジタルプロデューサー
デジタルマーケティング_マネージャー	デジタルマーケティング マネージャー
デジタルメディア_スーパーバイザー	デジタルメディア スーパーバイザー
デジタルメディア_デザイナー	デジタルメディア デザイナー
デジタルメディア_プランナー	デジタルメディア プランナー
デジタルメディア_プロデューサー	デジタルメディア プロデューサー
デジタルメディア責任者	デジタルメディア責任者
デジタル設計エンジニア	デジタル設計エンジニア
デジタル販売マネージャー	デジタル販売マネージャー
デスクサイド_サポート技術者	デスクサイド サポート技術者
デスクトップ_パブリッシャー	デスクトップ パブリッシャー
デスクトップエンジニア	デスクトップエンジニア
デスクトップサポート	デスクトップサポート
デスクトップサポート_アナリスト	デスクトップサポート アナリスト
デスクトップサポート_エンジニア	デスクトップサポート エンジニア
デスクトップサポート_スペシャリスト	デスクトップサポート スペシャリスト
デスクトップサポート_チームリーダー	デスクトップサポート チームリーダー
デスクトップサポートのインターン	デスクトップサポートのインターン
デスクトップサポート技術者	デスクトップサポート技術者
デスクトップ管理者	デスクトップ管理者
デベロッパー	デベロッパー
デリバティブ_トレーダー	デリバティブ トレーダー
デリバティブ_ブローカー	デリバティブ ブローカー
データ_ネットワーク_コンサルタント	データ ネットワーク コンサルタント
データ_ネットワークエンジニア	データ ネットワークエンジニア
データセキュリティ管理者	データセキュリティ管理者
データセンター_アナリスト	データセンター アナリスト
データセンター_オペレーター	データセンター オペレーター
データセンターのスーパーバイザー	データセンターのスーパーバイザー
データセンター管理者	データセンター管理者
データネットワーク_スペシャリスト	データネットワーク スペシャリスト
データベース開発者	データベース開発者
テキスタイルデザイナー	テキスタイルデザイナー
テクスチャアーティスト	テクスチャアーティスト
テクニカル_アニメーター	テクニカル アニメーター
テクニカル_アーキテクト	テクニカル アーキテクト
テクニカル_アートディレクター	テクニカル アートディレクター
テクニカル_オフィス_エンジニア	テクニカル オフィス エンジニア
テクニカル_カスタマーサポート担当者	テクニカル カスタマーサポート担当者
テクニカル_サポート_アソシエイト	テクニカル サポート アソシエイト
テクニカル_プロデューサー	テクニカル プロデューサー
テクニカル_フィールドエンジニア	テクニカル フィールドエンジニア
テクニカルアーティスト	テクニカルアーティスト
テクニカルオフィス_マネージャー	テクニカルオフィス マネージャー
テクニカルオペレーター	テクニカルオペレーター
テクニカルサポート	テクニカルサポート
テクニカルサポート_アナリスト	テクニカルサポート アナリスト
テクニカルサポート_エキスパート	テクニカルサポート エキスパート
テクニカルサポート_エンジニア	テクニカルサポート エンジニア
テクニカルサポート_コーディネーター	テクニカルサポート コーディネーター
テクニカルサポート_スーパーバイザー	テクニカルサポート スーパーバイザー
テクニカルサポート_チームリーダー	テクニカルサポート チームリーダー
テクニカルサポート担当者	テクニカルサポート担当者
テクニカルセールスサポートエンジニア	テクニカルセールスサポートエンジニア
テクニカルデザイナー	テクニカルデザイナー
テクニカルテスト_リーダー	テクニカルテスト リーダー
テクノロジー	テクノロジー
テクノロジー_アーキテクト	テクノロジー アーキテクト
テクノロジー_リクルーター	テクノロジー リクルーター
テクノロジーサポート_アナリスト	テクノロジーサポート アナリスト
テクノロジーアナリスト	テクノロジーアナリスト
テクノロジーサポート技術者	テクノロジーサポート技術者
テストエンジニア	テストエンジニア
テスト自動化コンサルタント	テスト自動化コンサルタント
テスト自動化スペシャリスト	テスト自動化スペシャリスト
テスト設計エンジニア	テスト設計エンジニア
テニスコーチ	テニスコーチ
テレビのニュースレポーター	テレビのニュースレポーター
テレビジャーナリスト	テレビジャーナリスト
テレビディレクター	テレビディレクター
テレビニュース_プロデューサー	テレビニュース プロデューサー
テレビプロデューサー	テレビプロデューサー
テレビ司会者	テレビ司会者
テープオペレーター	テープオペレーター
デザイン部の責任者	デザイン部の責任者
デジタル_イメージング技術者	デジタル イメージング技術者
デリバティブの専門家	デリバティブの専門家
ドッグトレーナー	ドッグトレーナー
ドナー関係コーディネーター	ドナー関係コーディネーター
ドラマー	ドラマー
ドリラー	ドリラー
トラベルナース	トラベルナース
トラベルマネージャー	トラベルマネージャー
トランスミッション_エンジニア	トランスミッション エンジニア
トランスミッション_コントローラー	トランスミッション コントローラー
トレーダー	トレーダー
トレーディンク_゙ディレクター	トレーディンク ゙ディレクター
トレードマーケティング_スーパーバイザー	トレードマーケティング スーパーバイザー
トレーニングキャプテン	トレーニングキャプテン
トークショーの司会者	トークショーの司会者
ドキュメンタリー映画製作者	ドキュメンタリー映画製作者
ドッグウォーカー	ドッグウォーカー
ドナーリレーション_マネージャー	ドナーリレーション マネージャー
ドナー関係オフィサー	ドナー関係オフィサー
ナイトオーディター	ナイトオーディター
ナース_プラクティショナー	ナース プラクティショナー
ニットウェアデザイナー	ニットウェアデザイナー
ニュースディレクター	ニュースディレクター
ニュースプロデューサー	ニュースプロデューサー
ニュース運営マネージャー	ニュース運営マネージャー
ニューメディア_プロデューサー	ニューメディア プロデューサー
ネイリスト	ネイリスト
ネットワーク_インテグレーター	ネットワーク インテグレーター
ネットワーク_インフラ_マネージャ	ネットワーク インフラ マネージャ
ネットワーク_オペレーション_センター_アナリスト	ネットワーク オペレーション センター アナリスト
ネットワーク_オペレーション_センターのチーム_リーダー	ネットワーク オペレーション センターのチーム リーダー
ネットワーク_オペレーションセンターのオペレーター	ネットワーク オペレーションセンターのオペレーター
ネットワーク_オペレーションセンターのディレクター	ネットワーク オペレーションセンターのディレクター
ネットワーク_コンサルタント	ネットワーク コンサルタント
ネットワーク_サポート技術者	ネットワーク サポート技術者
ネットワーク_デザインマネージャー	ネットワーク デザインマネージャー
ネットワーク_パフォーマンス_エンジニア	ネットワーク パフォーマンス エンジニア
ネットワーク_プロビジョナー	ネットワーク プロビジョナー
ネットワークアナリスト	ネットワークアナリスト
ネットワークアーキテクト	ネットワークアーキテクト
ネットワークインフラ_エンジニア	ネットワークインフラ エンジニア
ネットワークエンジニア	ネットワークエンジニア
ネットワークエンジニアリング_マネージャー	ネットワークエンジニアリング マネージャー
ネットワークエンジニアリング_コンサルタント	ネットワークエンジニアリング コンサルタント
ネットワークオフィサー	ネットワークオフィサー
ネットワークコントロール技術者	ネットワークコントロール技術者
ネットワークサポート_アナリスト	ネットワークサポート アナリスト
ネットワークサポート_エンジニア	ネットワークサポート エンジニア
ネットワークシステム_エンジニア	ネットワークシステム エンジニア
ネットワークスペシャリスト	ネットワークスペシャリスト
ネットワークセキュリティ_アナリスト	ネットワークセキュリティ アナリスト
ネットワークセキュリティ_エンジニア	ネットワークセキュリティ エンジニア
ネットワークセキュリティ_コンサルタント	ネットワークセキュリティ コンサルタント
ネットワークセキュリティ_スペシャリスト	ネットワークセキュリティ スペシャリスト
ネットワークセキュリティ管理者	ネットワークセキュリティ管理者
ネットワークデザイナー	ネットワークデザイナー
ネットワーク実施マネージャー	ネットワーク実施マネージャー
ネットワーク技術者	ネットワーク技術者
ネットワーク管理者	ネットワーク管理者
ネットワーク統合エンジニア	ネットワーク統合エンジニア
ネットワーク計画エンジニア	ネットワーク計画エンジニア
ネットワーク設計エンジニア	ネットワーク設計エンジニア
ネットワーク設計コンサルタント	ネットワーク設計コンサルタント
ネットワーク運用アナリスト	ネットワーク運用アナリスト
ネットワーク運用エンジニア	ネットワーク運用エンジニア
ネットワーク運用ディレクター	ネットワーク運用ディレクター
ネットワーク運用マネージャー	ネットワーク運用マネージャー
ネットワーク運用責任者	ネットワーク運用責任者
バイヤー_エージェント	バイヤー エージェント
バイリンガルの教師	バイリンガルの教師
バイリンガルの重役秘書	バイリンガルの重役秘書
バスボーイ	バスボーイ
バックエンド開発者	バックエンド開発者
バンドディレクター	バンドディレクター
バンドマネージャー	バンドマネージャー
バンドメンバー	バンドメンバー
バーのマネージャー	バーのマネージャー
バーアテンダント	バーアテンダント
パソコン修理技術者	パソコン修理技術者
パソコン専門家	パソコン専門家
パソコン技術者	パソコン技術者
パソコン販売員	パソコン販売員
パターンメーカー	パターンメーカー
パッケージエンジニア	パッケージエンジニア
パティシエ	パティシエ
パテシエ	パテシエ
パフォーマンスコーチ	パフォーマンスコーチ
パフォーマンス向上コーディネーター	パフォーマンス向上コーディネーター
パワートレイン_エンジニア	パワートレイン エンジニア
パン屋	パン屋
パーソナルシェフ	パーソナルシェフ
パーソナルトレーニンクの゙ディレクター	パーソナルトレーニンクの゙ディレクター
パーソナルバンキング_アドバイザー	パーソナルバンキング アドバイザー
パーソナルバンキング_マネージャー	パーソナルバンキング マネージャー
パーソナルバンキング代表者	パーソナルバンキング代表者
パーソナルライン_アンダーライター	パーソナルライン アンダーライター
パーソナルライン_マネージャー	パーソナルライン マネージャー
パーティーのシェフ	パーティーのシェフ
ハウスキーピング_スーパーバイザー	ハウスキーピング スーパーバイザー
ハウスキーピング_マネージャー	ハウスキーピング マネージャー
ハウスキーピングのアシスタントディレクター	ハウスキーピングのアシスタントディレクター
ハウススーパーバイザー	ハウススーパーバイザー
ハードウェア_システム_エンジニア	ハードウェア システム エンジニア
ハードウェア_チームリーダー	ハードウェア チームリーダー
ハードウェア_デザイナー	ハードウェア デザイナー
ハードウェアエンジニア	ハードウェアエンジニア
ハードウェアサポート_エンジニア	ハードウェアサポート エンジニア
ハードウェアスペシャリスト	ハードウェアスペシャリスト
ハードウェア技術者	ハードウェア技術者
ハードウェア設計エンジニア	ハードウェア設計エンジニア
ハードウェア開発エンジニア	ハードウェア開発エンジニア
ハードウェア開発ディレクター	ハードウェア開発ディレクター
ハードウェア開発者	ハードウェア開発者
ハーバリスト	ハーバリスト
バレエ講師	バレエ講師
バンケット_スーパーバイザー	バンケット スーパーバイザー
バンケットキャプテン	バンケットキャプテン
バンケットコーディネーター	バンケットコーディネーター
バンケットサーバー	バンケットサーバー
バンケットシェフ	バンケットシェフ
バーのスーパーバイザー	バーのスーパーバイザー
バーテンダー_スペシャリスト	バーテンダー スペシャリスト
パブリックアドレス_アナウンサー	パブリックアドレス アナウンサー
パン屋店員	パン屋店員
パーソナルトレーナー	パーソナルトレーナー
パーソナルトレーニング_マネージャー	パーソナルトレーニング マネージャー
パートナー	パートナー
パートナーシップ_コーディネーター	パートナーシップ コーディネーター
ビジネスアナリスト	ビジネスアナリスト
ビジネスエキスパート	ビジネスエキスパート
ビジネスコンサルタント	ビジネスコンサルタント
ビジネスセンター_マネージャー	ビジネスセンター マネージャー
ビジネスバンキンク専門家	ビジネスバンキンク専門家
ビジネスライター	ビジネスライター
ビジネス教育の教師	ビジネス教育の教師
ビジネス開発者	ビジネス開発者
ビジュアライザー	ビジュアライザー
ビジュアルアーティスト	ビジュアルアーティスト
ビジュアルデザイナー	ビジュアルデザイナー
ビジュアルマーチャンダイジンクの゙インターン	ビジュアルマーチャンダイジンクの゙インターン
ビジュアル開発アーティスト	ビジュアル開発アーティスト
ビデオエンジニア	ビデオエンジニア
ビデオジャーナリスト	ビデオジャーナリスト
ビデオ制作担当	ビデオ制作担当
ピエロ	ピエロ
ピッカー	ピッカー
ピッチングコーチ	ピッチングコーチ
ヒアリング_オフィサー	ヒアリング オフィサー
ビジネス経営コンサルタント	ビジネス経営コンサルタント
ビューティーアドバイザー	ビューティーアドバイザー
ピアノ調律師	ピアノ調律師
ブランド_デザインマネージャー	ブランド デザインマネージャー
ブランドアナリスト	ブランドアナリスト
ブランドデザイナー	ブランドデザイナー
ブランドプランナー	ブランドプランナー
ブリーダー	ブリーダー
ブロガー	ブロガー
ブローカーの営業担当	ブローカーの営業担当
ブローカーアシスタント	ブローカーアシスタント
プライベート_エクイティ_アナリスト	プライベート エクイティ アナリスト
プライベート_エクイティ_インターン	プライベート エクイティ インターン
プライベート_クライアント_マネージャー	プライベート クライアント マネージャー
プライベートイベント_ディレクター	プライベートイベント ディレクター
プライベートクライアント_サービス	プライベートクライアント サービス
プライベートシェフ	プライベートシェフ
プライベートバンキング_アナリスト	プライベートバンキング アナリスト
プライベートバンキング_オフィサー	プライベートバンキング オフィサー
プライベートバンキング_マネージャー	プライベートバンキング マネージャー
プライベートバンキング_リレーションシップ_マネージャー	プライベートバンキング リレーションシップ マネージャー
プライベートバンキング責任者	プライベートバンキング責任者
プライベートバンク_アナリスト	プライベートバンク アナリスト
プライベート住宅ローン銀行家	プライベート住宅ローン銀行家
プランナー	プランナー
プリンシパルバンカー	プリンシパルバンカー
プリントデザイナー	プリントデザイナー
プリント基板設計者	プリント基板設計者
プレコンストラクション_マネージャー	プレコンストラクション マネージャー
プレスと広報マネージャー	プレスと広報マネージャー
プレゼンター	プレゼンター
プロのエンジニア	プロのエンジニア
プロのダンサー	プロのダンサー
プロのミュージシャン	プロのミュージシャン
プロのメイクアップアーティスト	プロのメイクアップアーティスト
プロの不動産業者	プロの不動産業者
プロの会計士	プロの会計士
プロの俳優	プロの俳優
プロの歌手	プロの歌手
プロの芸術家	プロの芸術家
プロの運転手	プロの運転手
プロサッカー選手	プロサッカー選手
プロジェクト_アーキビスト	プロジェクト アーキビスト
プロジェクト_エンジニア	プロジェクト エンジニア
プロジェクトアシスタント	プロジェクトアシスタント
プロジェクトエディター	プロジェクトエディター
プロジェクトオフィサー	プロジェクトオフィサー
プロジェクトコーディネーション_マネージャー	プロジェクトコーディネーション マネージャー
プロジェクトデザイナー	プロジェクトデザイナー
プロジェクトファイナンス責任者	プロジェクトファイナンス責任者
プロジェクト地質学者	プロジェクト地質学者
プロジェクト水文地質学者	プロジェクト水文地質学者
プロジェクト監督	プロジェクト監督
プロジェクト見積もり	プロジェクト見積もり
プロジェクト責任者	プロジェクト責任者
プロスポーツ選手	プロスポーツ選手
プロセス_コンサルタント	プロセス コンサルタント
プロセス_スペシャリスト	プロセス スペシャリスト
プロセスエンジニア	プロセスエンジニア
プロセスマネージャー	プロセスマネージャー
プロセス制御エンジニア	プロセス制御エンジニア
プロセス技術者	プロセス技術者
プロセス機械エンジニア	プロセス機械エンジニア
プロセス設計エンジニア	プロセス設計エンジニア
プロダクトエンジニア	プロダクトエンジニア
プロダクトデザイナー	プロダクトデザイナー
プロダクトデザイン_コンサルタント	プロダクトデザイン コンサルタント
プロデューサー	プロデューサー
プロモーション_プロデューサー	プロモーション プロデューサー
プロ写真家	プロ写真家
プールマネージャー	プールマネージャー
ファイアウォール_エンジニア	ファイアウォール エンジニア
ファインアーティスト	ファインアーティスト
ファッションアシスタント	ファッションアシスタント
ファッションコンサルタント	ファッションコンサルタント
ファッションコーディネーター	ファッションコーディネーター
ファッションスタイリスト	ファッションスタイリスト
ファッションデザイナー	ファッションデザイナー
ファッションデザイン_インターン	ファッションデザイン インターン
ファッションデザイナー	ファッションデザイナー
ファッション写真家	ファッション写真家
ファンディング_アナリスト	ファンディング アナリスト
ファンドアナリスト	ファンドアナリスト
ファンドマネージャー	ファンドマネージャー
ファンド開発部長	ファンド開発部長
ファースト_アシスタントエディター	ファースト アシスタントエディター
ファースト_アシスタントディレクター	ファースト アシスタントディレクター
ファースト_カメラアシスタント	ファースト カメラアシスタント
ファーストエンジニア	ファーストエンジニア
ファームウェア設計エンジニア	ファームウェア設計エンジニア
フィジカルデザイナー	フィジカルデザイナー
フィットネス_コンサルタント	フィットネス コンサルタント
フィットネス_コーディネーター	フィットネス コーディネーター
フィットネス_ディレクター	フィットネス ディレクター
フィットネスコーチ	フィットネスコーチ
フィットネストレーナー	フィットネストレーナー
フィットネスマネージャー	フィットネスマネージャー
フィットネス専門家	フィットネス専門家
フィールドエンジニア	フィールドエンジニア
フィールドオペレーション_エンジニア	フィールドオペレーション エンジニア
フィールドオペレーション技術者	フィールドオペレーション技術者
フィールドサポート_アナリスト	フィールドサポート アナリスト
フィールドサポート技術者	フィールドサポート技術者
フィールドサービス_コーディネーター	フィールドサービス コーディネーター
フィールド地質学者	フィールド地質学者
フィールド_アンダーライター	フィールド アンダーライター
フィールドエンジニアリング_マネージャー	フィールドエンジニアリング マネージャー
フォトグラファー_アシスタント	フォトグラファー アシスタント
フォトスタイリスト	フォトスタイリスト
フラッシュアニメーター	フラッシュアニメーター
フラワーデザイナー	フラワーデザイナー
フラワーマネージャー	フラワーマネージャー
フリーランス	フリーランス
フルスタック_エンジニア	フルスタック エンジニア
フレーバリスト	フレーバリスト
フロアスタッフ	フロアスタッフ
フロアディレクター	フロアディレクター
フロアブローカー	フロアブローカー
フロアリーダー	フロアリーダー
フロントエンド_スーパーバイザー	フロントエンド スーパーバイザー
フロントオブハウス_マネージャー	フロントオブハウス マネージャー
フロントオフィス_アソシエイト	フロントオフィス アソシエイト
フロントオフィス_インターン	フロントオフィス インターン
フロントオフィス_エージェント	フロントオフィス エージェント
フロントオフィス_スーパーバイザー	フロントオフィス スーパーバイザー
フロントオフィス_マネージャー	フロントオフィス マネージャー
フロントオフィスのチームリーダー	フロントオフィスのチームリーダー
フロントオフィス役員	フロントオフィス役員
フロントカウンター_アソシエイト	フロントカウンター アソシエイト
フロントデスク_マネージャー	フロントデスク マネージャー
フロント担当者	フロント担当者
フードエンジニア	フードエンジニア
フードサーバー	フードサーバー
フードサービスマネージャー	フードサービスマネージャー
ブローカー	ブローカー
ブートキャンプ講師	ブートキャンプ講師
プライベート_エクイティ_アソシエイト	プライベート エクイティ アソシエイト
プライベートバンキング_アシスタント	プライベートバンキング アシスタント
プラント冶金学者	プラント冶金学者
プリスクールの教諭	プリスクールの教諭
プレコンストラクション_ディレクター	プレコンストラクション ディレクター
プレスクールの園長	プレスクールの園長
プレスクールの教師	プレスクールの教師
プレスクールの教諭助手	プレスクールの教諭助手
プログラミング_アナリスト	プログラミング アナリスト
プロセス_オートメーション_エンジニア	プロセス オートメーション エンジニア
プロセス工学の専門家	プロセス工学の専門家
プロダクトマネージャー	プロダクトマネージャー
ベビーシッター	ベビーシッター
ベンチャーキャピタル_アナリスト	ベンチャーキャピタル アナリスト
ベーカリー_マネージャー	ベーカリー マネージャー
ベーシスト	ベーシスト
ペイントアーティスト	ペイントアーティスト
ペットシッター	ペットシッター
ヘアスタイリスト	ヘアスタイリスト
ヘアデザイナー	ヘアデザイナー
ヘアメイクアーティスト	ヘアメイクアーティスト
ヘッジファント_アナリスト	ヘッジファント アナリスト
ヘッドコーチ	ヘッドコーチ
ヘッドサーバー	ヘッドサーバー
ヘッドデザイナー	ヘッドデザイナー
ヘッドトレーダー	ヘッドトレーダー
ヘッドバーテンダー	ヘッドバーテンダー
ヘルスケア_リクルーター	ヘルスケア リクルーター
ヘルスビジター	ヘルスビジター
ヘルプデスク_アナリスト	ヘルプデスク アナリスト
ヘルプデスク_エンジニア	ヘルプデスク エンジニア
ヘルプデスク_コーディネーター	ヘルプデスク コーディネーター
ヘルプデスク_サポート技術者	ヘルプデスク サポート技術者
ヘルプデスク_スーパーバイザー	ヘルプデスク スーパーバイザー
ヘルプデスクサポート_アナリスト	ヘルプデスクサポート アナリスト
ヘルプデスク技術者	ヘルプデスク技術者
ヘルプデスク管理者	ヘルプデスク管理者
ベンチ技術者	ベンチ技術者
ボイスエンジニア	ボイスエンジニア
ボーカリスト	ボーカリスト
ボーカルコーチ	ボーカルコーチ
ボードオペレーター	ボードオペレーター
ポストプロダクション_アシスタント	ポストプロダクション アシスタント
ポストプロダクション_エディター	ポストプロダクション エディター
ポストプロダクション_コーディネーター	ポストプロダクション コーディネーター
ポストプロダクション_スーパーバイザー	ポストプロダクション スーパーバイザー
ポストプロダクション_マネージャー	ポストプロダクション マネージャー
ポストプロダクションのディレクター	ポストプロダクションのディレクター
ポストプロダクションの責任者	ポストプロダクションの責任者
ポストプロダクションインターン	ポストプロダクションインターン
ポストプロデューサー	ポストプロデューサー
ポートエンジニア	ポートエンジニア
ポートフォリオ_アソシエイト	ポートフォリオ アソシエイト
ポートフォリオ_ディレクター	ポートフォリオ ディレクター
ポートフォリオ_マネージャー	ポートフォリオ マネージャー
ポートフォリオ管理アナリスト	ポートフォリオ管理アナリスト
ホスト	ホスト
ホスピタリティマネージャー	ホスピタリティマネージャー
ホームシアターの専門家	ホームシアターの専門家
ホームステージャー	ホームステージャー
ポストクローザー	ポストクローザー
マイクロソフト_システム_エンジニア	マイクロソフト システム エンジニア
マイクロソフトのシステム管理者	マイクロソフトのシステム管理者
マイコン専門家	マイコン専門家
マスター_スタイリスト	マスター スタイリスト
マスターコントロール_オペレーター	マスターコントロール オペレーター
マスター大工	マスター大工
マスター税務アドバイザー	マスター税務アドバイザー
マスター船乗り	マスター船乗り
マスター配管工	マスター配管工
マテリアルハンドラー	マテリアルハンドラー
マネージャーの人材獲得	マネージャーの人材獲得
マネージングパートナー	マネージングパートナー
マネージングブローカー	マネージングブローカー
マルチメディア_インターン	マルチメディア インターン
マルチメディア_ジャーナリスト	マルチメディア ジャーナリスト
マルチメディア_デザイナー	マルチメディア デザイナー
マルチメディア_プログラマー	マルチメディア プログラマー
マルチメディア_プロデューサー	マルチメディア プロデューサー
マーケットインテリジェンス_ディレクター	マーケットインテリジェンス ディレクター
マーケットインテリジェンス_アナリスト	マーケットインテリジェンス アナリスト
マーケットデータアナリスト	マーケットデータアナリスト
マーケットリスク_マネージャー	マーケットリスク マネージャー
マーケットレポーター	マーケットレポーター
マーケティング_コピーライター	マーケティング コピーライター
マーケティング_コミュニケーション_スペシャリスト	マーケティング コミュニケーション スペシャリスト
マーケティングおよびコミュニケーション_アソシエイト	マーケティングおよびコミュニケーション アソシエイト
マーケティングおよびコミュニケーションコーディネーター	マーケティングおよびコミュニケーションコーディネーター
マーケティングおよびコミュニケーション役員	マーケティングおよびコミュニケーション役員
マーケティングおよびコミュニケーション最高責任者	マーケティングおよびコミュニケーション最高責任者
マーケティングと広報コンサルタント	マーケティングと広報コンサルタント
マーケティングと広報担当者	マーケティングと広報担当者
マーケティングコンサルタント	マーケティングコンサルタント
マーケティングサービス_コーディネーター	マーケティングサービス コーディネーター
マーケティング担当者	マーケティング担当者
マーケティンク戦略家	マーケティンク戦略家
マーケティング_アナリスト	マーケティング アナリスト
マーケティングと広報のスペシャリスト	マーケティングと広報のスペシャリスト
ミクソロジスト	ミクソロジスト
ミドルオフィスの責任者	ミドルオフィスの責任者
ミドルマーケット_アカウントマネージャー	ミドルマーケット アカウントマネージャー
ミドルオフィス担当	ミドルオフィス担当
ミュージカルディレクター	ミュージカルディレクター
ミュージシャン	ミュージシャン
メインダンサー	メインダンサー
メカニカル_ドラフター	メカニカル ドラフター
メジャーギフト_マネージャー	メジャーギフト マネージャー
メジャー引退	メジャー引退
メディア_エグゼクティブ	メディア エグゼクティブ
メディア_リレーションズ_アソシエイト	メディア リレーションズ アソシエイト
メディアおよびコミュニケーション_マネージャー	メディアおよびコミュニケーション マネージャー
メディアサービス_ディレクター	メディアサービス ディレクター
メディアスーパーバイザー	メディアスーパーバイザー
メディアディレクター	メディアディレクター
メディアプランナー	メディアプランナー
メディアマネージャー	メディアマネージャー
メディアリレーションズ_オフィサー	メディアリレーションズ オフィサー
メディア制作スペシャリスト	メディア制作スペシャリスト
メディア技術者	メディア技術者
メディア研究者	メディア研究者
メディア関係者	メディア関係者
メディエーター	メディエーター
メディア_ライブラリアン	メディア ライブラリアン
メディアグループ責任者	メディアグループ責任者
メディアプランニング_スーパーバイザー	メディアプランニング スーパーバイザー
メディアリレーションズ_ディレクター	メディアリレーションズ ディレクター
メディア戦略家	メディア戦略家
メディカルサイエンス_リエゾン	メディカルサイエンス リエゾン
メトロ編集者	メトロ編集者
メンタルヘルス_カウンセラー	メンタルヘルス カウンセラー
メンタルヘルス_コンサルタント	メンタルヘルス コンサルタント
メンバーシップサービス_ディレクター	メンバーシップサービス ディレクター
メールルームの事務員	メールルームの事務員
モジュールリーダー	モジュールリーダー
モデラー	モデラー
モバイルアプリ開発者	モバイルアプリ開発者
モバイルエンジニア	モバイルエンジニア
モーゲージバンカー	モーゲージバンカー
モーゲージ_ブローカー	モーゲージ ブローカー
モーニングショーのホスト	モーニングショーのホスト
モーニングショーの共同司会者	モーニングショーの共同司会者
ユニバーサル_バンカー	ユニバーサル バンカー
ユーザーサポート_スペシャリスト	ユーザーサポート スペシャリスト
ユーザーサポート技術者	ユーザーサポート技術者
ライター	ライター
ライフガード	ライフガード
ライフスタイル編集者	ライフスタイル編集者
ラインクック	ラインクック
ラインシェフ	ラインシェフ
ラインパイロット	ラインパイロット
ラインプロデューサー	ラインプロデューサー
ラジオトークショーの司会者	ラジオトークショーの司会者
ラジオプロデューサー	ラジオプロデューサー
ラジオブロードキャスター	ラジオブロードキャスター
ラジオ企画エンジニア	ラジオ企画エンジニア
ランドスケープ_アーキテクト	ランドスケープ アーキテクト
ランドスケープデザイナー	ランドスケープデザイナー
ランドスケープ_アーキテクチャーのインターン	ランドスケープ アーキテクチャーのインターン
リスク管理インターン	リスク管理インターン
リスク管理担当者	リスク管理担当者
リスク管理者	リスク管理者
リソース_スペシャリスト	リソース スペシャリスト
リソースマネージャー	リソースマネージャー
リテール_マーケットマネージャー	リテール マーケットマネージャー
リモートサポート_エンジニア	リモートサポート エンジニア
リレーションシップ_エグゼクティブ	リレーションシップ エグゼクティブ
リレーションシップ_オフィサー	リレーションシップ オフィサー
リレーションシップ_バンカー	リレーションシップ バンカー
リレーションシップ_マネージャー	リレーションシップ マネージャー
リーガル_コーディネーター	リーガル コーディネーター
リーダーシップ開発コンサルタント	リーダーシップ開発コンサルタント
ルート開発マネージャー	ルート開発マネージャー
レイアウトアーティスト	レイアウトアーティスト
レイアウトデザイナー	レイアウトデザイナー
レイアウト技術者	レイアウト技術者
レイアウト設計エンジニア	レイアウト設計エンジニア
レコーディングアーティスト	レコーディングアーティスト
レコーディングエンジニア	レコーディングエンジニア
レジの顧客サービス	レジの顧客サービス
レジスタッフ	レジスタッフ
レジストラー	レジストラー
レジデント	レジデント
レジデントのアーティスト	レジデントのアーティスト
レジデントアーティスト	レジデントアーティスト
レジャー販売ディレクター	レジャー販売ディレクター
レジ責任者	レジ責任者
レストラン_スーパーバイザー	レストラン スーパーバイザー
レストランとバーのマネージャー	レストランとバーのマネージャー
レストランのサーバー	レストランのサーバー
レストランのシェフ	レストランのシェフ
レストランの総支配人	レストランの総支配人
レストランマネージャー	レストランマネージャー
レタッチャー	レタッチャー
レバレッジ_ファイナンス_アナリスト	レバレッジ ファイナンス アナリスト
レンタルエージェント	レンタルエージェント
ロケーション_ハンティング	ロケーション ハンティング
ロケーションマネージャー	ロケーションマネージャー
ロジスティクス_エグゼクティブ	ロジスティクス エグゼクティブ
ロシア語学者	ロシア語学者
ローイングコーチ	ローイングコーチ
ローカリゼーション_スペシャリスト	ローカリゼーション スペシャリスト
ローカリゼーション_プログラム_マネージャー	ローカリゼーション プログラム マネージャー
ローダー	ローダー
ロールアウト_エンジニア	ロールアウト エンジニア
ローンクローザー	ローンクローザー
ローンコーディネーター	ローンコーディネーター
ローンスペシャリスト	ローンスペシャリスト
ローンプロセッサー	ローンプロセッサー
ローン担当者	ローン担当者
ワイヤレス製品マネージャー	ワイヤレス製品マネージャー
ワードローブスタイリスト	ワードローブスタイリスト
一般フィールドエンジニア	一般フィールドエンジニア
一般医師	一般医師
一般歯科医	一般歯科医
一般開業医	一般開業医
上級システムエンジニア	上級システムエンジニア
上級執行役員	上級執行役員
不動産の責任者	不動産の責任者
不動産アソシエイト	不動産アソシエイト
不動産アナリスト	不動産アナリスト
不動産エージェント	不動産エージェント
不動産コンサルタント	不動産コンサルタント
不動産チームリーダー	不動産チームリーダー
不動産ブローカー	不動産ブローカー
不動産ポートフォリオ_マネージャー	不動産ポートフォリオ マネージャー
不動産会計士	不動産会計士
不動産専門家	不動産専門家
不動産弁護士	不動産弁護士
不動産管理者	不動産管理者
不動産融資担当者	不動産融資担当者
不動産販売員	不動産販売員
不動産販売業者	不動産販売業者
不動産鑑定士	不動産鑑定士
中学の英語教師	中学の英語教師
中学校の教員	中学校の教員
中学校の教師	中学校の教師
中学校の数学教師	中学校の数学教師
中学校の科学教師	中学校の科学教師
中尉	中尉
中級会計士	中級会計士
中級建築家	中級建築家
主な射撃教官	主な射撃教官
主任	主任
主任_ハードウェアエンジニア	主任 ハードウェアエンジニア
主任アートディレクター	主任アートディレクター
主任グラフィックデザイナー	主任グラフィックデザイナー
主任クリエイティブ_ディレクター	主任クリエイティブ ディレクター
主任セキュリティエンジニア	主任セキュリティエンジニア
主任ポートフォリオ_マネージャー	主任ポートフォリオ マネージャー
主任ランドスケープ_アーキテクト	主任ランドスケープ アーキテクト
主任会計士	主任会計士
主任土木技術者	主任土木技術者
主任地質学者	主任地質学者
主任弁護士	主任弁護士
主任心理学者	主任心理学者
主任捜査官	主任捜査官
主任採用担当者	主任採用担当者
主任機械エンジニア	主任機械エンジニア
主任機械技師	主任機械技師
主任歯科医師	主任歯科医師
主任水文地質学者	主任水文地質学者
主任特派員	主任特派員
主任研究員	主任研究員
主任設計エンジニア	主任設計エンジニア
主任講師	主任講師
主任電気技師	主任電気技師
主任顧問補佐	主任顧問補佐
主治医	主治医
主要アカウントマネージャー	主要アカウントマネージャー
主要政策担当者	主要政策担当者
予備警察官	予備警察官
予約エージェント	予約エージェント
予約コーディネーター	予約コーディネーター
予約販売エージェント	予約販売エージェント
事件担当者	事件担当者
事務弁護士	事務弁護士
事務所運営パートナー	事務所運営パートナー
事業運営ディレクター	事業運営ディレクター
事業運営副社長	事業運営副社長
事業開発のエグゼクティブバイスプレジデント	事業開発のエグゼクティブバイスプレジデント
事業開発の副社長	事業開発の副社長
事業開発の副社長補佐	事業開発の副社長補佐
事業開発の副部長	事業開発の副部長
事業開発アソシエイト	事業開発アソシエイト
事業開発コンサルタント	事業開発コンサルタント
事業開発スペシャリスト	事業開発スペシャリスト
事業開発ディレクター	事業開発ディレクター
事業開発マネージャー	事業開発マネージャー
事業開発リーダー	事業開発リーダー
事業開発責任者	事業開発責任者
二等航海士	二等航海士
井戸エンジニア	井戸エンジニア
交換管理者	交換管理者
交通管理者	交通管理者
交通記者	交通記者
人事アナリスト	人事アナリスト
人事コンサルタント	人事コンサルタント
人事コーディネーター	人事コーディネーター
人事ビジネスパートナー	人事ビジネスパートナー
人事マネージャー	人事マネージャー
人事情報システムアナリスト	人事情報システムアナリスト
人事担当者	人事担当者
人事採用アシスタント	人事採用アシスタント
人事採用コーディネーター	人事採用コーディネーター
人事採用スペシャリスト	人事採用スペシャリスト
人事採用担当者	人事採用担当者
人事総務	人事総務
人事責任者	人事責任者
人事部長	人事部長
人材ディレクター	人材ディレクター
人材派遣のスペシャリスト	人材派遣のスペシャリスト
人材派遣コンサルタント	人材派遣コンサルタント
人材派遣マネージャー	人材派遣マネージャー
人材派遣リーダー	人材派遣リーダー
人材派遣管理者	人材派遣管理者
人材派遣部長	人材派遣部長
人材獲得インターン	人材獲得インターン
人材獲得コンサルタント	人材獲得コンサルタント
人材獲得スペシャリスト	人材獲得スペシャリスト
人材獲得ディレクター	人材獲得ディレクター
人材獲得マネージャー	人材獲得マネージャー
人材獲得リクルーター	人材獲得リクルーター
人材獲得リーダー	人材獲得リーダー
人材獲得副社長	人材獲得副社長
人材獲得役員	人材獲得役員
人材育成ディレクター	人材育成ディレクター
人類学の教授	人類学の教授
仕出し屋	仕出し屋
代理店の責任者	代理店の責任者
代理店オーナー	代理店オーナー
代理店マネージャー	代理店マネージャー
代理店代表	代理店代表
代理店分野の専門家	代理店分野の専門家
代理店採用担当者	代理店採用担当者
代理店現場幹部	代理店現場幹部
代理教師	代理教師
仲裁人	仲裁人
企業および財団関係のディレクター	企業および財団関係のディレクター
企業のシェフ	企業のシェフ
企業の客室乗務員	企業の客室乗務員
企業アプリケーション_エンジニア	企業アプリケーション エンジニア
企業イベントプランナー	企業イベントプランナー
企業ウェブマスター	企業ウェブマスター
企業クレジットアナリスト	企業クレジットアナリスト
企業ネットワークエンジニア	企業ネットワークエンジニア
企業パイロット	企業パイロット
企業パラリーガル	企業パラリーガル
企業パートナーシップのディレクター	企業パートナーシップのディレクター
企業図書館員	企業図書館員
企業弁護士	企業弁護士
企業法務アシスタント	企業法務アシスタント
企業法務顧問	企業法務顧問
企業物流マネージャー	企業物流マネージャー
企業調査員	企業調査員
企業財務アナリスト	企業財務アナリスト
企業財務インターン	企業財務インターン
企業財務責任者	企業財務責任者
企業開発アソシエイト	企業開発アソシエイト
企業開発アナリスト	企業開発アナリスト
企業顧問	企業顧問
企業顧問アシスタント	企業顧問アシスタント
伍長	伍長
休暇プランナー	休暇プランナー
会員コンサルタント	会員コンサルタント
会員サービス員	会員サービス員
会場管理者	会場管理者
会社の運転手	会社の運転手
会計スタッフ	会計スタッフ
会計士	会計士
会計担当者	会計担当者
会計講師	会計講師
会議およびイベントコーディネーター	会議およびイベントコーディネーター
会議アシスタント	会議アシスタント
会議サービス_マネージャー	会議サービス マネージャー
会議センターマネージャー	会議センターマネージャー
会議プランナー	会議プランナー
会議マネージャー	会議マネージャー
伴奏者	伴奏者
住宅ローン_コーディネーター	住宅ローン コーディネーター
住宅ローンのオリジネーター	住宅ローンのオリジネーター
住宅ローンエージェント	住宅ローンエージェント
住宅ローンコンサルタント	住宅ローンコンサルタント
住宅ローンスペシャリスト	住宅ローンスペシャリスト
住宅ローン営業マネージャー	住宅ローン営業マネージャー
住宅ローン引受人	住宅ローン引受人
住宅ローン担当副社長	住宅ローン担当副社長
住宅ローン担当者	住宅ローン担当者
住宅ローン融資担当副社長	住宅ローン融資担当副社長
住宅ローン金融業者	住宅ローン金融業者
住宅不動産業者	住宅不動産業者
住宅不動産管理者	住宅不動産管理者
体育教師	体育教師
供給教師	供給教師
価格設定コーディネーター	価格設定コーディネーター
価格設定スーパーバイザー	価格設定スーパーバイザー
保健師	保健師
保安官	保安官
保管庫管理者	保管庫管理者
保育アシスタント	保育アシスタント
保育助手	保育助手
保育労働者	保育労働者
保育士	保育士
保険のスペシャリスト	保険のスペシャリスト
保険アンダーライター	保険アンダーライター
保険エージェント	保険エージェント
保険コンサルタント	保険コンサルタント
保険プロデューサー	保険プロデューサー
保険口座の担当者	保険口座の担当者
保険営業員	保険営業員
保険担当役員	保険担当役員
保険責任者	保険責任者
信用管理責任者	信用管理責任者
修理工	修理工
修理技術者	修理技術者
倉庫および流通マネージャー	倉庫および流通マネージャー
倉庫および物流マネージャー	倉庫および物流マネージャー
倉庫オペレーション_マネージャー	倉庫オペレーション マネージャー
倉庫オペレーター	倉庫オペレーター
倉庫スタッフ	倉庫スタッフ
倉庫スペシャリスト	倉庫スペシャリスト
倉庫チームリーダー	倉庫チームリーダー
倉庫作業員	倉庫作業員
倉庫管理者	倉庫管理者
個人寄付マネージャー	個人寄付マネージャー
個人開業	個人開業
個人開業の心理療法士	個人開業の心理療法士
健康とフィットネスの専門家	健康とフィットネスの専門家
債券アナリスト	債券アナリスト
債券スペシャリスト	債券スペシャリスト
債券ディレクター	債券ディレクター
債券トレーダー	債券トレーダー
債券ポートフォリオ_マネージャー	債券ポートフォリオ マネージャー
優先バンカー	優先バンカー
優先フィールドエンジニア	優先フィールドエンジニア
優秀なソフトウェアエンジニア	優秀なソフトウェアエンジニア
優秀な技術スタッフ	優秀な技術スタッフ
先物トレーダー	先物トレーダー
先物ブローカー	先物ブローカー
先進的なサービスのマネージャー	先進的なサービスのマネージャー
児童保育士	児童保育士
入学インターン	入学インターン
入学ディレクター	入学ディレクター
入学学部長	入学学部長
入学部副部長	入学部副部長
全国人事マネージャー	全国人事マネージャー
全国採用担当者	全国採用担当者
全国物流マネージャー	全国物流マネージャー
公共の図書館員	公共の図書館員
公共政策マネージャー	公共政策マネージャー
公務員	公務員
公立学校教師	公立学校教師
公認アソシエイト不動産ブローカー	公認アソシエイト不動産ブローカー
公認不動産専門家	公認不動産専門家
公認不動産業者	公認不動産業者
公認不動産鑑定士	公認不動産鑑定士
公認会計士	公認会計士
公認住宅ローン_ブローカー	公認住宅ローン ブローカー
公認心理師	公認心理師
公認臨床ソーシャルワーカー	公認臨床ソーシャルワーカー
公認臨床専門カウンセラー	公認臨床専門カウンセラー
公認販売業者	公認販売業者
公認金融アナリスト	公認金融アナリスト
兵士	兵士
内科レジデント	内科レジデント
内科医	内科医
内部コミュニケーション担当者	内部コミュニケーション担当者
内部収入エージェント	内部収入エージェント
再レコーディングミキサー	再レコーディングミキサー
再保険ブローカー	再保険ブローカー
写真マネージャー	写真マネージャー
写真専門家	写真専門家
写真技術者	写真技術者
写真検査技師	写真検査技師
写真編集者	写真編集者
冶金エンジニア	冶金エンジニア
出席係	出席係
出演アーティスト	出演アーティスト
出版アシスタント	出版アシスタント
出版コンサルタント	出版コンサルタント
出版コーディネーター	出版コーディネーター
出版ディレクター	出版ディレクター
出版マネージャー	出版マネージャー
出版マネージャー	出版マネージャー
出版物デザイナー	出版物デザイナー
出版社	出版社
出版編集者	出版編集者
出版部の責任者	出版部の責任者
出荷と受入コーディネーター	出荷と受入コーディネーター
出荷と受入マネージャー	出荷と受入マネージャー
出荷と受入担当者	出荷と受入担当者
出荷マネージャー	出荷マネージャー
出荷リーダー	出荷リーダー
切符取扱人	切符取扱人
刑事	刑事
刑事弁護人	刑事弁護人
初等教育の教師	初等教育の教師
制作アーティスト	制作アーティスト
制作コーディネーター	制作コーディネーター
制作担当	制作担当
制作秘書	制作秘書
制作請負業者	制作請負業者
制御システム_スペシャリスト	制御システム スペシャリスト
制御システムエンジニア	制御システムエンジニア
制御システム設計者	制御システム設計者
副クリエイティブディレクター	副クリエイティブディレクター
副マネージャー	副マネージャー
副マーケティングマネージャー	副マーケティングマネージャー
副保安官	副保安官
副司法長官	副司法長官
副地方検事	副地方検事
副大臣	副大臣
副学長	副学長
副操縦士	副操縦士
副料理長	副料理長
副校長	副校長
副法務顧問	副法務顧問
副消防長	副消防長
副社長	副社長
副社長補佐	副社長補佐
副編集長	副編集長
副長官	副長官
創業パートナー	創業パートナー
助成金マネージャー	助成金マネージャー
助教授	助教授
労働と雇用弁護士	労働と雇用弁護士
勅許会計士アシスタント	勅許会計士アシスタント
動物管理技術者	動物管理技術者
動物飼育員	動物飼育員
動画編集者	動画編集者
化学エンジニア	化学エンジニア
医学教育部長	医学教育部長
医学部の助教授	医学部の助教授
医師	医師
医師助手	医師助手
医療イラストレーター	医療イラストレーター
医療インターン	医療インターン
医療リクルーター	医療リクルーター
医療助手	医療助手
医療情報管理者	医療情報管理者
医療技術者	医療技術者
卒業生リレーションズ_オフィサー	卒業生リレーションズ オフィサー
卒業生リレーションズ_マネージャー	卒業生リレーションズ マネージャー
印刷プロデューサー	印刷プロデューサー
印刷制作マネージャー	印刷制作マネージャー
印刷物制作コーディネーター	印刷物制作コーディネーター
危機管理コーディネーター	危機管理コーディネーター
収益エージェント	収益エージェント
取引アシスタント	取引アシスタント
取引アナリスト	取引アナリスト
取引責任者	取引責任者
取引関係者	取引関係者
取締役会副議長	取締役会副議長
取締役社長	取締役社長
受付スーパーバイザー	受付スーパーバイザー
受付マネージャー	受付マネージャー
受入のスーパーバイザー	受入のスーパーバイザー
口腔顎顔面外科医	口腔顎顔面外科医
司書	司書
司法法律事務員	司法法律事務員
司法補佐官	司法補佐官
司法長官補佐	司法長官補佐
司祭	司祭
同窓会役員	同窓会役員
名誉教授	名誉教授
吹奏楽講師	吹奏楽講師
品質保証オートメーション_エンジニア	品質保証オートメーション エンジニア
品質保証技術者	品質保証技術者
品質管理オペレーター	品質管理オペレーター
哲学の助教授	哲学の助教授
哲学の教授	哲学の教授
商品アナリスト	商品アナリスト
商業プロデューサー	商業プロデューサー
商業ローンアシスタント	商業ローンアシスタント
商業保険エージェント	商業保険エージェント
商業保険ブローカー	商業保険ブローカー
商業用不動産コンサルタント	商業用不動産コンサルタント
商業用不動産スペシャリスト	商業用不動産スペシャリスト
商業用不動産業者	商業用不動産業者
商業銀行家	商業銀行家
商法弁護士	商法弁護士
営業スプランナー	営業スプランナー
営業リクルーター	営業リクルーター
営業担当者	営業担当者
営業部長	営業部長
回路設計エンジニア	回路設計エンジニア
回路設計者	回路設計者
団体予約コーディネーター	団体予約コーディネーター
図書館メディアスペシャリスト	図書館メディアスペシャリスト
図書館長	図書館長
固定資産税マネージャー	固定資産税マネージャー
国の代表者	国の代表者
国内記者	国内記者
国家専門家	国家専門家
国選副弁護人	国選副弁護人
国選弁護人補佐	国選弁護人補佐
国際リクルーター	国際リクルーター
国際事業開発コンサルタント	国際事業開発コンサルタント
国際広報マネージャー	国際広報マネージャー
国際弁護士	国際弁護士
国際物流コーディネーター	国際物流コーディネーター
国際物流マネージャー	国際物流マネージャー
国際貿易の専門家	国際貿易の専門家
国際購買マネージャー	国際購買マネージャー
土木エンジニアの大学院生	土木エンジニアの大学院生
土木デザイナー	土木デザイナー
土木工学のインターン	土木工学のインターン
土木技術者	土木技術者
土木製図者	土木製図者
土木設計エンジニア	土木設計エンジニア
在宅看護師	在宅看護師
在庫マネージャー	在庫マネージャー
在庫管理責任者	在庫管理責任者
地上運用マネージャー	地上運用マネージャー
地区のエンジニア	地区のエンジニア
地区トレーナー	地区トレーナー
地区資産保護マネージャー	地区資産保護マネージャー
地域の不動産マネージャー	地域の不動産マネージャー
地域の技術専門家	地域の技術専門家
地域の看護師	地域の看護師
地域コーチ	地域コーチ
地域システムエンジニア	地域システムエンジニア
地域ゼネラルマネージャー	地域ゼネラルマネージャー
地域レベニューマネージャー	地域レベニューマネージャー
地域ロスプリベンション_ディレクター	地域ロスプリベンション ディレクター
地域建設マネージャー	地域建設マネージャー
地域弁護士	地域弁護士
地域採用マネージャー	地域採用マネージャー
地域支援スペシャリスト	地域支援スペシャリスト
地域物流マネージャー	地域物流マネージャー
地域生産マネージャー	地域生産マネージャー
地域輸出マネージャー	地域輸出マネージャー
地域輸送マネージャー	地域輸送マネージャー
地方の運送業者	地方の運送業者
地方の運送業者アソシエイト	地方の運送業者アソシエイト
地方判事	地方判事
地方捜査官	地方捜査官
地方検事補	地方検事補
地方自治体の技術者	地方自治体の技術者
地球科学者	地球科学者
地質エンジニア	地質エンジニア
地質学者	地質学者
地質学者コンサルタント	地質学者コンサルタント
地質技術者	地質技術者
地震データ処理専門の地球物理学者	地震データ処理専門の地球物理学者
基地マネージャー	基地マネージャー
報道官	報道官
報道記者	報道記者
報酬および福利厚生コーディネーター	報酬および福利厚生コーディネーター
壁画家	壁画家
夏限定の法律事務員	夏限定の法律事務員
外国人アソシエイト	外国人アソシエイト
外国法コンサルタント	外国法コンサルタント
外国為替マネージャー	外国為替マネージャー
外科医	外科医
外科教授	外科教授
外科看護師	外科看護師
外部コミュニケーションマネージャー	外部コミュニケーションマネージャー
外部審査員	外部審査員
夜勤のアシスタントマネージャー	夜勤のアシスタントマネージャー
夜勤のマネージャー	夜勤のマネージャー
大学の司書	大学の司書
大学プログラム_インターン	大学プログラム インターン
大学教授	大学教授
大学登録担当者	大学登録担当者
大学講師	大学講師
大学院プログラム_コーディネーター	大学院プログラム コーディネーター
大学院生アソシエイト	大学院生アソシエイト
大学院生講師	大学院生講師
大学院研究員	大学院研究員
大隊長	大隊長
契約Java開発者	契約Java開発者
契約ウェブ開発者	契約ウェブ開発者
契約コピーライター	契約コピーライター
契約パイロット	契約パイロット
契約フォトグラファー	契約フォトグラファー
契約ライター	契約ライター
契約地質学者	契約地質学者
契約弁護士	契約弁護士
契約採用担当者	契約採用担当者
契約機械エンジニア	契約機械エンジニア
婦人服デザイナー	婦人服デザイナー
学校のセラピスト	学校のセラピスト
学校の看護師	学校の看護師
学校図書館メディアスペシャリスト	学校図書館メディアスペシャリスト
学生ボランティア	学生ボランティア
学生教師	学生教師
学生記者	学生記者
学生配置コーディネーター	学生配置コーディネーター
学習サポート教師	学習サポート教師
学術専門家	学術専門家
学部入学のアシスタントディレクター	学部入学のアシスタントディレクター
学部長	学部長
宇宙船技師	宇宙船技師
完成エンジニア	完成エンジニア
実施責任者	実施責任者
客員助教	客員助教
客員教授	客員教授
客室部門_マネージャー	客室部門 マネージャー
家庭医	家庭医
家族カウンセラー	家族カウンセラー
家族サービスのディレクター	家族サービスのディレクター
家族支援ワーカー	家族支援ワーカー
家族法弁護士	家族法弁護士
宿屋の主	宿屋の主
寄稿ライター	寄稿ライター
対外関係の副社長	対外関係の副社長
専任教員	専任教員
専門スタッフメンバー	専門スタッフメンバー
導入エンジニア	導入エンジニア
導入エンジニア	導入エンジニア
導入チームのリーダー	導入チームのリーダー
導入技術者	導入技術者
小児科の看護師	小児科の看護師
小児科医	小児科医
小売店スタッフ	小売店スタッフ
小売販売アシスタント	小売販売アシスタント
小売販売員	小売販売員
小売販売業者	小売販売業者
小学校のカウンセラー	小学校のカウンセラー
小学校の校長	小学校の校長
小学校教師	小学校教師
展覧会キュレーター	展覧会キュレーター
州および地方の税務マネージャー	州および地方の税務マネージャー
州警察​​官	州警察​​官
巡査	巡査
巡査部長	巡査部長
工場プロセスエンジニア	工場プロセスエンジニア
市内郵便配達員	市内郵便配達員
市副弁護士	市副弁護士
市場調査アナリスト	市場調査アナリスト
市民監督者	市民監督者
常駐エンジニア	常駐エンジニア
常駐医務官	常駐医務官
年次ファンドマネージャー	年次ファンドマネージャー
年次基金のアシスタントディレクター	年次基金のアシスタントディレクター
年次寄付マネージャー	年次寄付マネージャー
幼児教師	幼児教師
幼児教育者	幼児教育者
幼稚園の先生	幼稚園の先生
広告アカウント担当者	広告アカウント担当者
広告エージェント	広告エージェント
広告コピーライター	広告コピーライター
広告コーディネーター	広告コーディネーター
広告スペシャリスト	広告スペシャリスト
広告スーパーバイザー	広告スーパーバイザー
広告デザイナー	広告デザイナー
広告マネージャー	広告マネージャー
広告制作コーディネーター	広告制作コーディネーター
広告担当マネージャー	広告担当マネージャー
広告責任者	広告責任者
広報	広報
広報とコミュニケーション_コンサルタント	広報とコミュニケーション コンサルタント
広報のディレクター	広報のディレクター
広報の責任者	広報の責任者
広報アカウント_エグゼクティブ	広報アカウント エグゼクティブ
広報コンサルタント	広報コンサルタント
広報コーディネーター	広報コーディネーター
広報スペシャリスト	広報スペシャリスト
広報マネージャー	広報マネージャー
広報・コミュニケーション_コーディネーター	広報・コミュニケーション コーディネーター
広報代表者	広報代表者
広報担当者	広報担当者
広報責任者	広報責任者
床屋	床屋
床技師	床技師
店主	店主
建築アシスタント	建築アシスタント
建築アソシエイト	建築アソシエイト
建築サービスエンジニア	建築サービスエンジニア
建築デザイナー	建築デザイナー
建築学の教授	建築学の教授
建築学生	建築学生
建築学科の大学院生	建築学科の大学院生
建築家	建築家
建設インターン	建設インターン
建設検査官	建設検査官
建設現場監督	建設現場監督
建設監督	建設監督
建設者	建設者
弁護士	弁護士
弁護士の秘書	弁護士の秘書
弁護士補佐	弁護士補佐
引受アシスタント	引受アシスタント
引受コンサルタント	引受コンサルタント
引受取締役	引受取締役
引受担当副社長補佐	引受担当副社長補佐
当直マネージャー	当直マネージャー
彫刻家	彫刻家
循環器の研修医	循環器の研修医
心理アシスタント	心理アシスタント
心理学者	心理学者
心臓専門医	心臓専門医
応用技術者	応用技術者
情報システムアナリスト	情報システムアナリスト
情報セキュリティ_アナリスト	情報セキュリティ アナリスト
情報セキュリティエンジニア	情報セキュリティエンジニア
情報セキュリティ管理者	情報セキュリティ管理者
情報保証責任者	情報保証責任者
成人看護師	成人看護師
戦略と運営ディレクター	戦略と運営ディレクター
戦略と運営マネージャー	戦略と運営マネージャー
戦略コンサルタント	戦略コンサルタント
戦略スーパーバイザー	戦略スーパーバイザー
戦略ビジネスコンサルタント	戦略ビジネスコンサルタント
戦略企画マネージャー	戦略企画マネージャー
戦略副社長	戦略副社長
戦略的コミュニケーション	戦略的コミュニケーション
戦略的取り組みの副社長	戦略的取り組みの副社長
戦略計画のマネージャー	戦略計画のマネージャー
戦略計画アナリスト	戦略計画アナリスト
戦略開発ディレクター	戦略開発ディレクター
戦略開発責任者	戦略開発責任者
技術コーチ	技術コーチ
技術スタッフのメンバー	技術スタッフのメンバー
技術リーダー	技術リーダー
技術採用マネージャー	技術採用マネージャー
技術監督	技術監督
技術翻訳者	技術翻訳者
技術者	技術者
投資アナリスト	投資アナリスト
投資ストラテジスト	投資ストラテジスト
投資パフォーマンス_アナリスト	投資パフォーマンス アナリスト
投資信託アナリスト	投資信託アナリスト
投資信託スペシャリスト	投資信託スペシャリスト
投資専門家	投資専門家
投資調査アナリスト	投資調査アナリスト
投資責任者	投資責任者
投資運用マネージャー	投資運用マネージャー
投資銀行のサマーアナリスト	投資銀行のサマーアナリスト
投資銀行アソシエイト	投資銀行アソシエイト
投資銀行アナリスト	投資銀行アナリスト
投資銀行インターン	投資銀行インターン
担保のスペシャリスト	担保のスペシャリスト
指定ブローカー	指定ブローカー
指導助手	指導助手
指導専門家	指導専門家
挨拶係	挨拶係
振付家	振付家
捜査官	捜査官
捜査部長	捜査部長
排水エンジニア	排水エンジニア
掘削コンサルタント	掘削コンサルタント
掘削マネージャー	掘削マネージャー
掘削監督	掘削監督
採用と研修マネージャー	採用と研修マネージャー
採用と選考のマネージャー	採用と選考のマネージャー
採用アカウントマネージャー	採用アカウントマネージャー
採用アシスタント	採用アシスタント
採用アシスタントマネージャー	採用アシスタントマネージャー
採用アナリスト	採用アナリスト
採用コンサルタント	採用コンサルタント
採用スペシャリスト	採用スペシャリスト
採用スーパーバイザー	採用スーパーバイザー
採用スーパーバイザー	採用スーパーバイザー
採用チームリーダー	採用チームリーダー
採用プロジェクトマネージャー	採用プロジェクトマネージャー
採用マネージャー	採用マネージャー
採用担当副社長	採用担当副社長
採用担当役員	採用担当役員
採用担当者	採用担当者
採用業務マネージャー	採用業務マネージャー
採用責任者	採用責任者
探査の副社長	探査の副社長
推進エンジニア	推進エンジニア
損害賠償請求査定人	損害賠償請求査定人
撮影監督	撮影監督
擁護者	擁護者
支店運営責任者	支店運営責任者
支店長	支店長
放射線技師	放射線技師
放射線科スーパーバイザー	放射線科スーパーバイザー
放射線科マネージャー	放射線科マネージャー
放射線科部長	放射線科部長
放送アシスタント	放送アシスタント
放送アナウンサー	放送アナウンサー
放送コーディネーター	放送コーディネーター
放送ジャーナリスト	放送ジャーナリスト
放送システムエンジニア	放送システムエンジニア
放送デザイナー	放送デザイナー
放送バイヤー	放送バイヤー
放送マネージャー	放送マネージャー
放送交渉人	放送交渉人
放送制作ディレクター	放送制作ディレクター
放送局	放送局
放送局員	放送局員
放送技術者	放送技術者
放送業務ディレクター	放送業務ディレクター
放送監督	放送監督
政治学の教授	政治学の教授
政策アナリスト	政策アナリスト
政策コーディネーター	政策コーディネーター
政策官	政策官
政策専門家	政策専門家
政策責任者	政策責任者
救急医	救急医
救急救命士	救急救命士
救急科技師	救急科技師
救済マネージャー	救済マネージャー
教員アドバイザー	教員アドバイザー
教室アシスタント	教室アシスタント
教師	教師
教師補佐	教師補佐
教授	教授
教育カウンセラー	教育カウンセラー
教育コーチ	教育コーチ
教育セラピスト	教育セラピスト
教育ディレクター	教育ディレクター
教育学の助教授	教育学の助教授
教育学部の教授	教育学部の教授
教育診断士	教育診断士
数学の教師	数学の教師
文書管理担当者	文書管理担当者
料理マネージャー	料理マネージャー
料理人	料理人
料理講師	料理講師
料理長	料理長
新卒採用マネージャー	新卒採用マネージャー
新居コンサルタント	新居コンサルタント
新居販売カウンセラー	新居販売カウンセラー
新居販売コンサルタント	新居販売コンサルタント
新生児専門医	新生児専門医
新規事業スペシャリスト	新規事業スペシャリスト
旅行カウンセラー	旅行カウンセラー
旅行ライター	旅行ライター
旅行代理店マネージャー	旅行代理店マネージャー
旅行専門家	旅行専門家
旅行役員	旅行役員
旅行編集者	旅行編集者
日本語の翻訳者	日本語の翻訳者
日焼けコンサルタント	日焼けコンサルタント
映像プロデューサー	映像プロデューサー
映像作家	映像作家
映像制作スペシャリスト	映像制作スペシャリスト
映像制作ディレクター	映像制作ディレクター
映画とビデオの編集者	映画とビデオの編集者
映画プロデューサー	映画プロデューサー
映画作曲家	映画作曲家
映画監督	映画監督
映画編集者	映画編集者
映画製作者	映画製作者
暖房および空調エンジニア	暖房および空調エンジニア
最前線のサポート	最前線のサポート
最高リスク責任者	最高リスク責任者
最高事業開発責任者	最高事業開発責任者
最高信用責任者	最高信用責任者
最高医療責任者	最高医療責任者
最高執行責任者	最高執行責任者
最高引受責任者	最高引受責任者
最高投資責任者	最高投資責任者
最高経営責任者	最高経営責任者
最高融資責任者	最高融資責任者
有限責任社員	有限責任社員
朝のニュースのアナウンサー	朝のニュースのアナウンサー
朝の番組のプロデューサー	朝の番組のプロデューサー
期間限定の販売スタッフ	期間限定の販売スタッフ
校正技術者	校正技術者
校正者	校正者
校長	校長
校長補佐	校長補佐
株主	株主
株式アナリスト	株式アナリスト
株式オプション取引業者	株式オプション取引業者
株式ストラテジスト	株式ストラテジスト
株式ディーラー	株式ディーラー
株式デリバティブ_トレーダー	株式デリバティブ トレーダー
株式デリバティブの販売	株式デリバティブの販売
株式デリバティブ_ブローカー	株式デリバティブ ブローカー
株式パートナー	株式パートナー
株式ポートフォリオマネージャー	株式ポートフォリオマネージャー
株式売却	株式売却
株式専門家	株式専門家
株式担当者	株式担当者
株式調査アナリスト	株式調査アナリスト
株式調査インターン	株式調査インターン
株式調査ディレクター	株式調査ディレクター
株式調査員	株式調査員
株式調査責任者	株式調査責任者
株式販売トレーダー	株式販売トレーダー
核医学技術者	核医学技術者
格闘技インストラクター	格闘技インストラクター
案内広告のマネージャー	案内広告のマネージャー
検索コンサルタント	検索コンサルタント
業務支援システムエンジニア	業務支援システムエンジニア
構成エンジニア	構成エンジニア
構造エンジニアの大学院生	構造エンジニアの大学院生
権利擁護担当者	権利擁護担当者
橋のエンジニア	橋のエンジニア
機械システムエンジニア	機械システムエンジニア
機械プロジェクトエンジニア	機械プロジェクトエンジニア
機械専門家	機械専門家
機械工学の学生	機械工学の学生
機械工学インターン	機械工学インターン
機械工学コンサルタント	機械工学コンサルタント
機械工学技術者	機械工学技術者
機械工学科の大学院生	機械工学科の大学院生
機械設計エンジニア	機械設計エンジニア
機械設計マネージャー	機械設計マネージャー
機械設計者	機械設計者
機械開発エンジニア	機械開発エンジニア
機関投資家向け株式販売担当副社長	機関投資家向け株式販売担当副社長
歌手	歌手
正社員採用コンサルタント	正社員採用コンサルタント
歯内療法士	歯内療法士
歯科看護師	歯科看護師
歯科矯正医	歯科矯正医
歴史の助教授	歴史の助教授
歴史の非常勤教授	歴史の非常勤教授
歴史教師	歴史教師
水中エアロビクスのインストラクター	水中エアロビクスのインストラクター
水文学者	水文学者
水泳コーチ	水泳コーチ
決済専門家	決済専門家
治安要員	治安要員
法人トラベルマネージャー	法人トラベルマネージャー
法人営業ディレクター	法人営業ディレクター
法人営業トレーダー	法人営業トレーダー
法人営業副社長	法人営業副社長
法人弁護士	法人弁護士
法人旅行代理店	法人旅行代理店
法人税コンサルタント	法人税コンサルタント
法人税マネージャー	法人税マネージャー
法務およびコンプライアンス責任者	法務およびコンプライアンス責任者
法務アソシエイト	法務アソシエイト
法務官	法務官
法務幹部	法務幹部
法務秘書	法務秘書
法務責任者	法務責任者
法務責任者と会社秘書	法務責任者と会社秘書
法務部のインターン	法務部のインターン
法務部の責任者	法務部の責任者
法務部アシスタントマネージャー	法務部アシスタントマネージャー
法務部長	法務部長
法務顧問補佐	法務顧問補佐
法医学心理学者	法医学心理学者
法執行官	法執行官
法学部の助教授	法学部の助教授
法廷弁護士	法廷弁護士
法律カウンセラー	法律カウンセラー
法律事務員	法律事務員
法律専門家	法律専門家
法律採用コンサルタント	法律採用コンサルタント
法律研究者	法律研究者
法律編集者	法律編集者
法律顧問	法律顧問
派遣スーパーバイザー	派遣スーパーバイザー
派遣マネージャー	派遣マネージャー
流通責任者	流通責任者
海事士官	海事士官
海事監督官	海事監督官
海兵隊員	海兵隊員
海外旅行コンサルタント	海外旅行コンサルタント
海洋コンサルタント	海洋コンサルタント
海洋業務マネージャー	海洋業務マネージャー
海鮮担当者	海鮮担当者
消費者ローン_アンダーライター	消費者ローン アンダーライター
消防中尉	消防中尉
消防保安官	消防保安官
消防士	消防士
消防署長	消防署長
消防署長補佐	消防署長補佐
混合信号設計エンジニア	混合信号設計エンジニア
清掃員	清掃員
演劇の教師	演劇の教師
演劇監督	演劇監督
灌流学者	灌流学者
炎のアーティスト	炎のアーティスト
無線エンジニア	無線エンジニア
無線コンサルタント	無線コンサルタント
無線スペシャリスト	無線スペシャリスト
無線ネットワーク_エンジニア	無線ネットワーク エンジニア
無線技師	無線技師
無線技術者	無線技術者
照明カメラマン	照明カメラマン
物流	物流
物流の専門家	物流の専門家
物流アカウント_マネージャー	物流アカウント マネージャー
物流アシスタント	物流アシスタント
物流アソシエイト	物流アソシエイト
物流アナリスト	物流アナリスト
物流エンジニア	物流エンジニア
物流エージェント	物流エージェント
物流コンサルタント	物流コンサルタント
物流コントローラー	物流コントローラー
物流コーディネーター	物流コーディネーター
物流スーパーバイザー	物流スーパーバイザー
物流センターのスーパーバイザー	物流センターのスーパーバイザー
物流センター長	物流センター長
物流チームのリーダー	物流チームのリーダー
物流ディレクター	物流ディレクター
物流プランナー	物流プランナー
物流マネージャー	物流マネージャー
物流業者	物流業者
物流管理者	物流管理者
物流責任者	物流責任者
物流部の責任者	物流部の責任者
物流部門マネージャー	物流部門マネージャー
物理設計エンジニア	物理設計エンジニア
物理設計マネージャー	物理設計マネージャー
特別イベントディレクター	特別イベントディレクター
特別イベントプランナー	特別イベントプランナー
特別サービスのディレクター	特別サービスのディレクター
特別捜査官	特別捜査官
特別教育の指導助手	特別教育の指導助手
特別教育の教師	特別教育の教師
特別教育の監修者	特別教育の監修者
特別教育アシスタント	特別教育アシスタント
特別教育者	特別教育者
特別請求の担当者	特別請求の担当者
特別顧問	特別顧問
特集ライター	特集ライター
犬舎アシスタント	犬舎アシスタント
犯罪捜査官	犯罪捜査官
獣医アシスタント	獣医アシスタント
獣医外科医	獣医外科医
獣医師	獣医師
現地ネットワーク管理者	現地ネットワーク管理者
現地販売アシスタント	現地販売アシスタント
現地販売マネージャー	現地販売マネージャー
現場土木技術者	現場土木技術者
現場監督	現場監督
現場調査員	現場調査員
現金出納員	現金出納員
理学療法ディレクター	理学療法ディレクター
環境エンジニア	環境エンジニア
環境グラフィックデザイナー	環境グラフィックデザイナー
環境プログラムマネージャー	環境プログラムマネージャー
環境プロジェクトマネージャー	環境プロジェクトマネージャー
環境保護の専門家	環境保護の専門家
環境地質学者	環境地質学者
環境技術者	環境技術者
環境科学者	環境科学者
生命保険会社	生命保険会社
生物医学機器技術者	生物医学機器技術者
生物学の教師	生物学の教師
生産部門マネージャー	生産部門マネージャー
産業保健師	産業保健師
用務員責任者	用務員責任者
用地取得マネージャー	用地取得マネージャー
画像サービスのディレクター	画像サービスのディレクター
画像スーパーバイザー	画像スーパーバイザー
画家	画家
留学アドバイザー	留学アドバイザー
番組プロデューサー	番組プロデューサー
発車係	発車係
登録ディレクター	登録ディレクター
登録歯科助手	登録歯科助手
登録歯科衛生士	登録歯科衛生士
登録獣医師	登録獣医師
登録管理ディレクター	登録管理ディレクター
監査人	監査人
監査員	監査員
監督	監督
監督特別代理人	監督特別代理人
監視官	監視官
目録作成者	目録作成者
相談心理学者	相談心理学者
看護インストラクター	看護インストラクター
看護学生	看護学生
看護師	看護師
看護師リエゾン	看護師リエゾン
看護部長補佐	看護部長補佐
知的財産のスペシャリスト	知的財産のスペシャリスト
知的財産エンジニア	知的財産エンジニア
知的財産弁護士	知的財産弁護士
矯正職員	矯正職員
石油エンジニア	石油エンジニア
研修および配置担当者	研修および配置担当者
研究のディレクター	研究のディレクター
研究アシスタント	研究アシスタント
研究図書館員	研究図書館員
研究地質学者	研究地質学者
研究弁護士	研究弁護士
研究開発エンジニア	研究開発エンジニア
研究開発技術者	研究開発技術者
研究開発科学者	研究開発科学者
破産の専門家	破産の専門家
礼拝リーダー	礼拝リーダー
社会学の教師	社会学の教師
社会学の教授	社会学の教授
社内コミュニケーション_コーディネーター	社内コミュニケーション コーディネーター
社内リクルーター	社内リクルーター
社内問屋	社内問屋
社内通訳	社内通訳
社外弁護士	社外弁護士
福利厚生マネージャー	福利厚生マネージャー
私立探偵	私立探偵
科学リクルーター	科学リクルーター
秘書アシスタント	秘書アシスタント
移行コーディネーター	移行コーディネーター
移転ディレクター	移転ディレクター
移転専門家	移転専門家
税務アナリスト	税務アナリスト
税務コンサルタント	税務コンサルタント
税務コンプライアンス_マネージャー	税務コンプライアンス マネージャー
税務マネージャー	税務マネージャー
税務専門家	税務専門家
税務弁護士	税務弁護士
税務担当者	税務担当者
税務監督者	税務監督者
税務管理者	税務管理者
税務署長	税務署長
税務課の責任者	税務課の責任者
税務調査官	税務調査官
税理士	税理士
空港運営スーパーバイザー	空港運営スーパーバイザー
窓口担当者	窓口担当者
第二アシスタント	第二アシスタント
第二助監督	第二助監督
管理弁護士	管理弁護士
管理株主	管理株主
管理編集者	管理編集者
管理責任者	管理責任者
簿記係	簿記係
精神分析医	精神分析医
精神科メンタルヘルス看護師	精神科メンタルヘルス看護師
紳士服デザイナー	紳士服デザイナー
紹介エージェント	紹介エージェント
組み込みソフトウェア_チームリーダー	組み込みソフトウェア チームリーダー
組織の有効性のディレクター	組織の有効性のディレクター
組織開発コンサルタント	組織開発コンサルタント
組織開発担当副社長	組織開発担当副社長
組込みシステムエンジニア	組込みシステムエンジニア
経営コンサルタント	経営コンサルタント
経営学の助教授	経営学の助教授
経営顧問	経営顧問
経済開発担当官	経済開発担当官
結婚家族セラピスト	結婚家族セラピスト
給与および福利厚生コーディネーター	給与および福利厚生コーディネーター
給与スーパーバイザー	給与スーパーバイザー
給与計算士	給与計算士
給与計算税理士	給与計算税理士
統合マーケティングマネージャー	統合マーケティングマネージャー
緊急指令員	緊急指令員
総代理店	総代理店
総勘定元帳のスーパーバイザー	総勘定元帳のスーパーバイザー
総料理長	総料理長
総監督	総監督
編集アシスタント	編集アシスタント
編集コンサルタント	編集コンサルタント
編集コーディネーター	編集コーディネーター
編集ディレクター	編集ディレクター
編集プロジェクトマネージャー	編集プロジェクトマネージャー
編集ライター	編集ライター
編集制作担当	編集制作担当
編集監修	編集監修
編集者	編集者
編集部長	編集部長
編集長	編集長
美容師	美容師
美術の専門家	美術の専門家
美術の教授	美術の教授
美術写真家	美術写真家
美術品ディーラー	美術品ディーラー
美術評論家	美術評論家
美術部コーディネーター	美術部コーディネーター
美術部マネージャー	美術部マネージャー
翻訳コーディネーター	翻訳コーディネーター
職長	職長
脚本家	脚本家
臨床インストラクター	臨床インストラクター
臨床カウンセラー	臨床カウンセラー
臨床スタッフ薬剤師	臨床スタッフ薬剤師
臨床ソーシャルワーカー	臨床ソーシャルワーカー
臨床リエゾン	臨床リエゾン
臨床准教授	臨床准教授
臨床工学技士	臨床工学技士
臨床心理士	臨床心理士
臨床応用スペシャリスト	臨床応用スペシャリスト
臨床指導者	臨床指導者
臨床療法士	臨床療法士
臨床研究コーディネーター	臨床研究コーディネーター
臨床薬剤師	臨床薬剤師
臨床薬学スペシャリスト	臨床薬学スペシャリスト
臨床薬局マネージャー	臨床薬局マネージャー
臨時スタッフ	臨時スタッフ
臨時会計士	臨時会計士
臨時教員	臨時教員
自動化コンサルタント	自動化コンサルタント
自動化コーディネーター	自動化コーディネーター
自動化システムエンジニア	自動化システムエンジニア
自動化チームのリーダー	自動化チームのリーダー
自動化テスト_アナリスト	自動化テスト アナリスト
自動化技術者	自動化技術者
自動化開発者	自動化開発者
自己トレーダー	自己トレーダー
自己株式トレーダー	自己株式トレーダー
舗装エンジニア	舗装エンジニア
航空エンジニア	航空エンジニア
航空会社の機長	航空会社の機長
航空電子技術者	航空電子技術者
船舶ブローカー	船舶ブローカー
芸術家	芸術家
英語の助教授	英語の助教授
英語の教授	英語の教授
英語の翻訳者	英語の翻訳者
英語を話す美術教師	英語を話す美術教師
英語教師	英語教師
荷送人	荷送人
薬事薬剤師	薬事薬剤師
薬局のアシスタントディレクター	薬局のアシスタントディレクター
薬局の管理者	薬局の管理者
薬局レジデント	薬局レジデント
薬局研修医	薬局研修医
薬局運営マネージャー	薬局運営マネージャー
融資担当ディレクター	融資担当ディレクター
血管技師	血管技師
行動健康技術者	行動健康技術者
行政アナリスト	行政アナリスト
行政法判事	行政法判事
袋詰め係	袋詰め係
裁判官	裁判官
裁判弁護士	裁判弁護士
裁縫講師	裁縫講師
装飾コンサルタント	装飾コンサルタント
補助教育者	補助教育者
製作責任者	製作責任者
製品エンジニアリング_スーパーバイザー	製品エンジニアリング スーパーバイザー
製品コントローラー	製品コントローラー
製品サポート技術者	製品サポート技術者
製品ストラテジスト	製品ストラテジスト
製品ポートフォリオ_マネージャー	製品ポートフォリオ マネージャー
製品マーケティングアナリスト	製品マーケティングアナリスト
製品技術者	製品技術者
製品設計および開発エンジニア	製品設計および開発エンジニア
製品開発アシスタント	製品開発アシスタント
製品開発アソシエイト	製品開発アソシエイト
製品開発技術者	製品開発技術者
製品開発者	製品開発者
製図技師	製図技師
製版コーディネーター	製版コーディネーター
製造技術者	製造技術者
製造業務マネージャー	製造業務マネージャー
製造薬剤師	製造薬剤師
製造設計エンジニア	製造設計エンジニア
規制顧問	規制顧問
視覚専門家	視覚専門家
観光ガイド	観光ガイド
言語コンサルタント	言語コンサルタント
言語学者	言語学者
言語芸術教師	言語芸術教師
計画的寄付のディレクター	計画的寄付のディレクター
設備保全技術者	設備保全技術者
設計と製作のインターン	設計と製作のインターン
設計エンジニア	設計エンジニア
設計リリースエンジニア	設計リリースエンジニア
設計工学インターン	設計工学インターン
設計建築家	設計建築家
設計自動化エンジニア	設計自動化エンジニア
設計開発エンジニア	設計開発エンジニア
設計開発ディレクター	設計開発ディレクター
許可技術者	許可技術者
訴訟アソシエイト	訴訟アソシエイト
訴訟コンサルタント	訴訟コンサルタント
訴訟スペシャリスト	訴訟スペシャリスト
訴訟ディレクター	訴訟ディレクター
訴訟パートナー	訴訟パートナー
訴訟マネージャー	訴訟マネージャー
訴訟弁護士	訴訟弁護士
訴訟支援アナリスト	訴訟支援アナリスト
訴訟補佐人	訴訟補佐人
診断エンジニア	診断エンジニア
詐欺捜査官	詐欺捜査官
評価アナリスト	評価アナリスト
評価担当者	評価担当者
試着室スタッフ	試着室スタッフ
試験中のソフトウェア開発エンジニア	試験中のソフトウェア開発エンジニア
認定の専門カウンセラー	認定の専門カウンセラー
認定エンジニア	認定エンジニア
認定パーソナルトレーナー	認定パーソナルトレーナー
認定メンタルヘルスカウンセラー	認定メンタルヘルスカウンセラー
認定モーゲージプランナー	認定モーゲージプランナー
認定住宅ローン計画スペシャリスト	認定住宅ローン計画スペシャリスト
認定住宅鑑定士	認定住宅鑑定士
認定保険エージェント	認定保険エージェント
認定准看護師	認定准看護師
認定法務インターン	認定法務インターン
認定看護助手	認定看護助手
認定結婚家族療法士	認定結婚家族療法士
認定臨床心理士	認定臨床心理士
認定臨床研究コーディネーター	認定臨床研究コーディネーター
認定薬剤師	認定薬剤師
認定鍼灸師	認定鍼灸師
読み書きの家庭教師	読み書きの家庭教師
読書の家庭教師	読書の家庭教師
読書の専門家	読書の専門家
読書の教師	読書の教師
読書コーチ	読書コーチ
課題編集者	課題編集者
調査スペシャリスト	調査スペシャリスト
調査研究コーディネーター	調査研究コーディネーター
調理補助	調理補助
請求の担当者	請求の担当者
請求アソシエイト	請求アソシエイト
請求弁護士	請求弁護士
請負業者	請負業者
講師	講師
識字コーチ	識字コーチ
識字専門家	識字専門家
警察副署長	警察副署長
警察官	警察官
警察署長	警察署長
警察署長補佐	警察署長補佐
警部	警部
警部補	警部補
財務担当者	財務担当者
財務管理プログラムのインターン	財務管理プログラムのインターン
財団マネージャー	財団マネージャー
財産請求の査定人	財産請求の査定人
販売およびマーケティング担当ディレクター	販売およびマーケティング担当ディレクター
販売と取引の責任者	販売と取引の責任者
販売員	販売員
貯水池の地質学者	貯水池の地質学者
買収マーケティングマネージャー	買収マーケティングマネージャー
買掛金管理者	買掛金管理者
貿易マーケティング_アシスタント	貿易マーケティング アシスタント
貿易マーケティングコーディネーター	貿易マーケティングコーディネーター
貿易専門家	貿易専門家
資本市場アナリスト	資本市場アナリスト
資源調達の責任者	資源調達の責任者
資産管理副社長	資産管理副社長
資産管理責任者	資産管理責任者
資金提供者	資金提供者
資金調達の責任者	資金調達の責任者
資金調達コンサルタント	資金調達コンサルタント
資金調達コーディネーター	資金調達コーディネーター
資金調達ディレクター	資金調達ディレクター
資金調達マネージャー	資金調達マネージャー
資金調達担当者	資金調達担当者
資金開発コーディネーター	資金開発コーディネーター
起業家	起業家
超音波技師	超音波技師
身元調査員	身元調査員
軍団メンバー	軍団メンバー
軍曹	軍曹
輸入アナリスト	輸入アナリスト
輸入エグゼクティブ	輸入エグゼクティブ
輸入コーディネーター	輸入コーディネーター
輸入スペシャリスト	輸入スペシャリスト
輸入マネージャー	輸入マネージャー
輸入担当者	輸入担当者
輸入部門	輸入部門
輸出エリアマネージャー	輸出エリアマネージャー
輸出マネージャー	輸出マネージャー
輸出入アシスタント	輸出入アシスタント
輸出入アナリスト	輸出入アナリスト
輸出入コーディネーター	輸出入コーディネーター
輸出入マネージャー	輸出入マネージャー
輸出入役員	輸出入役員
輸出営業担当者	輸出営業担当者
輸出専門家	輸出専門家
輸出担当官	輸出担当官
輸出販売役員	輸出販売役員
農業エンジニア	農業エンジニア
通貨トレーダー	通貨トレーダー
連邦政府職員	連邦政府職員
連邦税マネージャー	連邦税マネージャー
運動学の教授	運動学の教授
運営および物流マネージャー	運営および物流マネージャー
運営プリンシパル	運営プリンシパル
運用担当者	運用担当者
運航管理者	運航管理者
運航管理責任者	運航管理責任者
運転テストエンジニア	運転テストエンジニア
運転手	運転手
運送業者	運送業者
運送管理者	運送管理者
道路ドライバー	道路ドライバー
選別者	選別者
選手	選手
郡検事補	郡検事補
郵便処理係	郵便処理係
郵便局長	郵便局長
郵便検査官	郵便検査官
都市編集者	都市編集者
都市計画家	都市計画家
配管設計者	配管設計者
配置コンサルタント	配置コンサルタント
金融の非常勤教授	金融の非常勤教授
金融アナリスト	金融アナリスト
金融サービス担当者	金融サービス担当者
金融ジャーナリスト	金融ジャーナリスト
金融ブローカー	金融ブローカー
金融ライター	金融ライター
金融リクルーター	金融リクルーター
金融市場アナリスト	金融市場アナリスト
金融機関の責任者	金融機関の責任者
鉱山地質学者	鉱山地質学者
鉱山技師	鉱山技師
銀行のマネージャー	銀行のマネージャー
銀行員	銀行員
銀行審査官	銀行審査官
銀行窓口	銀行窓口
銃器インストラクター	銃器インストラクター
鍵管理人	鍵管理人
開発および広報担当ディレクター	開発および広報担当ディレクター
開発エンジニア	開発エンジニア
開発プロデューサー	開発プロデューサー
院長	院長
集中治療医	集中治療医
集中治療看護師	集中治療看護師
集荷係	集荷係
雇用専門家	雇用専門家
電子システムエンジニア	電子システムエンジニア
電子デザイナー	電子デザイナー
電子専門家	電子専門家
電子機器販売員	電子機器販売員
電子設計エンジニア	電子設計エンジニア
電子開発エンジニア	電子開発エンジニア
電気および計装エンジニア	電気および計装エンジニア
電気および電子技術者	電気および電子技術者
電気プロジェクトエンジニア	電気プロジェクトエンジニア
電気工学	電気工学
電気工学ディレクター	電気工学ディレクター
電気工学マネージャー	電気工学マネージャー
電気技師	電気技師
電気技師スタッフ	電気技師スタッフ
電気機械エンジニア	電気機械エンジニア
電気試験技師	電気試験技師
電気通信の専門家	電気通信の専門家
電気通信の監督	電気通信の監督
電気通信の責任者	電気通信の責任者
電気通信アシスタント	電気通信アシスタント
電気通信コンサルタント	電気通信コンサルタント
電気通信コーディネーター	電気通信コーディネーター
電気通信システム_エンジニア	電気通信システム エンジニア
電気通信スペシャリスト	電気通信スペシャリスト
電気通信チームリーダー	電気通信チームリーダー
電気通信プロジェクトエンジニア	電気通信プロジェクトエンジニア
電気通信士	電気通信士
電気通信技術者	電気通信技術者
電気部のマネージャー	電気部のマネージャー
電話エンジニア	電話エンジニア
電話オペレーター	電話オペレーター
青果アソシエイト	青果アソシエイト
青果担当者	青果担当者
非常勤教授	非常勤教授
非常勤講師	非常勤講師
音楽インターン	音楽インターン
音楽コンサルタント	音楽コンサルタント
音楽プロデューサー	音楽プロデューサー
音楽作曲家	音楽作曲家
音楽専門家	音楽専門家
音楽講師	音楽講師
音響プロデューサー	音響プロデューサー
顧問	顧問
顧問委員会のメンバー	顧問委員会のメンバー
顧問編集者	顧問編集者
顧客サービス担当者	顧客サービス担当者
顧客管理責任者	顧客管理責任者
顧客関係マネージャー	顧客関係マネージャー
飛行士	飛行士
飛行教官	飛行教官
飛行試験エンジニア	飛行試験エンジニア
食事管理者	食事管理者
食品の店員	食品の店員
食品サービスディレクター	食品サービスディレクター
食品スーパーのスタッフ	食品スーパーのスタッフ
食品安全マネージャー	食品安全マネージャー
食品科学者	食品科学者
食料品店の店員	食料品店の店員
飲食インターン	飲食インターン
飲食スーパーバイザー	飲食スーパーバイザー
飲食ディレクター	飲食ディレクター
飲食店の労働者	飲食店の労働者
飲食店オーナー	飲食店オーナー
飲食担当副社長	飲食担当副社長
高度実践看護師	高度実践看護師
高校の教員	高校の教員
高校の数学教師	高校の数学教師
麻酔技師	麻酔技師
麻酔科研修医	麻酔科研修医
