3dアニメーター	3dアニメーター
Java開発者	Java開発者
iOS開発者	iOS開発者
アナログ設計エンジニア	アナログ設計エンジニア
アーキビスト	アーキビスト
アーバンデザイナー	アーバンデザイナー
インテリア_デコレーター	インテリア デコレーター
ウェディングプランナー	ウェディングプランナー
ウェブ開発者	ウェブ開発者
カメラマン	カメラマン
ギャラリーディレクター	ギャラリーディレクター
グラフィックデザイナー	グラフィックデザイナー
コピーライター	コピーライター
コンピュータ修理技術者	コンピュータ修理技術者
スポーツコーチ	スポーツコーチ
ダンサー	ダンサー
デスクトップサポート技術者	デスクトップサポート技術者
テキスタイルデザイナー	テキスタイルデザイナー
テクニカルサポート担当者	テクニカルサポート担当者
テクニカルリクルーター	テクニカルリクルーター
ドッグトレーナー	ドッグトレーナー
トラック運転手	トラック運転手
トラベルエージェント	トラベルエージェント
ナニー	ナニー
ニュースアナウンサー	ニュースアナウンサー
ネットワークエンジニア	ネットワークエンジニア
ネットワークセキュリティ_アナリスト	ネットワークセキュリティ アナリスト
バーテンダー	バーテンダー
パン屋	パン屋
パーソナルフィットネストレーナー	パーソナルフィットネストレーナー
プライベート_エクイティ_アナリスト	プライベート エクイティ アナリスト
ファッションデザイナー	ファッションデザイナー
フォトグラファー	フォトグラファー
フォークリフト運転手	フォークリフト運転手
フロント_スーパーバイザー	フロント スーパーバイザー
ヘアスタイリスト	ヘアスタイリスト
ポートフォリオ_アナリスト	ポートフォリオ アナリスト
メイクアップアーティスト	メイクアップアーティスト
メディアバイヤー	メディアバイヤー
メディエーター	メディエーター
レジスタッフ	レジスタッフ
不動産業者	不動産業者
人材獲得	人材獲得
仕出し屋	仕出し屋
作曲家	作曲家
保険ブローカー	保険ブローカー
冶金学者	冶金学者
出版社	出版社
刑事	刑事
動画編集者	動画編集者
化学オペレーター	化学オペレーター
土木技術者	土木技術者
大工	大工
小学校教師	小学校教師
幼稚園の先生	幼稚園の先生
広報担当役員	広報担当役員
弁護士	弁護士
心理療法士	心理療法士
投資銀行アナリスト	投資銀行アナリスト
掘削エンジニア	掘削エンジニア
探査地質学者	探査地質学者
放射線技師	放射線技師
放送技術者	放送技術者
政策アドバイザー	政策アドバイザー
料理人	料理人
映画監督	映画監督
株式トレーダー	株式トレーダー
機械工学士	機械工学士
歌手	歌手
歯医者	歯医者
歴史の教授	歴史の教授
水文地質学者	水文地質学者
消防士	消防士
無線エンジニア	無線エンジニア
物流スペシャリスト	物流スペシャリスト
犬のトリマー	犬のトリマー
獣医	獣医
環境アーティスト	環境アーティスト
生物医学エンジニア	生物医学エンジニア
用務員	用務員
登録看護師	登録看護師
私立探偵	私立探偵
税理士	税理士
経営戦略コンサルタント	経営戦略コンサルタント
翻訳者	翻訳者
自動化エンジニア	自動化エンジニア
自動車エンジニア	自動車エンジニア
航空宇宙技術者	航空宇宙技術者
航空機パイロット	航空機パイロット
船員	船員
薬剤師	薬剤師
融資担当者	融資担当者
貿易マーケティングアナリスト	貿易マーケティングアナリスト
資金調達役	資金調達役
輸出入スペシャリスト	輸出入スペシャリスト
農学者	農学者
郵便配達員	郵便配達員
配管工	配管工
銀行員	銀行員
鍼灸師	鍼灸師
電気技術者	電気技術者
電気通信技術者	電気通信技術者
食品技術者	食品技術者
麻酔科医	麻酔科医
