Agente_esclusivo	Agente esclusivo
Allenatore	Allenatore
Assistant_Manager	Assistant Manager
Assistente_di_Progetto	Assistente di Progetto
Bagnino	Bagnino
Cantante_di_opera	Cantante di opera
Capitano	Capitano
Commerciante_d'arte	Commerciante d'arte
Coordinatore_risorse_umane	Coordinatore risorse umane
Designer_di_siti_internet	Designer di siti internet
Direttore_Operativo	Direttore Operativo
Direttore_del_casting	Direttore del casting
Direttore_del_reclutamento	Direttore del reclutamento
Direttore_della_filiale	Direttore della filiale
Direttore_dello_sviluppo_commerciale	Direttore dello sviluppo commerciale
Direttore_di_Market_Intelligence	Direttore di Market Intelligence
Direttore_esecutivo	Direttore esecutivo
Direttore_regionale_della_prevenzione_delle_perdite	Direttore regionale della prevenzione delle perdite
Editore_manageriale	Editore manageriale
Ingegnere_aeronautico	Ingegnere aeronautico
Ingegnere_del_Prodotto	Ingegnere del Prodotto
Ingegnere_interno	Ingegnere interno
Insegnante_delle_scuole_elementari	Insegnante delle scuole elementari
Istruttore_di_canto	Istruttore di canto
Manager_delle_Risorse_Umane	Manager delle Risorse Umane
Operatore_del_magazzino	Operatore del magazzino
Personale_commerciale	Personale commerciale
Pompiere	Pompiere
Process_Manager	Process Manager
Rappresentante_commerciale	Rappresentante commerciale
Rappresentante_del_Marketing	Rappresentante del Marketing
Rappresentante_del_Servizio_Clienti	Rappresentante del Servizio Clienti
Responsabile_Logistica	Responsabile Logistica
Scrittore_di_contenuti	Scrittore di contenuti
Segretario_legale	Segretario legale
Sistemista	Sistemista
Specialista_Servizio_Clienti	Specialista Servizio Clienti
Supervisore_per_la_gestione_della_casa	Supervisore per la gestione della casa
Ufficiale_capo_operazioni	Ufficiale capo operazioni
Visualizzatore	Visualizzatore
accompagnatore	accompagnatore
account_Manager	account Manager
acquirente_della_trasmissione	acquirente della trasmissione
acquisizione_del_talento_del_manager	acquisizione del talento del manager
addestratore_di_cani	addestratore di cani
addetta_spedizione_e_ricevimento	addetta spedizione e ricevimento
addetto_ai_materiali	addetto ai materiali
addetto_ai_mutui_ipotecari	addetto ai mutui ipotecari
addetto_ai_servizi_per_gli_ospiti	addetto ai servizi per gli ospiti
addetto_al_bar	addetto al bar
addetto_al_cibo	addetto al cibo
addetto_al_servizio_ospiti	addetto al servizio ospiti
addetto_all'amministrazione_del_credito	addetto all'amministrazione del credito
addetto_all'importazione	addetto all'importazione
addetto_alla_cassa	addetto alla cassa
addetto_alla_cortesia	addetto alla cortesia
addetto_alla_drogheria	addetto alla drogheria
addetto_alla_filiera	addetto alla filiera
addetto_alla_formazione_e_al_collocamento	addetto alla formazione e al collocamento
addetto_alla_posta	addetto alla posta
addetto_alla_raccolta_fondi	addetto alla raccolta fondi
addetto_alla_riscossione	addetto alla riscossione
addetto_alla_ristorazione	addetto alla ristorazione
addetto_alle_comunicazioni_aziendali	addetto alle comunicazioni aziendali
addetto_alle_comunicazioni_interne	addetto alle comunicazioni interne
addetto_alle_presenze	addetto alle presenze
addetto_alle_pulizie	addetto alle pulizie
addetto_alle_relazioni_con_gli_alunni	addetto alle relazioni con gli alunni
addetto_alle_relazioni_con_gli_investitori	addetto alle relazioni con gli investitori
addetto_alle_relazioni_con_gli_ospiti	addetto alle relazioni con gli ospiti
addetto_alle_relazioni_con_i_donatori	addetto alle relazioni con i donatori
addetto_alle_relazioni_con_i_media	addetto alle relazioni con i media
addetto_alle_relazioni_pubbliche	addetto alle relazioni pubbliche
addetto_alle_telecomunicazioni	addetto alle telecomunicazioni
addetto_alle_vendite	addetto alle vendite
addetto_alle_vendite_del_broker	addetto alle vendite del broker
addetto_alle_vendite_di_computer	addetto alle vendite di computer
addetto_alle_vendite_elettroniche	addetto alle vendite elettroniche
addetto_alle_vendite_part-time	addetto alle vendite part-time
addetto_alle_vendite_stagionali	addetto alle vendite stagionali
addetto_allo_sportello	addetto allo sportello
addetto_marketing_e_pubbliche_relazioni	addetto marketing e pubbliche relazioni
addetto_stampa	addetto stampa
agente_acquirenti	agente acquirenti
agente_assicurativo	agente assicurativo
agente_assicurativo_autorizzato	agente assicurativo autorizzato
agente_assicurativo_commerciale	agente assicurativo commerciale
agente_commerciale	agente commerciale
agente_del_titolo	agente del titolo
agente_delle_entrate	agente delle entrate
agente_delle_entrate_interne	agente delle entrate interne
agente_di_front_office	agente di front office
agente_di_noleggio	agente di noleggio
agente_di_polizia	agente di polizia
agente_di_polizia_di_riserva	agente di polizia di riserva
agente_di_prenotazione	agente di prenotazione
agente_di_prestito_immobiliare	agente di prestito immobiliare
agente_di_prestito_residenziale	agente di prestito residenziale
agente_di_riferimento	agente di riferimento
agente_di_servizio	agente di servizio
agente_di_trasporto	agente di trasporto
agente_di_vendita_agente_immobiliare	agente di vendita agente immobiliare
agente_di_vendita_autorizzato	agente di vendita autorizzato
agente_di_vendita_immobiliare	agente di vendita immobiliare
agente_di_vendita_prenotazioni	agente di vendita prenotazioni
agente_di_viaggio_aziendale	agente di viaggio aziendale
agente_federale	agente federale
agente_immobiliare	agente immobiliare
agente_immobiliare_associato_autorizzato	agente immobiliare associato autorizzato
agente_immobiliare_autorizzato	agente immobiliare autorizzato
agente_immobiliare_commerciale	agente immobiliare commerciale
agente_immobiliare_professionale	agente immobiliare professionale
agente_immobiliare_residenziale	agente immobiliare residenziale
agente_ipotecario	agente ipotecario
agente_logistico	agente logistico
agente_marittimo	agente marittimo
agente_speciale	agente speciale
agente_speciale_di_vigilanza	agente speciale di vigilanza
agopuntore_abilitato	agopuntore abilitato
aiuto_cuoco	aiuto cuoco
allenatore_delle_prestazioni	allenatore delle prestazioni
allenatore_di_alfabetizzazione	allenatore di alfabetizzazione
allenatore_di_calcio	allenatore di calcio
allenatore_di_fitness	allenatore di fitness
allenatore_di_forza_e_condizionamento	allenatore di forza e condizionamento
allenatore_di_lettura	allenatore di lettura
allenatore_di_nuoto	allenatore di nuoto
allenatore_di_tecnologia	allenatore di tecnologia
allenatore_di_tennis	allenatore di tennis
allenatore_di_zona	allenatore di zona
allenatore_didattico	allenatore didattico
allenatore_esecutivo	allenatore esecutivo
allenatore_personale	allenatore personale
allevatore	allevatore
alto_funzionario_esecutivo	alto funzionario esecutivo
ambasciatore_delle_ammissioni	ambasciatore delle ammissioni
amministratore_dei_conti_fornitori	amministratore dei conti fornitori
amministratore_del_personale	amministratore del personale
amministratore_del_server	amministratore del server
amministratore_del_service_desk	amministratore del service desk
amministratore_delegato	amministratore delegato
amministratore_dell'helpdesk	amministratore dell'helpdesk
amministratore_della_logistica	amministratore della logistica
amministratore_della_sicurezza	amministratore della sicurezza
amministratore_della_sicurezza_dei_dati	amministratore della sicurezza dei dati
amministratore_della_sicurezza_delle_informazioni	amministratore della sicurezza delle informazioni
amministratore_della_sicurezza_di_rete	amministratore della sicurezza di rete
amministratore_desktop	amministratore desktop
amministratore_di_datacenter	amministratore di datacenter
amministratore_di_internet	amministratore di internet
amministratore_di_rete	amministratore di rete
amministratore_di_rete_del_sistema	amministratore di rete del sistema
amministratore_di_rete_locale	amministratore di rete locale
amministratore_di_scambio	amministratore di scambio
amministratore_di_sistema	amministratore di sistema
amministratore_di_sistema_Microsoft	amministratore di sistema Microsoft
amministratore_fiscale	amministratore fiscale
analista_amministrativo	analista amministrativo
analista_azionario	analista azionario
analista_bancario_aziendale	analista bancario aziendale
analista_centro_servizi	analista centro servizi
analista_commerciale	analista commerciale
analista_del_centro_di_supporto	analista del centro di supporto
analista_del_credito	analista del credito
analista_del_credito_aziendale	analista del credito aziendale
analista_del_mercato_dei_capitali	analista del mercato dei capitali
analista_del_mercato_finanziario	analista del mercato finanziario
analista_del_reclutamento	analista del reclutamento
analista_del_reddito_fisso	analista del reddito fisso
analista_del_sistema_informativo_del_personale	analista del sistema informativo del personale
analista_del_sistema_informativo_hr	analista del sistema informativo hr
analista_del_sistema_operativo	analista del sistema operativo
analista_del_supporto_dell'helpdesk	analista del supporto dell'helpdesk
analista_del_supporto_desktop	analista del supporto desktop
analista_del_supporto_di_rete	analista del supporto di rete
analista_del_supporto_software	analista del supporto software
analista_del_supporto_tecnico	analista del supporto tecnico
analista_del_supporto_tecnologico	analista del supporto tecnologico
analista_dell'assistenza_clienti	analista dell'assistenza clienti
analista_dell'helpdesk	analista dell'helpdesk
analista_della_performance_degli_investimenti	analista della performance degli investimenti
analista_della_sicurezza_delle_informazioni	analista della sicurezza delle informazioni
analista_della_sicurezza_di_rete	analista della sicurezza di rete
analista_delle_operazioni_di_rete	analista delle operazioni di rete
analista_dello_stress	analista dello stress
analista_di_affari	analista di affari
analista_di_banca_privata	analista di banca privata
analista_di_banche_d'affari	analista di banche d'affari
analista_di_capitale_di_rischio	analista di capitale di rischio
analista_di_centri_operativi_di_rete	analista di centri operativi di rete
analista_di_contenuti	analista di contenuti
analista_di_datacenter	analista di datacenter
analista_di_dati_di_mercato	analista di dati di mercato
analista_di_finanza_aziendale	analista di finanza aziendale
analista_di_finanza_strutturata	analista di finanza strutturata
analista_di_finanziamento	analista di finanziamento
analista_di_fondi	analista di fondi
analista_di_fondi_comuni	analista di fondi comuni
analista_di_gestione_del_portafoglio	analista di gestione del portafoglio
analista_di_hedge_fund	analista di hedge fund
analista_di_importazione	analista di importazione
analista_di_informazioni_di_mercato	analista di informazioni di mercato
analista_di_investimenti	analista di investimenti
analista_di_marca	analista di marca
analista_di_marketing	analista di marketing
analista_di_marketing_di_prodotto	analista di marketing di prodotto
analista_di_materie_prime	analista di materie prime
analista_di_pianificazione_strategica	analista di pianificazione strategica
analista_di_private_banking	analista di private banking
analista_di_private_equity	analista di private equity
analista_di_programmazione	analista di programmazione
analista_di_rating	analista di rating
analista_di_rete	analista di rete
analista_di_ricerca_azionaria	analista di ricerca azionaria
analista_di_ricerca_sugli_investimenti	analista di ricerca sugli investimenti
analista_di_ricerca_sul_credito	analista di ricerca sul credito
analista_di_ricerche_di_mercato	analista di ricerche di mercato
analista_di_sistema	analista di sistema
analista_di_sistemi_di_consulenza	analista di sistemi di consulenza
analista_di_sistemi_informativi	analista di sistemi informativi
analista_di_software	analista di software
analista_di_supporto_al_contenzioso	analista di supporto al contenzioso
analista_di_supporto_di_seconda_linea	analista di supporto di seconda linea
analista_di_supporto_informatico	analista di supporto informatico
analista_di_supporto_sul_campo	analista di supporto sul campo
analista_di_sviluppo_aziendale	analista di sviluppo aziendale
analista_di_sviluppo_software	analista di sviluppo software
analista_di_test_di_automazione	analista di test di automazione
analista_di_transazione	analista di transazione
analista_di_valutazione	analista di valutazione
analista_estivo_di_banche_d'affari	analista estivo di banche d'affari
analista_finanziario	analista finanziario
analista_finanziario_con_leva_finanziaria	analista finanziario con leva finanziaria
analista_finanziario_professionista	analista finanziario professionista
analista_fiscale	analista fiscale
analista_immobiliare	analista immobiliare
analista_import_ed_export	analista import ed export
analista_logistico	analista logistico
analista_politico	analista politico
analista_tecnologico	analista tecnologico
ancora	ancora
ancora_sportiva	ancora sportiva
anestesista_del_personale	anestesista del personale
animatore	animatore
animatore_di_personaggi	animatore di personaggi
animatore_di_personaggi_3d	animatore di personaggi 3d
animatore_flash	animatore flash
animatore_informatico	animatore informatico
animatore_tecnico	animatore tecnico
annunciatore_di_indirizzo_pubblico	annunciatore di indirizzo pubblico
annunciatore_in_onda	annunciatore in onda
appaltatore_generale	appaltatore generale
arbitro	arbitro
architetto	architetto
architetto_Java	architetto Java
architetto_di_design	architetto di design
architetto_di_rete	architetto di rete
architetto_intermedio	architetto intermedio
architetto_laureato	architetto laureato
architetto_paesaggista	architetto paesaggista
architetto_tecnico	architetto tecnico
architetto_tecnologico	architetto tecnologico
archivista_di_progetto	archivista di progetto
aromatizzante	aromatizzante
arredatore	arredatore
arredatore_d'interni	arredatore d'interni
arteterapeuta	arteterapeuta
artista	artista
artista_3d	artista 3d
artista_concettuale	artista concettuale
artista_creativo	artista creativo
artista_degli_effetti_visivi	artista degli effetti visivi
artista_del_gioco	artista del gioco
artista_del_layout	artista del layout
artista_del_personaggio	artista del personaggio
artista_dell'ambiente_3d	artista dell'ambiente 3d
artista_dell'animazione	artista dell'animazione
artista_della_fiamma	artista della fiamma
artista_della_pittura	artista della pittura
artista_della_produzione_grafica	artista della produzione grafica
artista_della_registrazione	artista della registrazione
artista_delle_texture	artista delle texture
artista_dello_sviluppo_visivo	artista dello sviluppo visivo
artista_di_produzione	artista di produzione
artista_grafico	artista grafico
artista_grafico_informatico	artista grafico informatico
artista_in_residenza	artista in residenza
artista_in_studio	artista in studio
artista_ospite	artista ospite
artista_performativo	artista performativo
artista_professionista	artista professionista
artista_residente	artista residente
artista_tecnico	artista tecnico
artista_visuale	artista visuale
ascoltatore_notturno	ascoltatore notturno
assicuratore	assicuratore
assistente_al_direttore_generale	assistente al direttore generale
assistente_al_montaggio_video	assistente al montaggio video
assistente_al_reclutamento	assistente al reclutamento
assistente_all'infanzia	assistente all'infanzia
assistente_all'organizzazione_di_eventi	assistente all'organizzazione di eventi
assistente_alla_produzione_d'ufficio	assistente alla produzione d'ufficio
assistente_alla_progettazione	assistente alla progettazione
assistente_alla_redazione	assistente alla redazione
assistente_alla_sottoscrizione	assistente alla sottoscrizione
assistente_alla_telecamera	assistente alla telecamera
assistente_alla_trasmissione	assistente alla trasmissione
assistente_alle_pubblicazioni	assistente alle pubblicazioni
assistente_alle_relazioni_con_la_comunità	assistente alle relazioni con la comunità
assistente_alle_telecomunicazioni	assistente alle telecomunicazioni
assistente_alle_vendite_al_dettaglio	assistente alle vendite al dettaglio
assistente_alle_vendite_locali	assistente alle vendite locali
assistente_allenatore_di_calcio	assistente allenatore di calcio
assistente_allenatore_di_forza_e_condizionamento	assistente allenatore di forza e condizionamento
assistente_allo_sviluppo_del_prodotto	assistente allo sviluppo del prodotto
assistente_analista_di_sistema	assistente analista di sistema
assistente_animatore	assistente animatore
assistente_architetto	assistente architetto
assistente_architettonico	assistente architettonico
assistente_archivi	assistente archivi
assistente_archivista	assistente archivista
assistente_articolato	assistente articolato
assistente_asilo_nido	assistente asilo nido
assistente_avvocato	assistente avvocato
assistente_banchiere_privato	assistente banchiere privato
assistente_broker	assistente broker
assistente_capo_cantiere	assistente capo cantiere
assistente_capo_cucina	assistente capo cucina
assistente_capo_dei_vigili_del_fuoco	assistente capo dei vigili del fuoco
assistente_capo_pilota	assistente capo pilota
assistente_capo_terminal	assistente capo terminal
assistente_commerciale	assistente commerciale
assistente_consigliere_generale	assistente consigliere generale
assistente_contabile_di_gestione	assistente contabile di gestione
assistente_cuoco	assistente cuoco
assistente_del_canile	assistente del canile
assistente_del_frontend_manager	assistente del frontend manager
assistente_dell'insegnante	assistente dell'insegnante
assistente_dentale_registrato	assistente dentale registrato
assistente_di_banca_privata	assistente di banca privata
assistente_di_classe	assistente di classe
assistente_di_conferenza	assistente di conferenza
assistente_di_contenzioso	assistente di contenzioso
assistente_di_cucina	assistente di cucina
assistente_di_deposito_a_garanzia	assistente di deposito a garanzia
assistente_di_educazione_speciale	assistente di educazione speciale
assistente_di_galleria	assistente di galleria
assistente_di_moda	assistente di moda
assistente_di_prestito_commerciale	assistente di prestito commerciale
assistente_di_reclutamento_delle_ore	assistente di reclutamento delle ore
assistente_di_volo	assistente di volo
assistente_di_volo_aziendale	assistente di volo aziendale
assistente_didattico	assistente didattico
assistente_didattico_di_educazione_speciale	assistente didattico di educazione speciale
assistente_difensore_pubblico	assistente difensore pubblico
assistente_editore	assistente editore
assistente_editoriale	assistente editoriale
assistente_food_and_beverage_manager	assistente food and beverage manager
assistente_fotografi	assistente fotografi
assistente_fotografo	assistente fotografo
assistente_gestore_degli_investimenti	assistente gestore degli investimenti
assistente_gestore_del_bar	assistente gestore del bar
assistente_gestore_del_fondo	assistente gestore del fondo
assistente_gestore_di_portafoglio	assistente gestore di portafoglio
assistente_giudiziario	assistente giudiziario
assistente_grafico	assistente grafico
assistente_infermieristico_certificato	assistente infermieristico certificato
assistente_ingegnere_cittadino	assistente ingegnere cittadino
assistente_ingegnere_meccanico	assistente ingegnere meccanico
assistente_insegnante_di_scuola_materna	assistente insegnante di scuola materna
assistente_legale	assistente legale
assistente_legale_aziendale	assistente legale aziendale
assistente_logistico	assistente logistico
assistente_marketing_commerciale	assistente marketing commerciale
assistente_medico	assistente medico
assistente_notturno	assistente notturno
assistente_pasticcere	assistente pasticcere
assistente_per_l'importazione_e_l'esportazione	assistente per l'importazione e l'esportazione
assistente_per_l'infanzia	assistente per l'infanzia
assistente_personale_del_direttore_generale	assistente personale del direttore generale
assistente_personale_legale	assistente personale legale
assistente_pianificatore	assistente pianificatore
assistente_post_produzione	assistente post produzione
assistente_principale	assistente principale
assistente_procuratore_distrettuale	assistente procuratore distrettuale
assistente_produttore	assistente produttore
assistente_professore	assistente professore
assistente_professore_di_diritto	assistente professore di diritto
assistente_professore_di_educazione	assistente professore di educazione
assistente_professore_di_filosofia	assistente professore di filosofia
assistente_professore_di_inglese	assistente professore di inglese
assistente_professore_di_management	assistente professore di management
assistente_professore_di_medicina	assistente professore di medicina
assistente_professore_di_storia	assistente professore di storia
assistente_professore_in_visita	assistente professore in visita
assistente_progettista	assistente progettista
assistente_progettista_tecnico	assistente progettista tecnico
assistente_psicologico	assistente psicologico
assistente_responsabile_comunicazione_aziendale	assistente responsabile comunicazione aziendale
assistente_responsabile_dei_contenuti	assistente responsabile dei contenuti
assistente_responsabile_dei_servizi_per_gli_ospiti	assistente responsabile dei servizi per gli ospiti
assistente_responsabile_del_front_office	assistente responsabile del front office
assistente_responsabile_del_marchio	assistente responsabile del marchio
assistente_responsabile_del_mercato	assistente responsabile del mercato
assistente_responsabile_del_punto_vendita	assistente responsabile del punto vendita
assistente_responsabile_della_posizione	assistente responsabile della posizione
assistente_responsabile_della_reception	assistente responsabile della reception
assistente_responsabile_della_ristorazione	assistente responsabile della ristorazione
assistente_responsabile_delle_entrate	assistente responsabile delle entrate
assistente_responsabile_delle_prenotazioni	assistente responsabile delle prenotazioni
assistente_responsabile_delle_pulizie	assistente responsabile delle pulizie
assistente_responsabile_delle_relazioni	assistente responsabile delle relazioni
assistente_ricercatore	assistente ricercatore
assistente_sanitario	assistente sanitario
assistente_segretario_aziendale	assistente segretario aziendale
assistente_sociale	assistente sociale
assistente_sociale_clinico	assistente sociale clinico
assistente_sociale_clinico_abilitato	assistente sociale clinico abilitato
assistente_tecnico_residente	assistente tecnico residente
assistente_veterinario	assistente veterinario
assistente_vicedirettore_dell'account	assistente vicedirettore dell'account
assistente_vp	assistente vp
assistente_vp_di_sottoscrizione	assistente vp di sottoscrizione
assistente_vp_sviluppo_aziendale	assistente vp sviluppo aziendale
associato_agente_immobiliare	associato agente immobiliare
associato_ai_servizi_per_i_membri	associato ai servizi per i membri
associato_dei_reclami	associato dei reclami
associato_di_banca_d'affari	associato di banca d'affari
associato_di_portafoglio	associato di portafoglio
associato_di_ricerca_di_equità	associato di ricerca di equità
associato_di_trasmissione	associato di trasmissione
associato_vettore_rurale	associato vettore rurale
atleta_professionista	atleta professionista
attore_professionista	attore professionista
autista	autista
autista_aziendale	autista aziendale
autista_professionista	autista professionista
aviatore	aviatore
avvocato	avvocato
avvocato_aziendale	avvocato aziendale
avvocato_commerciale	avvocato commerciale
avvocato_del_lavoro_e_del_lavoro	avvocato del lavoro e del lavoro
avvocato_del_tribunale	avvocato del tribunale
avvocato_di_famiglia	avvocato di famiglia
avvocato_di_proprietà_intellettuale	avvocato di proprietà intellettuale
avvocato_difensore_penale	avvocato difensore penale
avvocato_dirigente	avvocato dirigente
avvocato_fiscale	avvocato fiscale
avvocato_immobiliare	avvocato immobiliare
avvocato_internazionale	avvocato internazionale
avvocato_processuale	avvocato processuale
avvocato_tributario	avvocato tributario
azionista	azionista
baby-sitter	baby-sitter
badante_di_animali_domestici	badante di animali domestici
ballerino_professionista	ballerino professionista
banchiere_commerciale	banchiere commerciale
banchiere_di_relazione	banchiere di relazione
banchiere_ipotecario	banchiere ipotecario
banchiere_preferito	banchiere preferito
banchiere_privato_di_mutui	banchiere privato di mutui
banchiere_universale	banchiere universale
banditore	banditore
barbiere	barbiere
barista	barista
bassista	bassista
batterista	batterista
bene_ingegnere	bene ingegnere
bibliotecario	bibliotecario
bibliotecario_aziendale	bibliotecario aziendale
bibliotecario_dei_servizi_pubblici	bibliotecario dei servizi pubblici
bibliotecario_di_ricerca	bibliotecario di ricerca
bibliotecario_multimediale	bibliotecario multimediale
bibliotecario_universitario	bibliotecario universitario
bigliettaio	bigliettaio
blogger	blogger
borsista_di_cardiologia	borsista di cardiologia
broker	broker
broker_di_affiliazione	broker di affiliazione
broker_di_derivati	broker di derivati
broker_di_derivati_azionari	broker di derivati azionari
broker_di_futures	broker di futures
broker_ipotecario_autorizzato	broker ipotecario autorizzato
calciatore	calciatore
calciatore_professionista	calciatore professionista
cameraman	cameraman
cameraman_delle_luci	cameraman delle luci
cameriera_di_cocktail	cameriera di cocktail
cameriere	cameriere
campione_del_prodotto	campione del prodotto
cancelliere	cancelliere
cancelliere_universitario	cancelliere universitario
candidato_mba	candidato mba
cantante	cantante
cantante_professionista	cantante professionista
cantautore	cantautore
capitale_fiscale	capitale fiscale
capitano_dei_vigili_del_fuoco	capitano dei vigili del fuoco
capitano_del_banchetto	capitano del banchetto
capitano_della_compagnia_aerea	capitano della compagnia aerea
capitano_di_addestramento	capitano di addestramento
capitano_di_polizia	capitano di polizia
capo_allenatore	capo allenatore
capo_allenatore_di_calcio	capo allenatore di calcio
capo_assistente	capo assistente
capo_barista	capo barista
capo_battaglione	capo battaglione
capo_bibliotecario	capo bibliotecario
capo_cameriere	capo cameriere
capo_cantiere	capo cantiere
capo_cassiere	capo cassiere
capo_commerciante	capo commerciante
capo_consulente_legale	capo consulente legale
capo_curatore	capo curatore
capo_degli_affari_legali	capo degli affari legali
capo_degli_investimenti	capo degli investimenti
capo_dei_prestiti	capo dei prestiti
capo_dei_vigili_del_fuoco	capo dei vigili del fuoco
capo_del_commercio	capo del commercio
capo_del_contenuto	capo del contenuto
capo_del_corporate_banking	capo del corporate banking
capo_del_dipartimento_di_logistica	capo del dipartimento di logistica
capo_del_dipartimento_di_progettazione	capo del dipartimento di progettazione
capo_del_dipartimento_di_pubbliche_relazioni	capo del dipartimento di pubbliche relazioni
capo_del_private_banking	capo del private banking
capo_del_reclutamento	capo del reclutamento
capo_del_settore_immobiliare	capo del settore immobiliare
capo_del_team_Java	capo del team Java
capo_del_team_del_centro_operativo_di_rete	capo del team del centro operativo di rete
capo_del_team_di_distribuzione	capo del team di distribuzione
capo_del_team_di_ingegnere_del_software	capo del team di ingegnere del software
capo_del_turno	capo del turno
capo_dell'ufficio_crediti	capo dell'ufficio crediti
capo_dell'ufficio_legale	capo dell'ufficio legale
capo_della_distribuzione	capo della distribuzione
capo_della_finanza_aziendale	capo della finanza aziendale
capo_della_finanza_di_progetto	capo della finanza di progetto
capo_della_gestione_dei_talenti	capo della gestione dei talenti
capo_della_gestione_patrimoniale	capo della gestione patrimoniale
capo_della_logistica	capo della logistica
capo_della_politica	capo della politica
capo_della_polizia	capo della polizia
capo_della_pubblicità	capo della pubblicità
capo_della_ricerca_sull'equità	capo della ricerca sull'equità
capo_della_segreteria_legale_e_aziendale	capo della segreteria legale e aziendale
capo_della_squadra	capo della squadra
capo_delle_assicurazioni	capo delle assicurazioni
capo_delle_istituzioni_finanziarie	capo delle istituzioni finanziarie
capo_delle_operazioni_di_rete	capo delle operazioni di rete
capo_delle_ore	capo delle ore
capo_delle_risorse	capo delle risorse
capo_dentista	capo dentista
capo_geologo	capo geologo
capo_giornalista	capo giornalista
capo_ingegnere_informatico	capo ingegnere informatico
capo_ingegnere_meccanico	capo ingegnere meccanico
capo_istruttore	capo istruttore
capo_istruttore_di_volo	capo istruttore di volo
capo_legale	capo legale
capo_pilota	capo pilota
capo_progettista	capo progettista
capo_progetto	capo progetto
capo_psicologo	capo psicologo
capo_residente	capo residente
capo_server	capo server
capo_squadra_agente_immobiliare	capo squadra agente immobiliare
capo_ufficio_assicurativo	capo ufficio assicurativo
capo_ufficio_centrale	capo ufficio centrale
capocuoco	capocuoco
capogruppo_delle_hr	capogruppo delle hr
capogruppo_media	capogruppo media
caporale	caporale
caporedattore	caporedattore
caposquadra	caposquadra
caposquadra_edile	caposquadra edile
cardiologo	cardiologo
caricatore	caricatore
cassiere	cassiere
cassiere_di_banca	cassiere di banca
catalogatore	catalogatore
cavo_del_modulo	cavo del modulo
cedente_di_mutuo_ipotecario	cedente di mutuo ipotecario
chef	chef
chef_aziendale	chef aziendale
chef_del_ristorante	chef del ristorante
chef_della_ristorazione	chef della ristorazione
chef_di_festa	chef di festa
chef_di_linea	chef di linea
chef_esecutivo_aziendale	chef esecutivo aziendale
chef_pasticcere_esecutivo	chef pasticcere esecutivo
chef_per_banchetti	chef per banchetti
chef_personale	chef personale
chef_privato	chef privato
chirurgo	chirurgo
chirurgo_orale_e_maxillo-facciale	chirurgo orale e maxillo-facciale
chirurgo_veterinario	chirurgo veterinario
chitarrista	chitarrista
clown	clown
collaboratore	collaboratore
collaboratore_al_dettaglio	collaboratore al dettaglio
collaboratore_allo_sviluppo_del_prodotto	collaboratore allo sviluppo del prodotto
collaboratore_contabile	collaboratore contabile
collaboratore_dei_media	collaboratore dei media
collaboratore_del_negozio_di_articoli_da_regalo	collaboratore del negozio di articoli da regalo
collaboratore_del_rapporto_con_il_cliente	collaboratore del rapporto con il cliente
collaboratore_del_supporto_tecnico	collaboratore del supporto tecnico
collaboratore_del_tesoro	collaboratore del tesoro
collaboratore_della_galleria	collaboratore della galleria
collaboratore_di_architettura	collaboratore di architettura
collaboratore_di_camerino	collaboratore di camerino
collaboratore_di_casting	collaboratore di casting
collaboratore_di_collezioni	collaboratore di collezioni
collaboratore_di_contenzioso	collaboratore di contenzioso
collaboratore_di_front_office	collaboratore di front office
collaboratore_di_gestione_del_rischio	collaboratore di gestione del rischio
collaboratore_di_magazzino	collaboratore di magazzino
collaboratore_di_mutui	collaboratore di mutui
collaboratore_di_pubbliche_relazioni	collaboratore di pubbliche relazioni
collaboratore_di_reclutamento	collaboratore di reclutamento
collaboratore_di_servizi_finanziari	collaboratore di servizi finanziari
collaboratore_di_sviluppo_aziendale	collaboratore di sviluppo aziendale
collaboratore_di_valutazione	collaboratore di valutazione
collaboratore_fiscale	collaboratore fiscale
collaboratore_immobiliare	collaboratore immobiliare
collaboratore_legale	collaboratore legale
collaboratore_logistico	collaboratore logistico
collaboratore_marketing_e_comunicazione	collaboratore marketing e comunicazione
collaboratore_per_la_cura_degli_animali	collaboratore per la cura degli animali
collaboratore_straniero	collaboratore straniero
collaboratore_temporaneo	collaboratore temporaneo
collegamento_clinico	collegamento clinico
collegamento_con_la_scienza_medica	collegamento con la scienza medica
collegamento_infermiere	collegamento infermiere
commercialista	commercialista
commercialista_del_personale	commercialista del personale
commercialista_delle_imposte_sui_salari	commercialista delle imposte sui salari
commerciante	commerciante
commerciante_a_reddito_fisso	commerciante a reddito fisso
commerciante_al_dettaglio	commerciante al dettaglio
commerciante_di_azioni	commerciante di azioni
commerciante_di_derivati	commerciante di derivati
commerciante_di_futures	commerciante di futures
commerciante_di_opzioni	commerciante di opzioni
commerciante_di_opzioni_su_azioni	commerciante di opzioni su azioni
commerciante_di_valuta	commerciante di valuta
commerciante_di_vendita	commerciante di vendita
commerciante_di_vendita_istituzionale	commerciante di vendita istituzionale
commerciante_in_linea	commerciante in linea
commerciante_proprietario	commerciante proprietario
compagno	compagno
compositore	compositore
compositore_di_film	compositore di film
compositore_di_musica	compositore di musica
comunicazioni_strategiche	comunicazioni strategiche
concierge	concierge
conducente_della_strada	conducente della strada
conduttore_dello_spettacolo_mattutino	conduttore dello spettacolo mattutino
conduttore_di_notizie_del_mattino	conduttore di notizie del mattino
conduttore_di_spettacoli_mattutini	conduttore di spettacoli mattutini
conduttore_di_talk_show	conduttore di talk show
conduttore_di_talk_show_radiofonici	conduttore di talk show radiofonici
consigliere_del_campo_diurno	consigliere del campo diurno
consigliere_delegato	consigliere delegato
consigliere_di_facoltà	consigliere di facoltà
consigliere_di_scuola_elementare	consigliere di scuola elementare
consigliere_di_sensibilizzazione	consigliere di sensibilizzazione
consigliere_di_viaggio	consigliere di viaggio
consigliere_per_campi_estivi	consigliere per campi estivi
consigliere_regionale	consigliere regionale
consiglio	consiglio
consiglio_del_personale	consiglio del personale
consiglio_direttivo	consiglio direttivo
consiglio_speciale	consiglio speciale
consulente	consulente
consulente_IT	consulente IT
consulente_abbronzante	consulente abbronzante
consulente_assicurativo	consulente assicurativo
consulente_bancario_personale	consulente bancario personale
consulente_clinico	consulente clinico
consulente_d'arredo	consulente d'arredo
consulente_d'arte	consulente d'arte
consulente_del_personale	consulente del personale
consulente_delle_ore	consulente delle ore
consulente_di_bellezza	consulente di bellezza
consulente_di_collocamento	consulente di collocamento
consulente_di_comunicazione	consulente di comunicazione
consulente_di_contenzioso	consulente di contenzioso
consulente_di_fitness	consulente di fitness
consulente_di_gestione	consulente di gestione
consulente_di_gestione_aziendale	consulente di gestione aziendale
consulente_di_impresa	consulente di impresa
consulente_di_ingegneria_di_rete	consulente di ingegneria di rete
consulente_di_ingegneria_meccanica	consulente di ingegneria meccanica
consulente_di_marketing	consulente di marketing
consulente_di_moda	consulente di moda
consulente_di_mutuo_per_la_casa	consulente di mutuo per la casa
consulente_di_perforazione	consulente di perforazione
consulente_di_processo	consulente di processo
consulente_di_reclutamento	consulente di reclutamento
consulente_di_rete	consulente di rete
consulente_di_rete_dati	consulente di rete dati
consulente_di_ricerca	consulente di ricerca
consulente_di_social_media_marketing	consulente di social media marketing
consulente_di_sottoscrizione	consulente di sottoscrizione
consulente_di_stile	consulente di stile
consulente_di_viaggi_internazionali	consulente di viaggi internazionali
consulente_editoriale	consulente editoriale
consulente_educativo	consulente educativo
consulente_esterno	consulente esterno
consulente_familiare	consulente familiare
consulente_fiscale_aziendale	consulente fiscale aziendale
consulente_fiscale_principale	consulente fiscale principale
consulente_grafico	consulente grafico
consulente_immobiliare	consulente immobiliare
consulente_immobiliare_commerciale	consulente immobiliare commerciale
consulente_java	consulente java
consulente_legale	consulente legale
consulente_legale_aziendale	consulente legale aziendale
consulente_legale_di_gruppo	consulente legale di gruppo
consulente_legale_estero	consulente legale estero
consulente_legale_per_le_assunzioni	consulente legale per le assunzioni
consulente_linguistico	consulente linguistico
consulente_logistico	consulente logistico
consulente_marittimo	consulente marittimo
consulente_marketing_e_pubbliche_relazioni	consulente marketing e pubbliche relazioni
consulente_matrimoniale	consulente matrimoniale
consulente_musicale	consulente musicale
consulente_mutuo_casa	consulente mutuo casa
consulente_normativo	consulente normativo
consulente_per_eventi	consulente per eventi
consulente_per_l'acquisizione_di_talenti	consulente per l'acquisizione di talenti
consulente_per_l'adesione	consulente per l'adesione
consulente_per_l'automazione	consulente per l'automazione
consulente_per_l'automazione_dei_test	consulente per l'automazione dei test
consulente_per_la_gestione_dei_talenti	consulente per la gestione dei talenti
consulente_per_la_progettazione_del_prodotto	consulente per la progettazione del prodotto
consulente_per_la_progettazione_di_reti	consulente per la progettazione di reti
consulente_per_la_raccolta_fondi	consulente per la raccolta fondi
consulente_per_la_ricerca_esecutiva	consulente per la ricerca esecutiva
consulente_per_la_salute_mentale	consulente per la salute mentale
consulente_per_la_salute_mentale_abilitato	consulente per la salute mentale abilitato
consulente_per_la_sicurezza_della_rete	consulente per la sicurezza della rete
consulente_per_le_assunzioni_a_tempo_indeterminato	consulente per le assunzioni a tempo indeterminato
consulente_per_le_pubbliche_relazioni	consulente per le pubbliche relazioni
consulente_per_le_pubbliche_relazioni_e_la_comunicazione	consulente per le pubbliche relazioni e la comunicazione
consulente_per_le_telecomunicazioni	consulente per le telecomunicazioni
consulente_per_lo_studio_all'estero	consulente per lo studio all'estero
consulente_per_lo_sviluppo_aziendale	consulente per lo sviluppo aziendale
consulente_per_lo_sviluppo_del_business_internazionale	consulente per lo sviluppo del business internazionale
consulente_per_lo_sviluppo_dell'organizzazione	consulente per lo sviluppo dell'organizzazione
consulente_per_lo_sviluppo_della_leadership	consulente per lo sviluppo della leadership
consulente_professionale_abilitato	consulente professionale abilitato
consulente_professionale_clinico_abilitato	consulente professionale clinico abilitato
consulente_software	consulente software
consulente_strategico	consulente strategico
consulente_strategico_aziendale	consulente strategico aziendale
consulente_wireless	consulente wireless
consulenza_aziendale	consulenza aziendale
contabile	contabile
contabile_pagamenti	contabile pagamenti
contraente	contraente
controllore_del_prodotto	controllore del prodotto
controllore_del_rischio	controllore del rischio
controllore_della_trasmissione	controllore della trasmissione
controllore_logistico	controllore logistico
coordinatore_atletico	coordinatore atletico
coordinatore_commerciale	coordinatore commerciale
coordinatore_dei_partenariati	coordinatore dei partenariati
coordinatore_dei_prezzi	coordinatore dei prezzi
coordinatore_dei_servizi_congressuali	coordinatore dei servizi congressuali
coordinatore_dei_servizi_di_marketing	coordinatore dei servizi di marketing
coordinatore_dei_servizi_per_gli_ospiti	coordinatore dei servizi per gli ospiti
coordinatore_del_banchetto	coordinatore del banchetto
coordinatore_del_collocamento_degli_studenti	coordinatore del collocamento degli studenti
coordinatore_del_convegno	coordinatore del convegno
coordinatore_del_corso_di_laurea	coordinatore del corso di laurea
coordinatore_del_dipartimento_artistico	coordinatore del dipartimento artistico
coordinatore_del_marketing_commerciale	coordinatore del marketing commerciale
coordinatore_del_miglioramento_delle_prestazioni	coordinatore del miglioramento delle prestazioni
coordinatore_del_prestito	coordinatore del prestito
coordinatore_del_programma_accademico	coordinatore del programma accademico
coordinatore_del_reclutamento_delle_hr	coordinatore del reclutamento delle hr
coordinatore_del_salone	coordinatore del salone
coordinatore_del_servizio_di_campo	coordinatore del servizio di campo
coordinatore_del_supporto_tecnico	coordinatore del supporto tecnico
coordinatore_dell'automazione	coordinatore dell'automazione
coordinatore_dell'helpdesk	coordinatore dell'helpdesk
coordinatore_dell'importazione	coordinatore dell'importazione
coordinatore_dell'ospitalità	coordinatore dell'ospitalità
coordinatore_della_comunicazione	coordinatore della comunicazione
coordinatore_della_comunicazione_aziendale	coordinatore della comunicazione aziendale
coordinatore_della_comunicazione_interna	coordinatore della comunicazione interna
coordinatore_della_galleria	coordinatore della galleria
coordinatore_della_logistica_internazionale	coordinatore della logistica internazionale
coordinatore_della_moda	coordinatore della moda
coordinatore_della_post_produzione	coordinatore della post produzione
coordinatore_della_prestampa	coordinatore della prestampa
coordinatore_della_produzione_di_stampa	coordinatore della produzione di stampa
coordinatore_della_produzione_pubblicitaria	coordinatore della produzione pubblicitaria
coordinatore_della_progettazione	coordinatore della progettazione
coordinatore_della_raccolta_fondi	coordinatore della raccolta fondi
coordinatore_della_ricerca_clinica	coordinatore della ricerca clinica
coordinatore_della_ricerca_clinica_certificato	coordinatore della ricerca clinica certificato
coordinatore_della_ristorazione	coordinatore della ristorazione
coordinatore_della_traduzione	coordinatore della traduzione
coordinatore_della_transizione	coordinatore della transizione
coordinatore_della_trasmissione	coordinatore della trasmissione
coordinatore_delle_prenotazioni	coordinatore delle prenotazioni
coordinatore_delle_prenotazioni_di_gruppo	coordinatore delle prenotazioni di gruppo
coordinatore_delle_pubbliche_relazioni	coordinatore delle pubbliche relazioni
coordinatore_delle_pubbliche_relazioni_e_della_comunicazione	coordinatore delle pubbliche relazioni e della comunicazione
coordinatore_delle_relazioni_con_gli_ospiti	coordinatore delle relazioni con gli ospiti
coordinatore_delle_relazioni_con_i_donatori	coordinatore delle relazioni con i donatori
coordinatore_delle_telecomunicazioni	coordinatore delle telecomunicazioni
coordinatore_di_compensi_e_benefici	coordinatore di compensi e benefici
coordinatore_di_conferenze_ed_eventi	coordinatore di conferenze ed eventi
coordinatore_di_eventi	coordinatore di eventi
coordinatore_di_internet_marketing	coordinatore di internet marketing
coordinatore_di_matrimoni	coordinatore di matrimoni
coordinatore_di_mutui_ipotecari	coordinatore di mutui ipotecari
coordinatore_di_produzione	coordinatore di produzione
coordinatore_di_studi_di_ricerca	coordinatore di studi di ricerca
coordinatore_editoriale	coordinatore editoriale
coordinatore_fitness	coordinatore fitness
coordinatore_grafico	coordinatore grafico
coordinatore_import_export	coordinatore import export
coordinatore_legale	coordinatore legale
coordinatore_logistico	coordinatore logistico
coordinatore_marketing_e_comunicazione	coordinatore marketing e comunicazione
coordinatore_paghe_e_benefici	coordinatore paghe e benefici
coordinatore_per_la_gestione_delle_emergenze	coordinatore per la gestione delle emergenze
coordinatore_per_lo_sviluppo_del_fondo	coordinatore per lo sviluppo del fondo
coordinatore_politico	coordinatore politico
coordinatore_pubblicitario	coordinatore pubblicitario
coordinatore_spedizioni_e_ricevimenti	coordinatore spedizioni e ricevimenti
coordinatore_sportivo	coordinatore sportivo
coordinatore_turistico	coordinatore turistico
copilota	copilota
copywriter	copywriter
copywriter_a_contratto	copywriter a contratto
copywriter_creativo	copywriter creativo
copywriter_di_marketing	copywriter di marketing
copywriter_pubblicitario	copywriter pubblicitario
coreografo	coreografo
correttore_di_bozze	correttore di bozze
corriere_della_città	corriere della città
corrispondente_nazionale	corrispondente nazionale
corrispondente_principale	corrispondente principale
cosmetologo	cosmetologo
costruttore	costruttore
creatore_di_campioni	creatore di campioni
creditore_ipotecario	creditore ipotecario
critico_d_'arte	critico d 'arte
cucinare	cucinare
curatore	curatore
curatore_della_mostra	curatore della mostra
custode_capo	custode capo
decano	decano
decano_delle_ammissioni	decano delle ammissioni
dentista_generale	dentista generale
designer_di_accessori	designer di accessori
designer_di_marca	designer di marca
designer_tessile	designer tessile
detective_della_polizia	detective della polizia
diagnostico_educativo	diagnostico educativo
difensore_dei_reclami	difensore dei reclami
difensore_del_cliente	difensore del cliente
difensore_del_processo	difensore del processo
dipartimento_di_importazione	dipartimento di importazione
direttore	direttore
direttore_artistico	direttore artistico
direttore_artistico_esecutivo	direttore artistico esecutivo
direttore_artistico_interattivo	direttore artistico interattivo
direttore_artistico_principale	direttore artistico principale
direttore_commerciale	direttore commerciale
direttore_creativo	direttore creativo
direttore_creativo_esecutivo	direttore creativo esecutivo
direttore_creativo_principale	direttore creativo principale
direttore_degli_affari_legali	direttore degli affari legali
direttore_degli_studi	direttore degli studi
direttore_dei_media	direttore dei media
direttore_dei_media_del_gruppo	direttore dei media del gruppo
direttore_dei_rapporti_societari_e_di_fondazione	direttore dei rapporti societari e di fondazione
direttore_dei_servizi_alla_clientela	direttore dei servizi alla clientela
direttore_dei_servizi_alla_famiglia	direttore dei servizi alla famiglia
direttore_dei_servizi_associativi	direttore dei servizi associativi
direttore_dei_servizi_di_imaging	direttore dei servizi di imaging
direttore_dei_servizi_di_ristorazione	direttore dei servizi di ristorazione
direttore_dei_servizi_multimediali	direttore dei servizi multimediali
direttore_dei_servizi_speciali	direttore dei servizi speciali
direttore_dei_social_media	direttore dei social media
direttore_del_capitale_umano	direttore del capitale umano
direttore_del_centro_operativo_di_rete	direttore del centro operativo di rete
direttore_del_contenzioso	direttore del contenzioso
direttore_del_conto	direttore del conto
direttore_del_culto	direttore del culto
direttore_del_design_e_dello_sviluppo	direttore del design e dello sviluppo
direttore_del_fisco	direttore del fisco
direttore_del_gioco	direttore del gioco
direttore_del_personale	direttore del personale
direttore_del_prestito	direttore del prestito
direttore_del_reddito_fisso	direttore del reddito fisso
direttore_del_talento	direttore del talento
direttore_del_trasloco	direttore del trasloco
direttore_dell'account_digitale	direttore dell'account digitale
direttore_dell'acquisizione_di_talenti	direttore dell'acquisizione di talenti
direttore_dell'animazione	direttore dell'animazione
direttore_dell'istruzione	direttore dell'istruzione
direttore_della_copia	direttore della copia
direttore_della_donazione_pianificata	direttore della donazione pianificata
direttore_della_finanza_strutturata	direttore della finanza strutturata
direttore_della_formazione_medica	direttore della formazione medica
direttore_della_formazione_personale	direttore della formazione personale
direttore_della_fotografia	direttore della fotografia
direttore_della_gestione_degli_eventi	direttore della gestione degli eventi
direttore_della_gestione_delle_iscrizioni	direttore della gestione delle iscrizioni
direttore_della_logistica	direttore della logistica
direttore_della_pianificazione_del_gruppo	direttore della pianificazione del gruppo
direttore_della_post_produzione	direttore della post produzione
direttore_della_precostruzione	direttore della precostruzione
direttore_della_produzione_televisiva	direttore della produzione televisiva
direttore_della_produzione_video	direttore della produzione video
direttore_della_raccolta_fondi	direttore della raccolta fondi
direttore_della_ricerca_esecutiva	direttore della ricerca esecutiva
direttore_della_ricerca_sul_patrimonio	direttore della ricerca sul patrimonio
direttore_della_ristorazione	direttore della ristorazione
direttore_della_scuola_materna	direttore della scuola materna
direttore_della_sottoscrizione	direttore della sottoscrizione
direttore_della_strategia_e_delle_operazioni	direttore della strategia e delle operazioni
direttore_delle_ammissioni	direttore delle ammissioni
direttore_delle_collezioni	direttore delle collezioni
direttore_delle_indagini	direttore delle indagini
direttore_delle_iscrizioni	direttore delle iscrizioni
direttore_delle_notizie	direttore delle notizie
direttore_delle_operazioni_commerciali	direttore delle operazioni commerciali
direttore_delle_operazioni_di_produzione	direttore delle operazioni di produzione
direttore_delle_operazioni_di_rete	direttore delle operazioni di rete
direttore_delle_operazioni_di_trasmissione	direttore delle operazioni di trasmissione
direttore_delle_operazioni_di_volo	direttore delle operazioni di volo
direttore_delle_poste	direttore delle poste
direttore_delle_pubbliche_relazioni	direttore delle pubbliche relazioni
direttore_delle_relazioni_con_i_media	direttore delle relazioni con i media
direttore_delle_società_di_persone	direttore delle società di persone
direttore_delle_vendite	direttore delle vendite
direttore_delle_vendite_di_ristorazione	direttore delle vendite di ristorazione
direttore_delle_vendite_per_il_tempo_libero	direttore delle vendite per il tempo libero
direttore_dello_spettacolo	direttore dello spettacolo
direttore_dello_sviluppo_del_fondo	direttore dello sviluppo del fondo
direttore_dello_sviluppo_del_pubblico	direttore dello sviluppo del pubblico
direttore_dello_sviluppo_del_talento	direttore dello sviluppo del talento
direttore_dello_sviluppo_e_delle_pubbliche_relazioni	direttore dello sviluppo e delle pubbliche relazioni
direttore_dello_sviluppo_hardware	direttore dello sviluppo hardware
direttore_dello_sviluppo_strategico	direttore dello sviluppo strategico
direttore_di_banca	direttore di banca
direttore_di_banda	direttore di banda
direttore_di_casa	direttore di casa
direttore_di_cibo_e_bevande	direttore di cibo e bevande
direttore_di_corporate_banking	direttore di corporate banking
direttore_di_eventi_privati	direttore di eventi privati
direttore_di_eventi_speciali	direttore di eventi speciali
direttore_di_fotografia	direttore di fotografia
direttore_di_ingegneria_elettrica	direttore di ingegneria elettrica
direttore_di_piano	direttore di piano
direttore_di_portafoglio	direttore di portafoglio
direttore_di_radiologia	direttore di radiologia
direttore_di_terapia_fisica	direttore di terapia fisica
direttore_editoriale	direttore editoriale
direttore_fitness	direttore fitness
direttore_generale	direttore generale
direttore_generale_del_ristorante	direttore generale del ristorante
direttore_generale_di_zona	direttore generale di zona
direttore_medico_esecutivo	direttore medico esecutivo
direttore_musicale	direttore musicale
direttore_notturno	direttore notturno
direttore_ospedaliero	direttore ospedaliero
direttore_regionale_dei_lavori	direttore regionale dei lavori
direttore_sportivo	direttore sportivo
direttore_tecnico_artistico	direttore tecnico artistico
direttore_tecnico_del_personaggio	direttore tecnico del personaggio
direttore_turistico	direttore turistico
direttore_vendite_e_marketing	direttore vendite e marketing
direttore_vendite_istituzionali	direttore vendite istituzionali
dirigente_assicurativo	dirigente assicurativo
dirigente_contabile	dirigente contabile
dirigente_d'azienda_del_paese	dirigente d'azienda del paese
dirigente_d'importazione	dirigente d'importazione
dirigente_dell'evento	dirigente dell'evento
dirigente_della_documentazione	dirigente della documentazione
dirigente_delle_assunzioni	dirigente delle assunzioni
dirigente_delle_relazioni_con_gli_ospiti	dirigente delle relazioni con gli ospiti
dirigente_di_finanza_aziendale	dirigente di finanza aziendale
dirigente_di_front_office	dirigente di front office
dirigente_di_viaggio	dirigente di viaggio
dirigente_import_export	dirigente import export
dirigente_in_residenza	dirigente in residenza
dirigente_logistico	dirigente logistico
dirigente_marketing_e_comunicazione	dirigente marketing e comunicazione
dirigente_mediatico	dirigente mediatico
dirigente_medico	dirigente medico
dirigente_per_l'acquisizione_di_talenti	dirigente per l'acquisizione di talenti
dirigente_scolastico	dirigente scolastico
dirigente_sportivo	dirigente sportivo
dirigente_sul_campo_dell'agenzia	dirigente sul campo dell'agenzia
disegnatore_civile	disegnatore civile
disegnatore_di_personaggi	disegnatore di personaggi
disegnatore_di_stampe	disegnatore di stampe
disegnatore_floreale	disegnatore floreale
disegnatore_meccanico	disegnatore meccanico
disegnatore_pubblicitario	disegnatore pubblicitario
docente	docente
docente_universitario	docente universitario
editor_di_foto	editor di foto
editore	editore
editore_appassionato	editore appassionato
editore_cittadino	editore cittadino
editore_desktop	editore desktop
editore_di_compiti	editore di compiti
editore_di_design	editore di design
editore_di_gruppo	editore di gruppo
editore_di_post_produzione	editore di post produzione
editore_di_progetto	editore di progetto
editore_di_stile_di_vita	editore di stile di vita
editore_di_viaggi	editore di viaggi
editore_editoriale	editore editoriale
editore_metro	editore metro
editore_video	editore video
editore_web	editore web
editorialista	editorialista
educatore_della_prima_infanzia	educatore della prima infanzia
educatore_speciale	educatore speciale
efficacia_organizzativa_del_direttore	efficacia organizzativa del direttore
elaboratore_di_posta	elaboratore di posta
emittente	emittente
emittente_radiofonica	emittente radiofonica
endodontista	endodontista
erborista	erborista
esaminatore_del_titolo	esaminatore del titolo
esaminatore_di_banca	esaminatore di banca
esaminatore_esterno	esaminatore esterno
esecutivo_legale	esecutivo legale
esecutivo_vp	esecutivo vp
esperto_di_affari	esperto di affari
esperto_di_logistica	esperto di logistica
esperto_di_sicurezza	esperto di sicurezza
esperto_di_supporto_tecnico	esperto di supporto tecnico
esperto_di_tecnologia_informatica	esperto di tecnologia informatica
esperto_di_telecomunicazioni	esperto di telecomunicazioni
esperto_nazionale	esperto nazionale
esploratore_di_posizione	esploratore di posizione
esplorazione_vp	esplorazione vp
esso_reclutatore	esso reclutatore
facilitatore_di_gruppo	facilitatore di gruppo
facoltà_a_tempo_pieno	facoltà a tempo pieno
farmacista_clinico	farmacista clinico
farmacista_del_personale_clinico	farmacista del personale clinico
farmacista_di_produzione	farmacista di produzione
farmacista_per_gli_affari_regolatori	farmacista per gli affari regolatori
finanziatore	finanziatore
fine_artista	fine artista
fisco_statale_e_locale	fisco statale e locale
fonte	fonte
formatore_distrettuale	formatore distrettuale
fornitore_di_assistenza_all'infanzia	fornitore di assistenza all'infanzia
fornitore_di_rete	fornitore di rete
fotografo_a_contratto	fotografo a contratto
fotografo_d'arte	fotografo d'arte
fotografo_di_eventi	fotografo di eventi
fotografo_di_moda	fotografo di moda
fotografo_personale	fotografo personale
fotografo_professionale	fotografo professionale
fotografo_sportivo	fotografo sportivo
fototecnico	fototecnico
front_office_capo_squadra	front office capo squadra
funzionario_di_banca_privata	funzionario di banca privata
funzionario_di_reclutamento	funzionario di reclutamento
funzionario_di_rete	funzionario di rete
funzionario_legale_e_di_conformità	funzionario legale e di conformità
gallerista	gallerista
generalista_3d	generalista 3d
geofisico_del_personale	geofisico del personale
geofisico_di_elaborazione	geofisico di elaborazione
geologo	geologo
geologo_a_contratto	geologo a contratto
geologo_ambientale	geologo ambientale
geologo_consulente	geologo consulente
geologo_di_giacimento	geologo di giacimento
geologo_di_progetto	geologo di progetto
geologo_minerario	geologo minerario
geologo_personale	geologo personale
geologo_ricercatore	geologo ricercatore
geologo_sul_campo	geologo sul campo
geoscienziato	geoscienziato
gestione_delle_operazioni_di_rete	gestione delle operazioni di rete
gestire_servizi_avanzati	gestire servizi avanzati
gestore_bancario_personale	gestore bancario personale
gestore_clienti_privato	gestore clienti privato
gestore_d'arte	gestore d'arte
gestore_dei_benefici	gestore dei benefici
gestore_dei_contenuti_del_sito_web	gestore dei contenuti del sito web
gestore_dei_media	gestore dei media
gestore_del_bar	gestore del bar
gestore_del_caffè	gestore del caffè
gestore_del_caveau	gestore del caveau
gestore_del_fisco_immobiliare	gestore del fisco immobiliare
gestore_del_fondo	gestore del fondo
gestore_del_locale	gestore del locale
gestore_del_mercato_al_dettaglio	gestore del mercato al dettaglio
gestore_del_portfolio	gestore del portfolio
gestore_del_rendimento	gestore del rendimento
gestore_del_rischio_di_mercato	gestore del rischio di mercato
gestore_del_ristorante	gestore del ristorante
gestore_del_sito_web	gestore del sito web
gestore_del_terminale	gestore del terminale
gestore_del_traffico	gestore del traffico
gestore_dell'account_digitale	gestore dell'account digitale
gestore_dell'account_pubblicitario	gestore dell'account pubblicitario
gestore_dell'infrastruttura_di_rete	gestore dell'infrastruttura di rete
gestore_della_piscina	gestore della piscina
gestore_della_proprietà	gestore della proprietà
gestore_della_responsabilità_patrimoniale	gestore della responsabilità patrimoniale
gestore_della_rete_principale	gestore della rete principale
gestore_della_trasmissione	gestore della trasmissione
gestore_delle_donazioni_individuali	gestore delle donazioni individuali
gestore_delle_sovvenzioni	gestore delle sovvenzioni
gestore_di_banca_privata	gestore di banca privata
gestore_di_base	gestore di base
gestore_di_cambio	gestore di cambio
gestore_di_contenuti	gestore di contenuti
gestore_di_contenuti_digitali	gestore di contenuti digitali
gestore_di_conto_mercato_medio	gestore di conto mercato medio
gestore_di_fondi_annuale	gestore di fondi annuale
gestore_di_immobili_residenziali	gestore di immobili residenziali
gestore_di_portafoglio_a_reddito_fisso	gestore di portafoglio a reddito fisso
gestore_di_portafoglio_azionario	gestore di portafoglio azionario
gestore_di_portafoglio_immobiliare	gestore di portafoglio immobiliare
gestore_di_portafoglio_prodotti	gestore di portafoglio prodotti
gestore_esterno	gestore esterno
gestore_floreale	gestore floreale
gestore_immobiliare_regionale	gestore immobiliare regionale
gestore_import_export	gestore import export
giocatore	giocatore
giornalista	giornalista
giornalista_del_traffico	giornalista del traffico
giornalista_di_mercato	giornalista di mercato
giornalista_finanziario	giornalista finanziario
giornalista_multimediale	giornalista multimediale
giornalista_sportivo	giornalista sportivo
giornalista_studentesco	giornalista studentesco
giornalista_televisivo	giornalista televisivo
giornalista_web	giornalista web
giudice	giudice
giudice_di_diritto_amministrativo	giudice di diritto amministrativo
giudice_distrettuale	giudice distrettuale
governante_esecutiva	governante esecutiva
grafico_ambientale	grafico ambientale
grafico_creativo	grafico creativo
grafico_principale	grafico principale
grande_responsabile_dei_regali	grande responsabile dei regali
grossista_interno	grossista interno
guida_creativa	guida creativa
guida_tecnica	guida tecnica
guida_turistica	guida turistica
hr_analista	hr analista
hr_associato	hr associato
hr_generalista	hr generalista
hr_partner_commerciale	hr partner commerciale
ideatore	ideatore
idrogeologo_del_progetto	idrogeologo del progetto
idrologo	idrologo
igienista_dentale_iscritto_all'albo	igienista dentale iscritto all'albo
il_team_esecutivo_guida_l'esperienza_degli_ospiti	il team esecutivo guida l'esperienza degli ospiti
illustratore	illustratore
illustratore_medico	illustratore medico
illustre_ingegnere_informatico	illustre ingegnere informatico
illustre_membro_dello_staff_tecnico	illustre membro dello staff tecnico
impiegato_allo_sportello	impiegato allo sportello
impiegato_del_caso	impiegato del caso
impiegato_della_panetteria	impiegato della panetteria
impiegato_di_banca	impiegato di banca
impiegato_di_pesce	impiegato di pesce
impiegato_di_prestito	impiegato di prestito
impiegato_di_produzione	impiegato di produzione
impiegato_di_revisione	impiegato di revisione
impiegato_giudiziario	impiegato giudiziario
impiegato_legale	impiegato legale
impiegato_legale_estivo	impiegato legale estivo
infermiera	infermiera
infermiera_chirurgica	infermiera chirurgica
infermiera_del_distretto	infermiera del distretto
infermiera_della_scuola	infermiera della scuola
infermiera_dello_staff	infermiera dello staff
infermiera_dentale	infermiera dentale
infermiera_di_pratica_avanzata	infermiera di pratica avanzata
infermiera_di_sanità_pubblica	infermiera di sanità pubblica
infermiera_di_terapia_intensiva	infermiera di terapia intensiva
infermiera_di_viaggio	infermiera di viaggio
infermiera_pediatrica	infermiera pediatrica
infermiera_pratica_autorizzata	infermiera pratica autorizzata
infermiera_psichiatrica_di_salute_mentale	infermiera psichiatrica di salute mentale
infermiere_domiciliare	infermiere domiciliare
infermiere_professionale	infermiere professionale
infermiere_tirocinante	infermiere tirocinante
ingegnere_aerodinamico	ingegnere aerodinamico
ingegnere_agricolo	ingegnere agricolo
ingegnere_alimentare	ingegnere alimentare
ingegnere_ambientale	ingegnere ambientale
ingegnere_applicativo	ingegnere applicativo
ingegnere_applicativo_aziendale	ingegnere applicativo aziendale
ingegnere_applicativo_del_personale	ingegnere applicativo del personale
ingegnere_bsc	ingegnere bsc
ingegnere_certificatore	ingegnere certificatore
ingegnere_chimico	ingegnere chimico
ingegnere_civile_del_sito	ingegnere civile del sito
ingegnere_clinico	ingegnere clinico
ingegnere_completo	ingegnere completo
ingegnere_comunale	ingegnere comunale
ingegnere_consulente	ingegnere consulente
ingegnere_d'impresa	ingegnere d'impresa
ingegnere_dei_servizi_edili	ingegnere dei servizi edili
ingegnere_dei_sistemi_di_telecomunicazioni	ingegnere dei sistemi di telecomunicazioni
ingegnere_del_controllo_di_processo	ingegnere del controllo di processo
ingegnere_del_pacchetto	ingegnere del pacchetto
ingegnere_del_sistema_di_automazione	ingegnere del sistema di automazione
ingegnere_del_sistema_di_controllo	ingegnere del sistema di controllo
ingegnere_del_sistema_di_supporto_aziendale	ingegnere del sistema di supporto aziendale
ingegnere_del_sistema_di_trasmissione	ingegnere del sistema di trasmissione
ingegnere_del_software	ingegnere del software
ingegnere_del_suono	ingegnere del suono
ingegnere_del_supporto_tecnico_del_personale	ingegnere del supporto tecnico del personale
ingegnere_dell'automazione_della_garanzia_della_qualità	ingegnere dell'automazione della garanzia della qualità
ingegnere_dell'innovazione	ingegnere dell'innovazione
ingegnere_dell'integrità_del_segnale	ingegnere dell'integrità del segnale
ingegnere_dell'interfaccia_utente	ingegnere dell'interfaccia utente
ingegnere_dell'ufficio_tecnico	ingegnere dell'ufficio tecnico
ingegnere_della_proprietà_intellettuale	ingegnere della proprietà intellettuale
ingegnere_della_sicurezza	ingegnere della sicurezza
ingegnere_della_sicurezza_delle_informazioni	ingegnere della sicurezza delle informazioni
ingegnere_della_sicurezza_di_rete	ingegnere della sicurezza di rete
ingegnere_della_telefonia	ingegnere della telefonia
ingegnere_delle_infrastrutture_di_rete	ingegnere delle infrastrutture di rete
ingegnere_delle_prestazioni_del_sistema	ingegnere delle prestazioni del sistema
ingegnere_delle_prestazioni_di_rete	ingegnere delle prestazioni di rete
ingegnere_delle_telecomunicazioni	ingegnere delle telecomunicazioni
ingegnere_dello_stress	ingegnere dello stress
ingegnere_desktop	ingegnere desktop
ingegnere_di_automazione_di_processo	ingegnere di automazione di processo
ingegnere_di_base	ingegnere di base
ingegnere_di_calibrazione	ingegnere di calibrazione
ingegnere_di_commutazione	ingegnere di commutazione
ingegnere_di_completamento	ingegnere di completamento
ingegnere_di_distribuzione	ingegnere di distribuzione
ingegnere_di_drenaggio	ingegnere di drenaggio
ingegnere_di_garanzia_della_qualità_del_software	ingegnere di garanzia della qualità del software
ingegnere_di_implementazione	ingegnere di implementazione
ingegnere_di_integrazione_di_rete	ingegnere di integrazione di rete
ingegnere_di_lancio	ingegnere di lancio
ingegnere_di_marciapiede	ingegnere di marciapiede
ingegnere_di_pianificazione_della_rete	ingegnere di pianificazione della rete
ingegnere_di_ponte	ingegnere di ponte
ingegnere_di_processo	ingegnere di processo
ingegnere_di_processo_dell'impianto	ingegnere di processo dell'impianto
ingegnere_di_produzione	ingegnere di produzione
ingegnere_di_progettazione_e_sviluppo	ingegnere di progettazione e sviluppo
ingegnere_di_progettazione_e_sviluppo_del_prodotto	ingegnere di progettazione e sviluppo del prodotto
ingegnere_di_progetto	ingegnere di progetto
ingegnere_di_prova	ingegnere di prova
ingegnere_di_prova_di_guida	ingegnere di prova di guida
ingegnere_di_prova_elettrico	ingegnere di prova elettrico
ingegnere_di_rete	ingegnere di rete
ingegnere_di_rete_Cisco	ingegnere di rete Cisco
ingegnere_di_rete_aziendale	ingegnere di rete aziendale
ingegnere_di_rete_dati	ingegnere di rete dati
ingegnere_di_rete_informatica	ingegnere di rete informatica
ingegnere_di_rete_principale	ingegnere di rete principale
ingegnere_di_rete_voip	ingegnere di rete voip
ingegnere_di_rete_wireless	ingegnere di rete wireless
ingegnere_di_rilascio_del_progetto	ingegnere di rilascio del progetto
ingegnere_di_sezione	ingegnere di sezione
ingegnere_di_simulazione	ingegnere di simulazione
ingegnere_di_sistema_Microsoft	ingegnere di sistema Microsoft
ingegnere_di_sistema_avanzato	ingegnere di sistema avanzato
ingegnere_di_sistema_di_rete	ingegnere di sistema di rete
ingegnere_di_sistema_elettronico	ingegnere di sistema elettronico
ingegnere_di_sistema_hardware	ingegnere di sistema hardware
ingegnere_di_sistema_integrato	ingegnere di sistema integrato
ingegnere_di_sistema_meccanico	ingegnere di sistema meccanico
ingegnere_di_sistema_regionale	ingegnere di sistema regionale
ingegnere_di_stazione	ingegnere di stazione
ingegnere_di_supporto_del_sistema	ingegnere di supporto del sistema
ingegnere_di_sviluppo_elettronico	ingegnere di sviluppo elettronico
ingegnere_di_sviluppo_hardware	ingegnere di sviluppo hardware
ingegnere_di_sviluppo_meccanico	ingegnere di sviluppo meccanico
ingegnere_di_sviluppo_software	ingegnere di sviluppo software
ingegnere_di_sviluppo_software_in_prova	ingegnere di sviluppo software in prova
ingegnere_di_sviluppo_web	ingegnere di sviluppo web
ingegnere_di_trasmissione	ingegnere di trasmissione
ingegnere_di_veicoli_spaziali	ingegnere di veicoli spaziali
ingegnere_diagnostico	ingegnere diagnostico
ingegnere_distrettuale	ingegnere distrettuale
ingegnere_edile	ingegnere edile
ingegnere_edison	ingegnere edison
ingegnere_elettrico	ingegnere elettrico
ingegnere_elettrico_del_personale	ingegnere elettrico del personale
ingegnere_elettrico_e_di_strumentazione	ingegnere elettrico e di strumentazione
ingegnere_elettrico_ed_elettronico	ingegnere elettrico ed elettronico
ingegnere_elettrico_principale	ingegnere elettrico principale
ingegnere_elettromeccanico	ingegnere elettromeccanico
ingegnere_firewall	ingegnere firewall
ingegnere_generale_sul_campo	ingegnere generale sul campo
ingegnere_geologico	ingegnere geologico
ingegnere_hardware	ingegnere hardware
ingegnere_hardware_del_personale	ingegnere hardware del personale
ingegnere_hardware_principale	ingegnere hardware principale
ingegnere_informatico	ingegnere informatico
ingegnere_layout	ingegnere layout
ingegnere_logistico	ingegnere logistico
ingegnere_meccanico_a_contratto	ingegnere meccanico a contratto
ingegnere_meccanico_di_processo	ingegnere meccanico di processo
ingegnere_medico	ingegnere medico
ingegnere_metallurgico	ingegnere metallurgico
ingegnere_minerario	ingegnere minerario
ingegnere_mobile	ingegnere mobile
ingegnere_operativo_di_rete	ingegnere operativo di rete
ingegnere_operativo_sul_campo	ingegnere operativo sul campo
ingegnere_petrolifero	ingegnere petrolifero
ingegnere_portuale	ingegnere portuale
ingegnere_professionista	ingegnere professionista
ingegnere_progettista	ingegnere progettista
ingegnere_progettista_analogico	ingegnere progettista analogico
ingegnere_progettista_civile	ingegnere progettista civile
ingegnere_progettista_del_firmware	ingegnere progettista del firmware
ingegnere_progettista_del_layout	ingegnere progettista del layout
ingegnere_progettista_del_personale	ingegnere progettista del personale
ingegnere_progettista_dell'automazione	ingegnere progettista dell'automazione
ingegnere_progettista_di_circuiti	ingegnere progettista di circuiti
ingegnere_progettista_di_macchine	ingegnere progettista di macchine
ingegnere_progettista_di_processo	ingegnere progettista di processo
ingegnere_progettista_di_produzione	ingegnere progettista di produzione
ingegnere_progettista_di_prova	ingegnere progettista di prova
ingegnere_progettista_di_reti	ingegnere progettista di reti
ingegnere_progettista_di_segnali_misti	ingegnere progettista di segnali misti
ingegnere_progettista_di_sistemi	ingegnere progettista di sistemi
ingegnere_progettista_digitale	ingegnere progettista digitale
ingegnere_progettista_elettrico	ingegnere progettista elettrico
ingegnere_progettista_elettronico	ingegnere progettista elettronico
ingegnere_progettista_fisico	ingegnere progettista fisico
ingegnere_progettista_hardware	ingegnere progettista hardware
ingegnere_progettista_meccanico	ingegnere progettista meccanico
ingegnere_progettista_principale	ingegnere progettista principale
ingegnere_progettista_radiofonico	ingegnere progettista radiofonico
ingegnere_progettista_telecomunicazioni	ingegnere progettista telecomunicazioni
ingegnere_propulsivo	ingegnere propulsivo
ingegnere_propulsore	ingegnere propulsore
ingegnere_prove_di_volo	ingegnere prove di volo
ingegnere_ricerca_e_sviluppo	ingegnere ricerca e sviluppo
ingegnere_ricercatore_del_personale	ingegnere ricercatore del personale
ingegnere_riparatore	ingegnere riparatore
ingegnere_scada	ingegnere scada
ingegnere_senza_fili	ingegnere senza fili
ingegnere_software_java	ingegnere software java
ingegnere_strutturista_laureato	ingegnere strutturista laureato
ingegnere_sul_campo	ingegnere sul campo
ingegnere_sul_campo_della_linea_fissa	ingegnere sul campo della linea fissa
ingegnere_tecnico_sul_campo	ingegnere tecnico sul campo
ingegnere_video	ingegnere video
ingegnere_vocale	ingegnere vocale
ingegnere_voip	ingegnere voip
ingegnere_web	ingegnere web
ingegneria_di_rete_del_gestore	ingegneria di rete del gestore
insaccatrice	insaccatrice
insegnante	insegnante
insegnante_bilingue	insegnante bilingue
insegnante_della_prima_infanzia	insegnante della prima infanzia
insegnante_di_animazione	insegnante di animazione
insegnante_di_arte_in_lingua_inglese	insegnante di arte in lingua inglese
insegnante_di_arti_linguistiche	insegnante di arti linguistiche
insegnante_di_asilo_nido	insegnante di asilo nido
insegnante_di_assistenza_all'infanzia	insegnante di assistenza all'infanzia
insegnante_di_biologia	insegnante di biologia
insegnante_di_chitarra	insegnante di chitarra
insegnante_di_classe	insegnante di classe
insegnante_di_contabilità	insegnante di contabilità
insegnante_di_cucina	insegnante di cucina
insegnante_di_cucito	insegnante di cucito
insegnante_di_danza	insegnante di danza
insegnante_di_design	insegnante di design
insegnante_di_educazione_aziendale	insegnante di educazione aziendale
insegnante_di_educazione_elementare	insegnante di educazione elementare
insegnante_di_educazione_speciale	insegnante di educazione speciale
insegnante_di_grafica	insegnante di grafica
insegnante_di_inglese_secondario	insegnante di inglese secondario
insegnante_di_italiano	insegnante di italiano
insegnante_di_lettura	insegnante di lettura
insegnante_di_lingua_inglese	insegnante di lingua inglese
insegnante_di_matematica_delle_scuole_medie	insegnante di matematica delle scuole medie
insegnante_di_matematica_delle_scuole_superiori	insegnante di matematica delle scuole superiori
insegnante_di_recitazione	insegnante di recitazione
insegnante_di_scienze_secondarie	insegnante di scienze secondarie
insegnante_di_scuola_estiva	insegnante di scuola estiva
insegnante_di_scuola_materna	insegnante di scuola materna
insegnante_di_scuola_media	insegnante di scuola media
insegnante_di_scuola_pubblica	insegnante di scuola pubblica
insegnante_di_sociologia	insegnante di sociologia
insegnante_di_sport	insegnante di sport
insegnante_di_storia	insegnante di storia
insegnante_di_supporto_all'apprendimento	insegnante di supporto all'apprendimento
insegnante_elementare	insegnante elementare
insegnante_inglese_lingua_straniera	insegnante inglese lingua straniera
insegnante_ospite	insegnante ospite
insegnante_secondario	insegnante secondario
insegnante_studente	insegnante studente
insegnante_supplente	insegnante supplente
integratore_di_rete	integratore di rete
intensivista	intensivista
intermediario_assicurativo_commerciale	intermediario assicurativo commerciale
intermediario_designato	intermediario designato
intermediario_di_gestione	intermediario di gestione
intrattenitore	intrattenitore
investigatore	investigatore
investigatore_aziendale	investigatore aziendale
investigatore_capo	investigatore capo
investigatore_criminale	investigatore criminale
investigatore_di_frodi	investigatore di frodi
investigatore_in_background	investigatore in background
investigatore_privato	investigatore privato
investigatore_regionale	investigatore regionale
investigatore_speciale	investigatore speciale
investigatore_sul_campo	investigatore sul campo
ispettore_di_polizia	ispettore di polizia
ispettore_edile	ispettore edile
ispettore_postale	ispettore postale
istruttore_aggiunto	istruttore aggiunto
istruttore_clinico	istruttore clinico
istruttore_culinario	istruttore culinario
istruttore_di_acquagym	istruttore di acquagym
istruttore_di_armi_da_fuoco	istruttore di armi da fuoco
istruttore_di_arti_marziali	istruttore di arti marziali
istruttore_di_bootcamp	istruttore di bootcamp
istruttore_di_canottaggio	istruttore di canottaggio
istruttore_di_cheerleader	istruttore di cheerleader
istruttore_di_ciclismo_indoor	istruttore di ciclismo indoor
istruttore_di_cinesiologia	istruttore di cinesiologia
istruttore_di_crossfit	istruttore di crossfit
istruttore_di_fitness_di_gruppo	istruttore di fitness di gruppo
istruttore_di_lancio	istruttore di lancio
istruttore_di_musica	istruttore di musica
istruttore_di_ottone	istruttore di ottone
istruttore_di_sbarra	istruttore di sbarra
istruttore_di_tiro_primario	istruttore di tiro primario
istruttore_di_volo	istruttore di volo
istruttore_in_visita	istruttore in visita
istruttore_infermieristico	istruttore infermieristico
istruttore_sportivo	istruttore sportivo
istruttore_studente_laureato	istruttore studente laureato
la_logistica	la logistica
laureato_ingegnere_civile	laureato ingegnere civile
laureato_ingegnere_meccanico	laureato ingegnere meccanico
libero_professionista	libero professionista
linea_di_cucina	linea di cucina
linguista	linguista
linguista_russo	linguista russo
logistico	logistico
maestra_d'asilo	maestra d'asilo
maestro_di_scuola_elementare	maestro di scuola elementare
maestro_falegname	maestro falegname
maestro_idraulico	maestro idraulico
maestro_marinaio	maestro marinaio
maestro_stilista	maestro stilista
magazziniere	magazziniere
magazzino_notturno	magazzino notturno
maggiore_pensionato	maggiore pensionato
manager_del_talento	manager del talento
manager_delle_relazioni	manager delle relazioni
manager_di_eventi	manager di eventi
manager_di_produzione	manager di produzione
manicure	manicure
media_manager_interattivo	media manager interattivo
mediatore	mediatore
mediatore_di_mutui	mediatore di mutui
mediatore_di_piano	mediatore di piano
mediatore_finanziario	mediatore finanziario
mediatore_riassicurativo	mediatore riassicurativo
medico	medico
medico_curante	medico curante
medico_del_personale	medico del personale
medico_di_emergenza	medico di emergenza
medico_di_famiglia	medico di famiglia
medico_di_medicina_d'urgenza	medico di medicina d'urgenza
medico_di_medicina_interna	medico di medicina interna
medico_generico	medico generico
membro_del_collegio_dei_consiglieri	membro del collegio dei consiglieri
membro_del_corpo	membro del corpo
membro_del_personale_professionale	membro del personale professionale
membro_del_team_di_vendita	membro del team di vendita
membro_dello_staff_tecnico	membro dello staff tecnico
membro_di_una_band	membro di una band
metallurgo_vegetale	metallurgo vegetale
mixer_audio	mixer audio
mixer_di_ri-registrazione	mixer di ri-registrazione
mixologo	mixologo
modellatore	modellatore
modellatore_3d	modellatore 3d
modellatore_di_personaggi	modellatore di personaggi
montatore_cinematografico	montatore cinematografico
montatore_di_film_e_video	montatore di film e video
muralista	muralista
musicista	musicista
musicista_professionista	musicista professionista
negoziatore_di_trasmissioni	negoziatore di trasmissioni
neonatologo	neonatologo
nuovo_consulente_per_la_casa	nuovo consulente per la casa
nuovo_consulente_per_la_vendita_di_case	nuovo consulente per la vendita di case
operativo_di_magazzino	operativo di magazzino
operatore_del_centro_operativo_di_rete	operatore del centro operativo di rete
operatore_di_bordo	operatore di bordo
operatore_di_camera	operatore di camera
operatore_di_capitale_proprio	operatore di capitale proprio
operatore_di_controllo_principale	operatore di controllo principale
operatore_di_controllo_qualità	operatore di controllo qualità
operatore_di_datacenter	operatore di datacenter
operatore_di_desktop_publishing	operatore di desktop publishing
operatore_di_nastri	operatore di nastri
operatore_di_sostegno_familiare	operatore di sostegno familiare
operatore_di_vendita_di_azioni	operatore di vendita di azioni
operatore_tecnico	operatore tecnico
operatore_telefonico	operatore telefonico
organista	organista
organizzatore_di_eventi_aziendali	organizzatore di eventi aziendali
organizzatore_di_eventi_speciali	organizzatore di eventi speciali
ortodontista	ortodontista
ospite	ospite
oste	oste
paesaggista	paesaggista
panettiere	panettiere
paraeducatore	paraeducatore
paralegale_aziendale	paralegale aziendale
parrucchiere	parrucchiere
partecipante_mba	partecipante mba
partner_di_contenzioso	partner di contenzioso
pasticcere	pasticcere
pediatra	pediatra
perforatore	perforatore
perfusionista	perfusionista
perito_immobiliare	perito immobiliare
perito_immobiliare_certificato	perito immobiliare certificato
perito_residenziale_certificato	perito residenziale certificato
perito_sinistri	perito sinistri
persona_che_passeggia_con_il_cane	persona che passeggia con il cane
personal_trainer_certificato	personal trainer certificato
personale_contabile	personale contabile
personale_di_piano	personale di piano
pianificatore	pianificatore
pianificatore_del_marchio	pianificatore del marchio
pianificatore_di_account	pianificatore di account
pianificatore_di_conferenze	pianificatore di conferenze
pianificatore_di_eventi	pianificatore di eventi
pianificatore_di_mutui_certificato	pianificatore di mutui certificato
pianificatore_di_vacanze	pianificatore di vacanze
pianificatore_di_vendita	pianificatore di vendita
pianificatore_digitale	pianificatore digitale
pianificatore_logistico	pianificatore logistico
pianificatore_multimediale	pianificatore multimediale
pianificatore_multimediale_digitale	pianificatore multimediale digitale
pianificatore_urbano	pianificatore urbano
pianificazione_strategica_del_manager	pianificazione strategica del manager
pilota_a_contratto	pilota a contratto
pilota_aziendale	pilota aziendale
pilota_commerciale	pilota commerciale
pilota_di_linea	pilota di linea
piombo_a_grappolo	piombo a grappolo
piombo_del_pavimento	piombo del pavimento
piombo_di_acquisizione_di_talenti	piombo di acquisizione di talenti
piombo_di_comunicazione	piombo di comunicazione
piombo_di_spedizione	piombo di spedizione
pittore	pittore
poliziotto	poliziotto
poliziotto_di_stato	poliziotto di stato
portachiavi	portachiavi
portavoce	portavoce
post_produttore	post produttore
posta_più_vicino	posta più vicino
pratica_privata	pratica privata
preparatore_fiscale	preparatore fiscale
presentatore	presentatore
presentatore_televisivo	presentatore televisivo
preside	preside
preside_dell'agenzia	preside dell'agenzia
preside_di_scuola_elementare	preside di scuola elementare
preside_elementare	preside elementare
prestito_più_vicino	prestito più vicino
prevosto	prevosto
prima_telecamera_assistente	prima telecamera assistente
primo_assistente_al_montaggio	primo assistente al montaggio
primo_assistente_alla_regia	primo assistente alla regia
primo_ballerino	primo ballerino
primo_ingegnere	primo ingegnere
primo_ufficiale	primo ufficiale
principale_account_manager	principale account manager
principale_architetto_paesaggista	principale architetto paesaggista
principale_banchiere	principale banchiere
principale_contabile	principale contabile
principale_geologo	principale geologo
principale_gestore_di_portafoglio	principale gestore di portafoglio
principale_idrogeologo	principale idrogeologo
principale_ingegnere_civile	principale ingegnere civile
principale_ingegnere_della_sicurezza	principale ingegnere della sicurezza
principale_ingegnere_meccanico	principale ingegnere meccanico
principale_operativo	principale operativo
principale_responsabile_delle_politiche	principale responsabile delle politiche
processore_di_prestito	processore di prestito
procuratore_aziendale	procuratore aziendale
procuratore_contrattuale	procuratore contrattuale
procuratore_del_personale	procuratore del personale
procuratore_di_ricerca	procuratore di ricerca
procuratore_generale_aggiunto	procuratore generale aggiunto
procuratore_principale	procuratore principale
produrre_associato	produrre associato
produttore	produttore
produttore_assicurativo	produttore assicurativo
produttore_audio	produttore audio
produttore_cinematografico	produttore cinematografico
produttore_commerciale	produttore commerciale
produttore_creativo	produttore creativo
produttore_del_programma	produttore del programma
produttore_di_colata	produttore di colata
produttore_di_contenuti	produttore di contenuti
produttore_di_linea	produttore di linea
produttore_di_linee_commerciali	produttore di linee commerciali
produttore_di_media_digitali	produttore di media digitali
produttore_di_notizie	produttore di notizie
produttore_di_nuovi_media	produttore di nuovi media
produttore_di_promozioni	produttore di promozioni
produttore_di_servizi_creativi	produttore di servizi creativi
produttore_di_spettacoli_mattutini	produttore di spettacoli mattutini
produttore_di_stampe	produttore di stampe
produttore_di_sviluppo	produttore di sviluppo
produttore_di_talenti	produttore di talenti
produttore_di_telegiornali	produttore di telegiornali
produttore_digitale	produttore digitale
produttore_esecutivo	produttore esecutivo
produttore_interattivo	produttore interattivo
produttore_multimediale	produttore multimediale
produttore_musicale	produttore musicale
produttore_radiofonico	produttore radiofonico
produttore_sportivo	produttore sportivo
produttore_tecnico	produttore tecnico
produttore_televisivo	produttore televisivo
produttore_video	produttore video
produttore_web	produttore web
professionista_della_musica	professionista della musica
professionista_immobiliare_abilitato	professionista immobiliare abilitato
professionista_infermiere_adulto	professionista infermiere adulto
professionista_legale	professionista legale
professore_a_contratto_di_finanza	professore a contratto di finanza
professore_a_contratto_di_storia	professore a contratto di storia
professore_aggiunto	professore aggiunto
professore_associato_clinico	professore associato clinico
professore_d'arte	professore d'arte
professore_di_antropologia	professore di antropologia
professore_di_architettura	professore di architettura
professore_di_chirurgia	professore di chirurgia
professore_di_educazione	professore di educazione
professore_di_filosofia	professore di filosofia
professore_di_inglese	professore di inglese
professore_di_matematica	professore di matematica
professore_di_scienze_politiche	professore di scienze politiche
professore_di_scuola_superiore	professore di scuola superiore
professore_di_sociologia	professore di sociologia
professore_emerito	professore emerito
professore_universitario	professore universitario
professoressa	professoressa
progettista	progettista
progettista_analogico	progettista analogico
progettista_architettonico	progettista architettonico
progettista_civile	progettista civile
progettista_del_prodotto	progettista del prodotto
progettista_dell'interfaccia_utente	progettista dell'interfaccia utente
progettista_della_comunicazione	progettista della comunicazione
progettista_della_trasmissione	progettista della trasmissione
progettista_di_circuiti	progettista di circuiti
progettista_di_circuiti_stampati	progettista di circuiti stampati
progettista_di_eventi	progettista di eventi
progettista_di_giochi	progettista di giochi
progettista_di_ingegneria	progettista di ingegneria
progettista_di_layout	progettista di layout
progettista_di_media_digitali	progettista di media digitali
progettista_di_pubblicazioni	progettista di pubblicazioni
progettista_di_rete	progettista di rete
progettista_di_servizi	progettista di servizi
progettista_di_sistemi_di_controllo	progettista di sistemi di controllo
progettista_digitale	progettista digitale
progettista_elettronico	progettista elettronico
progettista_fisico	progettista fisico
progettista_hardware	progettista hardware
progettista_idraulico	progettista idraulico
progettista_multimediale	progettista multimediale
progettista_tecnico	progettista tecnico
progettista_visivo	progettista visivo
programma_di_sviluppo_ingegneristico_di_edison	programma di sviluppo ingegneristico di edison
programmatore_di_applicazioni_web	programmatore di applicazioni web
programmatore_multimediale	programmatore multimediale
programmatore_php	programmatore php
programmatore_web	programmatore web
proprietario_del_ristorante	proprietario del ristorante
protagonista_dell'animazione	protagonista dell'animazione
psicoanalista	psicoanalista
psicologo	psicologo
psicologo_abilitato	psicologo abilitato
psicologo_clinico	psicologo clinico
psicologo_clinico_abilitato	psicologo clinico abilitato
psicologo_consulente	psicologo consulente
psicologo_forense	psicologo forense
psicoterapeuta_in_studio_privato	psicoterapeuta in studio privato
pubblicista	pubblicista
raccoglitore	raccoglitore
radiologo	radiologo
radiotecnico	radiotecnico
ragioniere_cliente	ragioniere cliente
ragioniere_immobiliare	ragioniere immobiliare
ragioniere_intermedio	ragioniere intermedio
ragioniere_professionista	ragioniere professionista
ragioniere_provvisorio	ragioniere provvisorio
ragioniere_pubblico_certificato	ragioniere pubblico certificato
rapporto_esecutivo	rapporto esecutivo
rappresentante_alla_reception	rappresentante alla reception
rappresentante_bancario_personale	rappresentante bancario personale
rappresentante_dei_reclami	rappresentante dei reclami
rappresentante_del_conto_assicurativo	rappresentante del conto assicurativo
rappresentante_del_credito	rappresentante del credito
rappresentante_del_paese	rappresentante del paese
rappresentante_del_prestito	rappresentante del prestito
rappresentante_del_servizio_clienti	rappresentante del servizio clienti
rappresentante_del_supporto_tecnico	rappresentante del supporto tecnico
rappresentante_dell'account_pubblicitario	rappresentante dell'account pubblicitario
rappresentante_dell'agenzia	rappresentante dell'agenzia
rappresentante_dell'assistenza_tecnica_ai_clienti	rappresentante dell'assistenza tecnica ai clienti
rappresentante_di_vendita_all'esportazione	rappresentante di vendita all'esportazione
rappresentante_di_vendita_di_assicurazioni	rappresentante di vendita di assicurazioni
rappresentante_finanziario	rappresentante finanziario
rappresentante_per_le_pubbliche_relazioni	rappresentante per le pubbliche relazioni
rappresentante_speciale_per_i_reclami	rappresentante speciale per i reclami
reclutamento_del_vicedirettore	reclutamento del vicedirettore
reclutatore	reclutatore
reclutatore_a_contratto	reclutatore a contratto
reclutatore_di_agenzia	reclutatore di agenzia
reclutatore_di_ingegneria	reclutatore di ingegneria
reclutatore_di_tecnologia	reclutatore di tecnologia
reclutatore_di_vendita	reclutatore di vendita
reclutatore_esecutivo	reclutatore esecutivo
reclutatore_finanziario	reclutatore finanziario
reclutatore_internazionale	reclutatore internazionale
reclutatore_interno	reclutatore interno
reclutatore_medico	reclutatore medico
reclutatore_nazionale	reclutatore nazionale
reclutatore_per_l'acquisizione_di_talenti	reclutatore per l'acquisizione di talenti
reclutatore_principale	reclutatore principale
reclutatore_sanitario	reclutatore sanitario
reclutatore_scientifico	reclutatore scientifico
redattore_consultivo	redattore consultivo
redattore_di_commissione	redattore di commissione
redattore_legale	redattore legale
redattore_sportivo	redattore sportivo
regista	regista
regista_di_documentari	regista di documentari
regista_teatrale	regista teatrale
regista_televisivo	regista televisivo
relazioni_pubbliche	relazioni pubbliche
residente	residente
residente_in_anestesiologia	residente in anestesiologia
residente_in_farmacia	residente in farmacia
residente_in_medicina_interna	residente in medicina interna
responsabile_acquisizione_talenti	responsabile acquisizione talenti
responsabile_acquisti_internazionali	responsabile acquisti internazionali
responsabile_adempimenti_fiscali	responsabile adempimenti fiscali
responsabile_agenzia_di_viaggi	responsabile agenzia di viaggi
responsabile_area_esportazione	responsabile area esportazione
responsabile_commerciale_interattivo	responsabile commerciale interattivo
responsabile_culinario	responsabile culinario
responsabile_dei_costi	responsabile dei costi
responsabile_dei_media_digitali	responsabile dei media digitali
responsabile_dei_rapporti_con_il_private_banking	responsabile dei rapporti con il private banking
responsabile_dei_rapporti_con_le_banche_commerciali	responsabile dei rapporti con le banche commerciali
responsabile_dei_servizi_congressuali	responsabile dei servizi congressuali
responsabile_dei_servizi_creativi	responsabile dei servizi creativi
responsabile_dei_servizi_grafici	responsabile dei servizi grafici
responsabile_dei_soccorsi	responsabile dei soccorsi
responsabile_dei_trasporti_regionali	responsabile dei trasporti regionali
responsabile_del_centro_affari	responsabile del centro affari
responsabile_del_centro_congressi	responsabile del centro congressi
responsabile_del_centro_di_progettazione	responsabile del centro di progettazione
responsabile_del_centro_logistico	responsabile del centro logistico
responsabile_del_centro_servizi	responsabile del centro servizi
responsabile_del_contenzioso	responsabile del contenzioso
responsabile_del_coordinamento_del_progetto	responsabile del coordinamento del progetto
responsabile_del_design_creativo	responsabile del design creativo
responsabile_del_design_del_marchio	responsabile del design del marchio
responsabile_del_dipartimento_artistico	responsabile del dipartimento artistico
responsabile_del_dovere	responsabile del dovere
responsabile_del_front_office	responsabile del front office
responsabile_del_magazzino	responsabile del magazzino
responsabile_del_personale	responsabile del personale
responsabile_del_prodotto_senza_fili	responsabile del prodotto senza fili
responsabile_del_progetto	responsabile del progetto
responsabile_del_progetto_ambientale	responsabile del progetto ambientale
responsabile_del_progetto_creativo	responsabile del progetto creativo
responsabile_del_progetto_di_reclutamento	responsabile del progetto di reclutamento
responsabile_del_progetto_di_rete	responsabile del progetto di rete
responsabile_del_progetto_editoriale	responsabile del progetto editoriale
responsabile_del_progetto_software	responsabile del progetto software
responsabile_del_programma_ambientale	responsabile del programma ambientale
responsabile_del_programma_di_localizzazione	responsabile del programma di localizzazione
responsabile_del_programma_tecnico_del_personale	responsabile del programma tecnico del personale
responsabile_del_rapporto_con_il_cliente	responsabile del rapporto con il cliente
responsabile_del_reclutamento	responsabile del reclutamento
responsabile_del_reparto_logistico	responsabile del reparto logistico
responsabile_del_rischio	responsabile del rischio
responsabile_del_salone	responsabile del salone
responsabile_del_servizio_di_ristorazione	responsabile del servizio di ristorazione
responsabile_del_team_del_service_desk	responsabile del team del service desk
responsabile_del_team_del_software_integrato	responsabile del team del software integrato
responsabile_del_team_di_automazione	responsabile del team di automazione
responsabile_del_team_di_magazzino	responsabile del team di magazzino
responsabile_del_team_di_progettazione	responsabile del team di progettazione
responsabile_del_team_di_reclutamento	responsabile del team di reclutamento
responsabile_del_team_di_supporto_desktop	responsabile del team di supporto desktop
responsabile_del_team_di_supporto_tecnico	responsabile del team di supporto tecnico
responsabile_del_team_di_sviluppo_delle_applicazioni	responsabile del team di sviluppo delle applicazioni
responsabile_del_team_di_sviluppo_web	responsabile del team di sviluppo web
responsabile_del_team_di_telecomunicazioni	responsabile del team di telecomunicazioni
responsabile_del_team_hardware	responsabile del team hardware
responsabile_del_team_logistico	responsabile del team logistico
responsabile_dell'accoglienza	responsabile dell'accoglienza
responsabile_dell'account_di_reclutamento	responsabile dell'account di reclutamento
responsabile_dell'account_digitale	responsabile dell'account digitale
responsabile_dell'acquisizione_del_sito	responsabile dell'acquisizione del sito
responsabile_dell'assicurazione_delle_informazioni	responsabile dell'assicurazione delle informazioni
responsabile_dell'editoria	responsabile dell'editoria
responsabile_dell'implementazione_della_rete	responsabile dell'implementazione della rete
responsabile_dell'importazione	responsabile dell'importazione
responsabile_dell'inventario	responsabile dell'inventario
responsabile_dell'ospitalità	responsabile dell'ospitalità
responsabile_della_conferenza	responsabile della conferenza
responsabile_della_consulenza	responsabile della consulenza
responsabile_della_copia	responsabile della copia
responsabile_della_cucina	responsabile della cucina
responsabile_della_finanza_strutturata	responsabile della finanza strutturata
responsabile_della_fondazione	responsabile della fondazione
responsabile_della_formazione_personale	responsabile della formazione personale
responsabile_della_fotografia	responsabile della fotografia
responsabile_della_gestione_dei_clienti	responsabile della gestione dei clienti
responsabile_della_gestione_patrimoniale	responsabile della gestione patrimoniale
responsabile_della_logistica	responsabile della logistica
responsabile_della_logistica_aziendale	responsabile della logistica aziendale
responsabile_della_logistica_di_gruppo	responsabile della logistica di gruppo
responsabile_della_logistica_globale	responsabile della logistica globale
responsabile_della_logistica_internazionale	responsabile della logistica internazionale
responsabile_della_logistica_nazionale	responsabile della logistica nazionale
responsabile_della_logistica_regionale	responsabile della logistica regionale
responsabile_della_messa_in_servizio	responsabile della messa in servizio
responsabile_della_panetteria	responsabile della panetteria
responsabile_della_perforazione	responsabile della perforazione
responsabile_della_pianificazione_strategica	responsabile della pianificazione strategica
responsabile_della_posizione	responsabile della posizione
responsabile_della_post_produzione	responsabile della post produzione
responsabile_della_precostruzione	responsabile della precostruzione
responsabile_della_produzione_di_stampa	responsabile della produzione di stampa
responsabile_della_produzione_editoriale	responsabile della produzione editoriale
responsabile_della_progettazione_fisica	responsabile della progettazione fisica
responsabile_della_pubblicità	responsabile della pubblicità
responsabile_della_pubblicità_online	responsabile della pubblicità online
responsabile_della_pubblicità_riservata	responsabile della pubblicità riservata
responsabile_della_raccolta_fondi	responsabile della raccolta fondi
responsabile_della_reception	responsabile della reception
responsabile_della_sicurezza_alimentare	responsabile della sicurezza alimentare
responsabile_della_spedizione	responsabile della spedizione
responsabile_della_strategia_e_delle_operazioni	responsabile della strategia e delle operazioni
responsabile_delle_collezioni_di_zona	responsabile delle collezioni di zona
responsabile_delle_comunicazioni	responsabile delle comunicazioni
responsabile_delle_comunicazioni_esterne	responsabile delle comunicazioni esterne
responsabile_delle_comunicazioni_globali	responsabile delle comunicazioni globali
responsabile_delle_donazioni_annuali	responsabile delle donazioni annuali
responsabile_delle_entrate_regionale	responsabile delle entrate regionale
responsabile_delle_esportazioni	responsabile delle esportazioni
responsabile_delle_imposte_sulle_società	responsabile delle imposte sulle società
responsabile_delle_informazioni_mediche	responsabile delle informazioni mediche
responsabile_delle_linee_personali	responsabile delle linee personali
responsabile_delle_operazioni_a_terra	responsabile delle operazioni a terra
responsabile_delle_operazioni_di_investimento	responsabile delle operazioni di investimento
responsabile_delle_operazioni_di_magazzino	responsabile delle operazioni di magazzino
responsabile_delle_operazioni_di_notizie	responsabile delle operazioni di notizie
responsabile_delle_operazioni_di_reclutamento	responsabile delle operazioni di reclutamento
responsabile_delle_operazioni_di_volo	responsabile delle operazioni di volo
responsabile_delle_operazioni_e_della_logistica	responsabile delle operazioni e della logistica
responsabile_delle_operazioni_marittime	responsabile delle operazioni marittime
responsabile_delle_politiche_pubbliche	responsabile delle politiche pubbliche
responsabile_delle_pubblicazioni	responsabile delle pubblicazioni
responsabile_delle_pubbliche_relazioni	responsabile delle pubbliche relazioni
responsabile_delle_pubbliche_relazioni_globali	responsabile delle pubbliche relazioni globali
responsabile_delle_pubbliche_relazioni_internazionali	responsabile delle pubbliche relazioni internazionali
responsabile_delle_pulizie	responsabile delle pulizie
responsabile_delle_relazioni_con_gli_ex_studenti	responsabile delle relazioni con gli ex studenti
responsabile_delle_relazioni_con_i_donatori	responsabile delle relazioni con i donatori
responsabile_delle_risorse	responsabile delle risorse
responsabile_delle_risorse_umane_di_gruppo	responsabile delle risorse umane di gruppo
responsabile_delle_spedizioni	responsabile delle spedizioni
responsabile_delle_telecomunicazioni	responsabile delle telecomunicazioni
responsabile_delle_terme	responsabile delle terme
responsabile_dello_studio_di_progettazione	responsabile dello studio di progettazione
responsabile_dello_sviluppo_aziendale	responsabile dello sviluppo aziendale
responsabile_dello_sviluppo_del_business	responsabile dello sviluppo del business
responsabile_dello_sviluppo_del_business_globale	responsabile dello sviluppo del business globale
responsabile_dello_sviluppo_del_percorso	responsabile dello sviluppo del percorso
responsabile_dello_sviluppo_economico	responsabile dello sviluppo economico
responsabile_dello_sviluppo_strategico	responsabile dello sviluppo strategico
responsabile_dello_sviluppo_web	responsabile dello sviluppo web
responsabile_di_agenzia	responsabile di agenzia
responsabile_di_eventi_di_ristorazione	responsabile di eventi di ristorazione
responsabile_di_viaggio	responsabile di viaggio
responsabile_di_viaggio_globale	responsabile di viaggio globale
responsabile_dietetico	responsabile dietetico
responsabile_distrettuale_della_protezione_del_patrimonio	responsabile distrettuale della protezione del patrimonio
responsabile_divisione_camere	responsabile divisione camere
responsabile_editoriale	responsabile editoriale
responsabile_export_regionale	responsabile export regionale
responsabile_farmacia_clinica	responsabile farmacia clinica
responsabile_fiscale	responsabile fiscale
responsabile_fiscale_federale	responsabile fiscale federale
responsabile_fitness	responsabile fitness
responsabile_grafico	responsabile grafico
responsabile_ingegneria_elettrica	responsabile ingegneria elettrica
responsabile_ingegneria_sul_campo	responsabile ingegneria sul campo
responsabile_magazzino_e_distribuzione	responsabile magazzino e distribuzione
responsabile_magazzino_e_logistica	responsabile magazzino e logistica
responsabile_marketing_acquisizioni	responsabile marketing acquisizioni
responsabile_marketing_dei_contenuti	responsabile marketing dei contenuti
responsabile_marketing_digitale	responsabile marketing digitale
responsabile_marketing_e_comunicazione	responsabile marketing e comunicazione
responsabile_marketing_integrato	responsabile marketing integrato
responsabile_marketing_secondario	responsabile marketing secondario
responsabile_marketing_social	responsabile marketing social
responsabile_media_e_comunicazione	responsabile media e comunicazione
responsabile_nazionale_delle_risorse_umane	responsabile nazionale delle risorse umane
responsabile_operativo_della_farmacia	responsabile operativo della farmacia
responsabile_post_produzione	responsabile post produzione
responsabile_produzione_video	responsabile produzione video
responsabile_progettazione_meccanica	responsabile progettazione meccanica
responsabile_radiologico	responsabile radiologico
responsabile_reclutamento_account	responsabile reclutamento account
responsabile_reclutamento_e_formazione	responsabile reclutamento e formazione
responsabile_reclutamento_e_selezione	responsabile reclutamento e selezione
responsabile_reclutamento_laureati	responsabile reclutamento laureati
responsabile_reclutamento_regionale	responsabile reclutamento regionale
responsabile_reclutamento_tecnico	responsabile reclutamento tecnico
responsabile_regionale_della_produzione	responsabile regionale della produzione
responsabile_reparto_elettrico	responsabile reparto elettrico
responsabile_ristorante_e_bar	responsabile ristorante e bar
responsabile_spedizioni_e_ricevimenti	responsabile spedizioni e ricevimenti
responsabile_stampa_e_pubbliche_relazioni	responsabile stampa e pubbliche relazioni
responsabile_sviluppo_web	responsabile sviluppo web
responsabile_tecnico_del_gruppo	responsabile tecnico del gruppo
responsabile_tecnico_java	responsabile tecnico java
responsabile_ufficio_tecnico	responsabile ufficio tecnico
responsabile_unità_produttiva	responsabile unità produttiva
responsabile_vendite_della_comunità	responsabile vendite della comunità
responsabile_vendite_digitali	responsabile vendite digitali
responsabile_vendite_e_commercio	responsabile vendite e commercio
responsabile_vendite_esportazione	responsabile vendite esportazione
responsabile_vendite_locale	responsabile vendite locale
responsabile_vendite_mutui	responsabile vendite mutui
responsabile_viaggi_aziendali	responsabile viaggi aziendali
revisore_dei_conti	revisore dei conti
revisore_fiscale	revisore fiscale
ricercatore_dei_media	ricercatore dei media
ricercatore_del_personale	ricercatore del personale
ricercatore_legale	ricercatore legale
ricercatore_post-laurea	ricercatore post-laurea
ricercatore_principale	ricercatore principale
rigger_di_personaggi	rigger di personaggi
risorse_esecutive	risorse esecutive
ristoratore	ristoratore
ritoccatore	ritoccatore
saluto	saluto
sceneggiatore	sceneggiatore
sceneggiatore_di_casa	sceneggiatore di casa
sceriffo	sceriffo
scienziato_ambientale	scienziato ambientale
scienziato_del_cibo	scienziato del cibo
scienziato_di_ricerca_e_sviluppo	scienziato di ricerca e sviluppo
scrittore	scrittore
scrittore_collaboratore	scrittore collaboratore
scrittore_creativo	scrittore creativo
scrittore_di_affari	scrittore di affari
scrittore_di_caratteristiche	scrittore di caratteristiche
scrittore_di_contenuti_web	scrittore di contenuti web
scrittore_di_contratto	scrittore di contratto
scrittore_di_viaggio	scrittore di viaggio
scrittore_editoriale	scrittore editoriale
scrittore_finanziario	scrittore finanziario
scultore	scultore
secondo_assistente	secondo assistente
secondo_assistente_alla_regia	secondo assistente alla regia
secondo_ufficiale	secondo ufficiale
secondo_vicedirettore	secondo vicedirettore
segretario_di_produzione	segretario di produzione
segretario_esecutivo_bilingue	segretario esecutivo bilingue
segretario_legale_esecutivo	segretario legale esecutivo
selettore_d'ordine	selettore d'ordine
selezionatore	selezionatore
selezionatore_di_ordini	selezionatore di ordini
sergente	sergente
sergente_di_pattuglia	sergente di pattuglia
sergente_di_polizia	sergente di polizia
server	server
server_del_ristorante	server del ristorante
server_per_banchetti	server per banchetti
servitore_di_cibo	servitore di cibo
servitore_di_cocktail	servitore di cocktail
servizi_per_clienti_privati	servizi per clienti privati
servizio_civile	servizio civile
servizio_clienti_cassiere	servizio clienti cassiere
servizio_ora_sviluppatore	servizio ora sviluppatore
set_assistente_alla_produzione	set assistente alla produzione
set_comò	set comò
social_media_manager	social media manager
società_di_software	società di software
socio	socio
socio_accomandante	socio accomandante
socio_commerciale	socio commerciale
socio_di_borsa	socio di borsa
socio_di_equità	socio di equità
socio_di_private_equity	socio di private equity
socio_dirigente	socio dirigente
socio_dirigente_d'ufficio	socio dirigente d'ufficio
socio_fondatore	socio fondatore
socio_laureato	socio laureato
socio_walmart	socio walmart
soldato	soldato
sostenitore	sostenitore
sostituto_difensore_pubblico	sostituto difensore pubblico
sottoscrittore_di_campo	sottoscrittore di campo
sottoscrittore_di_linee_personali	sottoscrittore di linee personali
sottoscrittore_di_mutui	sottoscrittore di mutui
sottoscrittore_di_prestiti_al_consumo	sottoscrittore di prestiti al consumo
sottoscrittore_di_produzione	sottoscrittore di produzione
sottoscrittore_di_vita	sottoscrittore di vita
sous_chef	sous chef
sous_chef_esecutivo	sous chef esecutivo
sovrintendente_al_progetto	sovrintendente al progetto
sovrintendente_alla_costruzione	sovrintendente alla costruzione
sovrintendente_alla_perforazione	sovrintendente alla perforazione
sovrintendente_del_sito	sovrintendente del sito
sovrintendente_generale	sovrintendente generale
sovrintendente_marittimo	sovrintendente marittimo
sovrintendente_tecnico	sovrintendente tecnico
specialista_accademico	specialista accademico
specialista_assicurativo	specialista assicurativo
specialista_certificato_di_pianificazione_dei_mutui	specialista certificato di pianificazione dei mutui
specialista_commerciale	specialista commerciale
specialista_d'arte	specialista d'arte
specialista_degli_insediamenti	specialista degli insediamenti
specialista_dei_social_media	specialista dei social media
specialista_del_colore	specialista del colore
specialista_del_commercio_internazionale	specialista del commercio internazionale
specialista_del_credito	specialista del credito
specialista_del_fitness	specialista del fitness
specialista_del_lavoro	specialista del lavoro
specialista_del_magazzino	specialista del magazzino
specialista_del_mutuo_per_la_casa	specialista del mutuo per la casa
specialista_del_personale	specialista del personale
specialista_del_reclutamento	specialista del reclutamento
specialista_del_reclutamento_di_risorse_umane	specialista del reclutamento di risorse umane
specialista_del_reddito_fisso	specialista del reddito fisso
specialista_del_servizio_di_assistenza	specialista del servizio di assistenza
specialista_del_supporto_desktop	specialista del supporto desktop
specialista_del_supporto_per_l'utente_finale	specialista del supporto per l'utente finale
specialista_del_supporto_regionale	specialista del supporto regionale
specialista_del_trasloco	specialista del trasloco
specialista_dell'assistenza_agli_utenti	specialista dell'assistenza agli utenti
specialista_dell'assistenza_clienti	specialista dell'assistenza clienti
specialista_dell'esportazione	specialista dell'esportazione
specialista_dell'home_theater	specialista dell'home theater
specialista_dell'importazione	specialista dell'importazione
specialista_dell'istruzione	specialista dell'istruzione
specialista_della_comunicazione	specialista della comunicazione
specialista_della_fotografia	specialista della fotografia
specialista_della_lettura	specialista della lettura
specialista_della_localizzazione	specialista della localizzazione
specialista_della_vista	specialista della vista
specialista_delle_risorse	specialista delle risorse
specialista_di_applicazioni_web	specialista di applicazioni web
specialista_di_eventi	specialista di eventi
specialista_di_microcomputer	specialista di microcomputer
specialista_di_mutui_ipotecari	specialista di mutui ipotecari
specialista_di_processo	specialista di processo
specialista_di_rete	specialista di rete
specialista_di_software	specialista di software
specialista_di_vendita_di_consulenza	specialista di vendita di consulenza
specialista_di_viaggi	specialista di viaggi
specialista_elettronico	specialista elettronico
specialista_fallimentare	specialista fallimentare
specialista_fiscale	specialista fiscale
specialista_grafico	specialista grafico
specialista_hardware	specialista hardware
specialista_immobiliare	specialista immobiliare
specialista_immobiliare_commerciale	specialista immobiliare commerciale
specialista_in_acquisizione_di_talenti	specialista in acquisizione di talenti
specialista_in_alfabetizzazione	specialista in alfabetizzazione
specialista_in_applicazioni_cliniche	specialista in applicazioni cliniche
specialista_in_automazione	specialista in automazione
specialista_in_automazione_dei_test	specialista in automazione dei test
specialista_in_azioni	specialista in azioni
specialista_in_banca_d'affari	specialista in banca d'affari
specialista_in_chiusura	specialista in chiusura
specialista_in_comunicazione_web	specialista in comunicazione web
specialista_in_comunicazioni_di_marketing	specialista in comunicazioni di marketing
specialista_in_contenzioso	specialista in contenzioso
specialista_in_derivati	specialista in derivati
specialista_in_farmacia_clinica	specialista in farmacia clinica
specialista_in_fondi_comuni_di_investimento	specialista in fondi comuni di investimento
specialista_in_gestione_dei_talenti	specialista in gestione dei talenti
specialista_in_ingegneria_di_processo	specialista in ingegneria di processo
specialista_in_investimenti	specialista in investimenti
specialista_in_marketing_e_pubbliche_relazioni	specialista in marketing e pubbliche relazioni
specialista_in_media_bibliotecari	specialista in media bibliotecari
specialista_in_media_delle_biblioteche_scolastiche	specialista in media delle biblioteche scolastiche
specialista_in_nuovi_affari	specialista in nuovi affari
specialista_in_personal_computer	specialista in personal computer
specialista_in_politica	specialista in politica
specialista_in_preclusione	specialista in preclusione
specialista_in_prestito	specialista in prestito
specialista_in_produzione_multimediale	specialista in produzione multimediale
specialista_in_produzione_video	specialista in produzione video
specialista_in_proprietà_intellettuale	specialista in proprietà intellettuale
specialista_in_protezione_ambientale	specialista in protezione ambientale
specialista_in_pubbliche_relazioni	specialista in pubbliche relazioni
specialista_in_pubblicità	specialista in pubblicità
specialista_in_reti_dati	specialista in reti dati
specialista_in_reti_informatiche	specialista in reti informatiche
specialista_in_salute_e_fitness	specialista in salute e fitness
specialista_in_sicurezza_di_rete	specialista in sicurezza di rete
specialista_in_sistemi_di_controllo	specialista in sistemi di controllo
specialista_in_sviluppo_aziendale	specialista in sviluppo aziendale
specialista_in_telecomunicazioni	specialista in telecomunicazioni
specialista_investigativo	specialista investigativo
specialista_legale	specialista legale
specialista_meccanico	specialista meccanico
specialista_nel_campo_dell'agenzia	specialista nel campo dell'agenzia
specialista_operativo	specialista operativo
specialista_tecnico_regionale	specialista tecnico regionale
specialista_wireless	specialista wireless
spedizioniere	spedizioniere
spedizioniere_di_emergenza	spedizioniere di emergenza
staff_della_cucina	staff della cucina
stagista	stagista
stagista_acquisizione_talenti	stagista acquisizione talenti
stagista_archivi	stagista archivi
stagista_cibo_e_bevande	stagista cibo e bevande
stagista_collezionista	stagista collezionista
stagista_creativo	stagista creativo
stagista_del_programma_di_gestione_finanziaria	stagista del programma di gestione finanziaria
stagista_del_programma_universitario	stagista del programma universitario
stagista_di_ammissione	stagista di ammissione
stagista_di_animazione	stagista di animazione
stagista_di_gestione_del_rischio	stagista di gestione del rischio
stagista_di_musica	stagista di musica
stagista_di_private_equity	stagista di private equity
stagista_di_progettazione	stagista di progettazione
stagista_di_progettazione_e_produzione	stagista di progettazione e produzione
stagista_di_ricerca_sul_patrimonio	stagista di ricerca sul patrimonio
stagista_di_servizi_creativi	stagista di servizi creativi
stagista_direzione_artistica	stagista direzione artistica
stagista_edile	stagista edile
stagista_front_office	stagista front office
stagista_grafica	stagista grafica
stagista_in_architettura_del_paesaggio	stagista in architettura del paesaggio
stagista_in_banca_d'investimento	stagista in banca d'investimento
stagista_in_fashion_design	stagista in fashion design
stagista_in_finanza_aziendale	stagista in finanza aziendale
stagista_in_ingegneria_civile	stagista in ingegneria civile
stagista_in_ingegneria_dei_sistemi	stagista in ingegneria dei sistemi
stagista_in_ingegneria_del_design	stagista in ingegneria del design
stagista_in_ingegneria_del_software	stagista in ingegneria del software
stagista_in_ingegneria_meccanica	stagista in ingegneria meccanica
stagista_legale_certificato	stagista legale certificato
stagista_medico	stagista medico
stagista_multimediale	stagista multimediale
stagista_post_produzione	stagista post produzione
stagista_sportivo	stagista sportivo
stagista_supporto_desktop	stagista supporto desktop
stagista_sviluppo_web	stagista sviluppo web
stagista_ufficio_legale	stagista ufficio legale
stagista_visual_merchandising	stagista visual merchandising
steward	steward
stilista	stilista
stilista_di_abbigliamento	stilista di abbigliamento
stilista_di_abbigliamento_femminile	stilista di abbigliamento femminile
stilista_di_abbigliamento_maschile	stilista di abbigliamento maschile
stilista_di_calzature	stilista di calzature
stilista_di_capelli	stilista di capelli
stilista_di_guardaroba	stilista di guardaroba
stilista_di_maglieria	stilista di maglieria
stilista_di_moda	stilista di moda
stilista_fotografico	stilista fotografico
stimatore_di_progetto	stimatore di progetto
stratega_degli_investimenti	stratega degli investimenti
stratega_dei_contenuti	stratega dei contenuti
stratega_dei_media	stratega dei media
stratega_dei_social_media	stratega dei social media
stratega_del_prodotto	stratega del prodotto
stratega_dell'account	stratega dell'account
stratega_di_equità	stratega di equità
stratega_di_marketing	stratega di marketing
strategia_vp	strategia vp
studente_di_architettura	studente di architettura
studente_di_grafica	studente di grafica
studente_di_infermieristica	studente di infermieristica
studente_di_informatica	studente di informatica
studente_di_ingegneria_meccanica	studente di ingegneria meccanica
studente_laureato	studente laureato
studente_volontario	studente volontario
sub_insegnante	sub insegnante
sulla_personalità_dell'aria	sulla personalità dell'aria
supervisore_al_controllo_delle_scorte	supervisore al controllo delle scorte
supervisore_all'accoglienza	supervisore all'accoglienza
supervisore_all'attuazione	supervisore all'attuazione
supervisore_alla_pianificazione_dei_media	supervisore alla pianificazione dei media
supervisore_alla_progettazione_grafica	supervisore alla progettazione grafica
supervisore_alle_assunzioni	supervisore alle assunzioni
supervisore_artistico_di_gruppo	supervisore artistico di gruppo
supervisore_cibo_e_bevande	supervisore cibo e bevande
supervisore_civile	supervisore civile
supervisore_clinico	supervisore clinico
supervisore_commerciale	supervisore commerciale
supervisore_dei_contenuti	supervisore dei contenuti
supervisore_dei_media	supervisore dei media
supervisore_dei_media_digitali	supervisore dei media digitali
supervisore_dei_prezzi	supervisore dei prezzi
supervisore_dei_servizi_creativi	supervisore dei servizi creativi
supervisore_dei_servizi_per_gli_ospiti	supervisore dei servizi per gli ospiti
supervisore_dei_trasporti	supervisore dei trasporti
supervisore_del_banchetto	supervisore del banchetto
supervisore_del_bar	supervisore del bar
supervisore_del_centro_di_distribuzione	supervisore del centro di distribuzione
supervisore_del_conto	supervisore del conto
supervisore_del_credito	supervisore del credito
supervisore_del_datacenter	supervisore del datacenter
supervisore_del_ristorante	supervisore del ristorante
supervisore_del_supporto_del_sistema	supervisore del supporto del sistema
supervisore_del_supporto_tecnico	supervisore del supporto tecnico
supervisore_dell'animazione	supervisore dell'animazione
supervisore_dell'helpdesk	supervisore dell'helpdesk
supervisore_dell'infrastruttura	supervisore dell'infrastruttura
supervisore_dell'istruzione_speciale	supervisore dell'istruzione speciale
supervisore_della_casa	supervisore della casa
supervisore_della_copia	supervisore della copia
supervisore_della_copia_di_gruppo	supervisore della copia di gruppo
supervisore_della_farmacia	supervisore della farmacia
supervisore_della_pubblicità	supervisore della pubblicità
supervisore_della_ristorazione	supervisore della ristorazione
supervisore_della_sceneggiatura	supervisore della sceneggiatura
supervisore_della_spedizione	supervisore della spedizione
supervisore_della_strategia	supervisore della strategia
supervisore_delle_buste_paga	supervisore delle buste paga
supervisore_delle_operazioni_aeroportuali	supervisore delle operazioni aeroportuali
supervisore_delle_operazioni_di_filiale	supervisore delle operazioni di filiale
supervisore_delle_pubbliche_relazioni	supervisore delle pubbliche relazioni
supervisore_delle_relazioni_con_gli_ospiti	supervisore delle relazioni con gli ospiti
supervisore_delle_telecomunicazioni	supervisore delle telecomunicazioni
supervisore_di_chiusura	supervisore di chiusura
supervisore_di_contabilità_generale	supervisore di contabilità generale
supervisore_di_cucina	supervisore di cucina
supervisore_di_front_office	supervisore di front office
supervisore_di_gestione	supervisore di gestione
supervisore_di_perforazione	supervisore di perforazione
supervisore_di_radiologia	supervisore di radiologia
supervisore_di_trasmissione	supervisore di trasmissione
supervisore_digitale	supervisore digitale
supervisore_editoriale	supervisore editoriale
supervisore_fiscale	supervisore fiscale
supervisore_front-end	supervisore front-end
supervisore_immagini	supervisore immagini
supervisore_logistico	supervisore logistico
supervisore_marketing_commerciale	supervisore marketing commerciale
supervisore_post_produzione	supervisore post produzione
supervisore_ricevente	supervisore ricevente
supervisore_tecnico_di_prodotto	supervisore tecnico di prodotto
supplente	supplente
supporta_il_tecnico	supporta il tecnico
supporto_desktop	supporto desktop
supporto_di_prima_linea	supporto di prima linea
supporto_tecnico	supporto tecnico
sviluppatore	sviluppatore
sviluppatore_Android	sviluppatore Android
sviluppatore_back-end	sviluppatore back-end
sviluppatore_creativo	sviluppatore creativo
sviluppatore_del_personale	sviluppatore del personale
sviluppatore_di_affari	sviluppatore di affari
sviluppatore_di_app_ios	sviluppatore di app ios
sviluppatore_di_applicazioni	sviluppatore di applicazioni
sviluppatore_di_applicazioni_java	sviluppatore di applicazioni java
sviluppatore_di_applicazioni_mobili	sviluppatore di applicazioni mobili
sviluppatore_di_applicazioni_software	sviluppatore di applicazioni software
sviluppatore_di_applicazioni_web	sviluppatore di applicazioni web
sviluppatore_di_automazione	sviluppatore di automazione
sviluppatore_di_concetti	sviluppatore di concetti
sviluppatore_di_contenuti	sviluppatore di contenuti
sviluppatore_di_database	sviluppatore di database
sviluppatore_di_interfaccia_utente_web	sviluppatore di interfaccia utente web
sviluppatore_di_prodotti	sviluppatore di prodotti
sviluppatore_di_soluzioni	sviluppatore di soluzioni
sviluppatore_di_strumenti	sviluppatore di strumenti
sviluppatore_hardware	sviluppatore hardware
sviluppatore_html5	sviluppatore html5
sviluppatore_interattivo	sviluppatore interattivo
sviluppatore_j2ee	sviluppatore j2ee
sviluppatore_java	sviluppatore java
sviluppatore_java_a_contratto	sviluppatore java a contratto
sviluppatore_java/j2ee	sviluppatore java/j2ee
sviluppatore_lato_client	sviluppatore lato client
sviluppatore_open_source	sviluppatore open source
sviluppatore_web_a_contratto	sviluppatore web a contratto
sviluppatore_web_java	sviluppatore web java
sviluppatore_web_php	sviluppatore web php
tastierista	tastierista
tecnico	tecnico
tecnico_ad_ultrasuoni	tecnico ad ultrasuoni
tecnico_addetto_alla_manutenzione_delle_apparecchiature	tecnico addetto alla manutenzione delle apparecchiature
tecnico_ambientale	tecnico ambientale
tecnico_anestesista	tecnico anestesista
tecnico_applicativo	tecnico applicativo
tecnico_archivistico	tecnico archivistico
tecnico_autorizzato	tecnico autorizzato
tecnico_avionico	tecnico avionico
tecnico_commerciale_di_zona	tecnico commerciale di zona
tecnico_da_banco	tecnico da banco
tecnico_dei_media	tecnico dei media
tecnico_dei_pavimenti	tecnico dei pavimenti
tecnico_dei_sistemi_informatici	tecnico dei sistemi informatici
tecnico_del_controllo_di_rete	tecnico del controllo di rete
tecnico_del_personale	tecnico del personale
tecnico_del_pronto_soccorso	tecnico del pronto soccorso
tecnico_del_servizio_assistenza	tecnico del servizio assistenza
tecnico_del_servizio_informatico	tecnico del servizio informatico
tecnico_del_supporto_desktop	tecnico del supporto desktop
tecnico_del_supporto_di_rete	tecnico del supporto di rete
tecnico_del_supporto_hardware	tecnico del supporto hardware
tecnico_del_supporto_remoto	tecnico del supporto remoto
tecnico_del_supporto_tecnico	tecnico del supporto tecnico
tecnico_dell'assistenza_agli_utenti	tecnico dell'assistenza agli utenti
tecnico_dell'assistenza_clienti	tecnico dell'assistenza clienti
tecnico_dell'assistenza_tecnica_al_cliente	tecnico dell'assistenza tecnica al cliente
tecnico_dell'assistenza_tecnica_alle_vendite	tecnico dell'assistenza tecnica alle vendite
tecnico_dell'automazione	tecnico dell'automazione
tecnico_dell'help_desk	tecnico dell'help desk
tecnico_della_salute_comportamentale	tecnico della salute comportamentale
tecnico_delle_comunicazioni	tecnico delle comunicazioni
tecnico_delle_telecomunicazioni	tecnico delle telecomunicazioni
tecnico_dello_sviluppo	tecnico dello sviluppo
tecnico_di_apparecchiature_biomediche	tecnico di apparecchiature biomediche
tecnico_di_configurazione	tecnico di configurazione
tecnico_di_distribuzione	tecnico di distribuzione
tecnico_di_garanzia_della_qualità	tecnico di garanzia della qualità
tecnico_di_immagini_digitali	tecnico di immagini digitali
tecnico_di_ingegneria_civile	tecnico di ingegneria civile
tecnico_di_ingegneria_meccanica	tecnico di ingegneria meccanica
tecnico_di_laboratorio_fotografico	tecnico di laboratorio fotografico
tecnico_di_laboratorio_informatico	tecnico di laboratorio informatico
tecnico_di_personal_computer	tecnico di personal computer
tecnico_di_pianoforte	tecnico di pianoforte
tecnico_di_prodotto	tecnico di prodotto
tecnico_di_radiologia	tecnico di radiologia
tecnico_di_rete	tecnico di rete
tecnico_di_rete_informatica	tecnico di rete informatica
tecnico_di_ricerca_e_sviluppo	tecnico di ricerca e sviluppo
tecnico_di_supporto	tecnico di supporto
tecnico_di_supporto_alla_rete	tecnico di supporto alla rete
tecnico_di_supporto_alla_scrivania	tecnico di supporto alla scrivania
tecnico_di_supporto_applicativo	tecnico di supporto applicativo
tecnico_di_supporto_del_prodotto	tecnico di supporto del prodotto
tecnico_di_supporto_del_sistema	tecnico di supporto del sistema
tecnico_di_supporto_dell'helpdesk	tecnico di supporto dell'helpdesk
tecnico_di_supporto_desktop	tecnico di supporto desktop
tecnico_di_supporto_informatico	tecnico di supporto informatico
tecnico_di_supporto_software	tecnico di supporto software
tecnico_di_supporto_sul_campo	tecnico di supporto sul campo
tecnico_di_supporto_tecnologico	tecnico di supporto tecnologico
tecnico_di_sviluppo_prodotto	tecnico di sviluppo prodotto
tecnico_di_trasmissione	tecnico di trasmissione
tecnico_farmaceutico_certificato	tecnico farmaceutico certificato
tecnico_fiscale	tecnico fiscale
tecnico_geologico	tecnico geologico
tecnico_grafico	tecnico grafico
tecnico_hardware	tecnico hardware
tecnico_hardware_informatico	tecnico hardware informatico
tecnico_in_loco	tecnico in loco
tecnico_informatico	tecnico informatico
tecnico_medico_di_emergenza	tecnico medico di emergenza
tecnico_operativo_sul_campo	tecnico operativo sul campo
tecnico_per_la_cura_degli_animali	tecnico per la cura degli animali
tecnico_redattore	tecnico redattore
tecnico_riparatore	tecnico riparatore
tecnico_riparatore_di_personal_computer	tecnico riparatore di personal computer
tecnico_riscaldamento_e_condizionamento	tecnico riscaldamento e condizionamento
tecnico_senza_fili	tecnico senza fili
tecnico_sul_campo	tecnico sul campo
tecnico_veterinario	tecnico veterinario
tecnico_veterinario_iscritto_all'albo	tecnico veterinario iscritto all'albo
tecnologia	tecnologia
tecnologo_di_medicina_nucleare	tecnologo di medicina nucleare
tecnologo_di_processo	tecnologo di processo
tecnologo_vascolare	tecnologo vascolare
tenente	tenente
tenente_dei_vigili_del_fuoco	tenente dei vigili del fuoco
tenente_di_polizia	tenente di polizia
terapeuta_clinico	terapeuta clinico
terapeuta_educativo	terapeuta educativo
terapeuta_matrimoniale_e_familiare	terapeuta matrimoniale e familiare
terapeuta_matrimoniale_e_familiare_autorizzata	terapeuta matrimoniale e familiare autorizzata
terapeuta_scolastico	terapeuta scolastico
terapista	terapista
testa_di_copia	testa di copia
testata_tecnica	testata tecnica
tester_dell'applicazione	tester dell'applicazione
tirocinante_ingegneria_del_software	tirocinante ingegneria del software
tirocinante_software	tirocinante software
tirocinio_per_sviluppatori_software	tirocinio per sviluppatori software
titolare_del_salone	titolare del salone
titolare_dell'agenzia	titolare dell'agenzia
titolo_1_insegnante	titolo 1 insegnante
toelettatore	toelettatore
trader_di_derivati_azionari	trader di derivati azionari
traduttore_giapponese	traduttore giapponese
traduttore_inglese	traduttore inglese
traduttore_interno	traduttore interno
traduttore_spagnolo	traduttore spagnolo
traduttore_tecnico	traduttore tecnico
truccatrice_e_parrucchiera	truccatrice e parrucchiera
truccatrice_professionista	truccatrice professionista
tutor_di_alfabetizzazione	tutor di alfabetizzazione
tutor_di_informatica	tutor di informatica
tutor_di_lettura	tutor di lettura
tutor_spagnolo	tutor spagnolo
ufficiale_degli_ex_alunni	ufficiale degli ex alunni
ufficiale_dei_vigili_del_fuoco	ufficiale dei vigili del fuoco
ufficiale_del_titolo	ufficiale del titolo
ufficiale_dell'udito	ufficiale dell'udito
ufficiale_delle_forze_dell'ordine	ufficiale delle forze dell'ordine
ufficiale_delle_operazioni	ufficiale delle operazioni
ufficiale_di_correzione	ufficiale di correzione
ufficiale_di_credito	ufficiale di credito
ufficiale_di_difesa	ufficiale di difesa
ufficiale_di_esportazione	ufficiale di esportazione
ufficiale_di_guardia	ufficiale di guardia
ufficiale_di_legge	ufficiale di legge
ufficiale_di_marina	ufficiale di marina
ufficiale_di_mezzo	ufficiale di mezzo
ufficiale_di_pace	ufficiale di pace
ufficiale_di_polizia	ufficiale di polizia
ufficiale_di_relazione	ufficiale di relazione
ufficiale_investigativo	ufficiale investigativo
ufficiale_marittimo	ufficiale marittimo
ufficiale_medico_residente	ufficiale medico residente
vendita_di_derivati_azionari	vendita di derivati azionari
vendite_di_azioni	vendite di azioni
venditore_al_dettaglio	venditore al dettaglio
vettore_rurale	vettore rurale
vice_cancelliere	vice cancelliere
vice_capo_dei_vigili_del_fuoco	vice capo dei vigili del fuoco
vice_capo_della_polizia	vice capo della polizia
vice_decano_delle_ammissioni	vice decano delle ammissioni
vice_ministro	vice ministro
vice_procuratore_comunale	vice procuratore comunale
vice_procuratore_distrettuale	vice procuratore distrettuale
vice_procuratore_generale	vice procuratore generale
vice_sceriffo	vice sceriffo
vice_segretario	vice segretario
viceconsigliere_generale	viceconsigliere generale
vicedirettore	vicedirettore
vicedirettore_capo	vicedirettore capo
vicedirettore_creativo	vicedirettore creativo
vicedirettore_del_fondo_annuale	vicedirettore del fondo annuale
vicedirettore_della_comunicazione	vicedirettore della comunicazione
vicedirettore_della_ristorazione	vicedirettore della ristorazione
vicedirettore_della_sicurezza	vicedirettore della sicurezza
vicedirettore_delle_ammissioni_universitarie	vicedirettore delle ammissioni universitarie
vicedirettore_delle_pulizie	vicedirettore delle pulizie
vicedirettore_dello_sviluppo_aziendale	vicedirettore dello sviluppo aziendale
vicedirettore_di_banca	vicedirettore di banca
vicedirettore_di_farmacia	vicedirettore di farmacia
vicedirettore_editoriale	vicedirettore editoriale
vicedirettore_infermieristico	vicedirettore infermieristico
vicedirettore_legale	vicedirettore legale
vicedirettore_scolastico	vicedirettore scolastico
vicepresidente_del_consiglio_di_amministrazione	vicepresidente del consiglio di amministrazione
vicepresidente_della_gestione_dei_talenti	vicepresidente della gestione dei talenti
vicepresidente_esecutivo_dello_sviluppo_aziendale	vicepresidente esecutivo dello sviluppo aziendale
videogiornalista	videogiornalista
videografo	videografo
vigile_del_fuoco	vigile del fuoco
visitatore_sanitario	visitatore sanitario
vp	vp
vp_della_gestione_patrimoniale	vp della gestione patrimoniale
vp_delle_operazioni_commerciali	vp delle operazioni commerciali
vp_delle_relazioni_esterne	vp delle relazioni esterne
vp_delle_vendite_di_azioni_istituzionali	vp delle vendite di azioni istituzionali
vp_delle_vendite_istituzionali	vp delle vendite istituzionali
vp_dello_sviluppo_del_business	vp dello sviluppo del business
vp_di_acquisizione_di_talenti	vp di acquisizione di talenti
vp_di_cibi_e_bevande	vp di cibi e bevande
vp_di_globale_hr	vp di globale hr
vp_di_mutuo_ipotecario	vp di mutuo ipotecario
vp_di_prestito_residenziale	vp di prestito residenziale
vp_di_reclutamento	vp di reclutamento
vp_di_servizi_creativi	vp di servizi creativi
vp_di_sviluppo_organizzativo	vp di sviluppo organizzativo
vp_iniziative_strategiche	vp iniziative strategiche
web_designer	web designer
web_e_grafico	web e grafico
webmaster_aziendale	webmaster aziendale
wedding_planner_ed_eventi	wedding planner ed eventi
è_amministratore_della_sicurezza	è amministratore della sicurezza
è_analista_della_sicurezza	è analista della sicurezza
è_consulente_per_le_assunzioni	è consulente per le assunzioni
è_generalista	è generalista
è_ingegnere_della_sicurezza	è ingegnere della sicurezza
è_ingegnere_di_sistema	è ingegnere di sistema
è_reclutatore_tecnico	è reclutatore tecnico
è_specialista_di_supporto	è specialista di supporto
