3d场景美术师	3d场景美术师
3d建模师	3d建模师
3d综合美术师	3d综合美术师
3d美术师	3d美术师
3d角色动画师	3d角色动画师
avid编辑	avid编辑
crossfit教练	crossfit教练
flash动画师	flash动画师
html5开发人员	html5开发人员
ios应用程序开发人员	ios应用程序开发人员
it专员	it专员
it安全分析师	it安全分析师
it安全工程师	it安全工程师
it安全管理员	it安全管理员
it技术人员	it技术人员
it技术招聘人员	it技术招聘人员
it招聘人员	it招聘人员
it招聘顾问	it招聘顾问
it支持专员	it支持专员
it支持技术员	it支持技术员
it现场技术员	it现场技术员
it系统工程师	it系统工程师
it综合人员	it综合人员
it顾问	it顾问
j2ee开发人员	j2ee开发人员
java_/_j2ee开发人员	java / j2ee开发人员
java团队负责人	java团队负责人
java应用程序开发人员	java应用程序开发人员
java开发人员	java开发人员
java技术负责人	java技术负责人
java架构师	java架构师
java网络开发人员	java网络开发人员
java软件工程师	java软件工程师
java顾问	java顾问
mba候选人	mba候选人
mba参与者	mba参与者
mba毕业生	mba毕业生
php程序员	php程序员
php网站开发人员	php网站开发人员
scada工程师	scada工程师
service_now开发人员	service now开发人员
title_1教师	title 1教师
voip工程师	voip工程师
voip网络工程师	voip网络工程师
一线支持	一线支持
下士	下士
专业人员	专业人员
专业会计	专业会计
专业化妆师	专业化妆师
专业司机	专业司机
专业工程师	专业工程师
专业房地产经纪人	专业房地产经纪人
专业摄影师	专业摄影师
专业歌手	专业歌手
专业演员	专业演员
专业舞者	专业舞者
专业艺术家	专业艺术家
专业运动员	专业运动员
专业音乐家	专业音乐家
专有股票交易员	专有股票交易员
专栏作家	专栏作家
专题作者	专题作者
业务专员	业务专员
业务中心经理	业务中心经理
业务分析师	业务分析师
业务发展专家	业务发展专家
业务发展人员	业务发展人员
业务发展副总监	业务发展副总监
业务发展副总裁	业务发展副总裁
业务发展助理	业务发展助理
业务发展干事	业务发展干事
业务发展执行副总裁	业务发展执行副总裁
业务发展经理	业务发展经理
业务发展负责人	业务发展负责人
业务发展部主管	业务发展部主管
业务发展部助理副总裁	业务发展部助理副总裁
业务发展顾问	业务发展顾问
业务开发总监	业务开发总监
业务支持系统工程师	业务支持系统工程师
业务管理顾问	业务管理顾问
业务运营副总裁	业务运营副总裁
业务运营总监	业务运营总监
个人业务核保员	个人业务核保员
个人业务经理	个人业务经理
个人培训总监	个人培训总监
个人捐赠经理	个人捐赠经理
个人电脑专员	个人电脑专员
个人电脑技术员	个人电脑技术员
个人电脑维修技术员	个人电脑维修技术员
中士	中士
中学教师	中学教师
中学数学教师	中学数学教师
中学科学教师	中学科学教师
中学英语教师	中学英语教师
中尉	中尉
中层干部	中层干部
中端市场客户经理	中端市场客户经理
中级会计师	中级会计师
中级架构师	中级架构师
中间办公室主任	中间办公室主任
临床主管	临床主管
临床医学副教授	临床医学副教授
临床工程师	临床工程师
临床应用专员	临床应用专员
临床心理学家	临床心理学家
临床指导员	临床指导员
临床治疗师	临床治疗师
临床研究协调员	临床研究协调员
临床社工	临床社工
临床联络员	临床联络员
临床药剂师	临床药剂师
临床药学专员	临床药学专员
临床药学人员	临床药学人员
临床药学经理	临床药学经理
临床顾问	临床顾问
临时会计	临时会计
临时保姆	临时保姆
临时助理	临时助理
临时经理	临时经理
主办方	主办方
主厨	主厨
主持人	主持人
主控操作员	主控操作员
主教练	主教练
主治医师	主治医师
主管合伙人	主管合伙人
主管律师	主管律师
主管经纪人	主管经纪人
主管股东	主管股东
主管顾问	主管顾问
主编	主编
乐队总监	乐队总监
乐队成员	乐队成员
乐队经理	乐队经理
买手代理人	买手代理人
二副	二副
二级营销经理	二级营销经理
二线支持分析师	二线支持分析师
互动制片人	互动制片人
互动媒体经理	互动媒体经理
互动艺术总监	互动艺术总监
互动销售经理	互动销售经理
互联网管理员	互联网管理员
互联网营销协调员	互联网营销协调员
井口工程师	井口工程师
交互开发人员	交互开发人员
交易分析师	交易分析师
交易员	交易员
交易所管理员	交易所管理员
交通主管	交通主管
交通经理	交通经理
交通记者	交通记者
产品冠军	产品冠军
产品工程主管	产品工程主管
产品工程师	产品工程师
产品开发人员	产品开发人员
产品开发助理	产品开发助理
产品开发技术专家	产品开发技术专家
产品战略规划师	产品战略规划师
产品技术专家	产品技术专家
产品控制员	产品控制员
产品支持技术员	产品支持技术员
产品组合经理	产品组合经理
产品营销分析师	产品营销分析师
产品设计与开发工程师	产品设计与开发工程师
产品设计师	产品设计师
产品设计顾问	产品设计顾问
产品运营总监	产品运营总监
产量经理	产量经理
人事总监	人事总监
人力资本总监	人力资本总监
人力资源业务伙伴	人力资源业务伙伴
人力资源主管	人力资源主管
人力资源信息系统分析师	人力资源信息系统分析师
人力资源分析师	人力资源分析师
人力资源助理	人力资源助理
人力资源协调员	人力资源协调员
人力资源招聘专员	人力资源招聘专员
人力资源招聘人员	人力资源招聘人员
人力资源招聘助理	人力资源招聘助理
人力资源招聘协调员	人力资源招聘协调员
人力资源经理	人力资源经理
人力资源综合人员	人力资源综合人员
人力资源顾问	人力资源顾问
人员配置专员	人员配置专员
人员配置管理员	人员配置管理员
人员配置经理	人员配置经理
人员配置负责人	人员配置负责人
人员配置顾问	人员配置顾问
人才制作人	人才制作人
人才发展总监	人才发展总监
人才引进专员	人才引进专员
人才引进主管	人才引进主管
人才引进副总裁	人才引进副总裁
人才引进实习生	人才引进实习生
人才引进总监	人才引进总监
人才引进招聘人员	人才引进招聘人员
人才引进经理	人才引进经理
人才引进负责人	人才引进负责人
人才引进顾问	人才引进顾问
人才总监	人才总监
人才管理专员	人才管理专员
人才管理副总裁	人才管理副总裁
人才管理部主管	人才管理部主管
人才管理顾问	人才管理顾问
人才经理	人才经理
人类学教授	人类学教授
仓库与物流经理	仓库与物流经理
仓库与配送经理	仓库与配送经理
仓库专员	仓库专员
仓库助理	仓库助理
仓库团队负责人	仓库团队负责人
仓库操作员	仓库操作员
仓库管理员	仓库管理员
仓库经理	仓库经理
仓库运营经理	仓库运营经理
代管助理	代管助理
代课教师	代课教师
仲裁人	仲裁人
仿真工程师	仿真工程师
企业与基金会关系总监	企业与基金会关系总监
企业主厨	企业主厨
企业传播助理	企业传播助理
企业传播协调员	企业传播协调员
企业传播部助理经理	企业传播部助理经理
企业信贷分析师	企业信贷分析师
企业发展分析师	企业发展分析师
企业发展助理	企业发展助理
企业合作伙伴关系总监	企业合作伙伴关系总监
企业图书管理员	企业图书管理员
企业工程师	企业工程师
企业应用程序工程师	企业应用程序工程师
企业律师	企业律师
企业旅行代理	企业旅行代理
企业旅行经理	企业旅行经理
企业法律助理	企业法律助理
企业法律顾问	企业法律顾问
企业活动策划	企业活动策划
企业物流经理	企业物流经理
企业税务经理	企业税务经理
企业税务顾问	企业税务顾问
企业空乘人员	企业空乘人员
企业网站管理员	企业网站管理员
企业网络工程师	企业网络工程师
企业行政总厨	企业行政总厨
企业调查员	企业调查员
企业财务主管	企业财务主管
企业财务实习生	企业财务实习生
企业财务部主管	企业财务部主管
企业金融分析师	企业金融分析师
企业银行业务主管	企业银行业务主管
企业银行业务分析师	企业银行业务分析师
企业银行业务总监	企业银行业务总监
企业顾问	企业顾问
企业飞行员	企业飞行员
休闲销售总监	休闲销售总监
会员服务部总监	会员服务部总监
会员顾问	会员顾问
会计	会计
会计人员	会计人员
会计助理	会计助理
会计讲师	会计讲师
会议与活动协调员	会议与活动协调员
会议中心经理	会议中心经理
会议助理	会议助理
会议服务协调员	会议服务协调员
会议服务经理	会议服务经理
会议策划人	会议策划人
会议经理	会议经理
传播专员	传播专员
传播协调员	传播协调员
传播经理	传播经理
传播设计师	传播设计师
传播负责人	传播负责人
传播部助理总监	传播部助理总监
传播顾问	传播顾问
传输工程师	传输工程师
传输控制员	传输控制员
伤亡事故索赔理算师	伤亡事故索赔理算师
估值分析师	估值分析师
估值助理	估值助理
伴奏员	伴奏员
住口专员	住口专员
住宅地产经理	住宅地产经理
住宅地产经纪人	住宅地产经纪人
住宅房地产经纪人	住宅房地产经纪人
住宅贷款副总裁	住宅贷款副总裁
体育主播	体育主播
体育制作人	体育制作人
体育协调员	体育协调员
体育实习生	体育实习生
体育总监	体育总监
体育摄影师	体育摄影师
体育教师	体育教师
体育教练	体育教练
体育经理	体育经理
体育编辑	体育编辑
体育记者	体育记者
作家	作家
供应教师	供应教师
供应链干事	供应链干事
俄语语言学家	俄语语言学家
保管员主任	保管员主任
保险专员	保险专员
保险主管	保险主管
保险代理	保险代理
保险客户代表	保险客户代表
保险库经理	保险库经理
保险核保员	保险核保员
保险经纪人	保险经纪人
保险部主管	保险部主管
保险销售代表	保险销售代表
保险顾问	保险顾问
信号完整性工程师	信号完整性工程师
信息保障干事	信息保障干事
信息安全分析师	信息安全分析师
信息安全工程师	信息安全工程师
信息安全管理员	信息安全管理员
信息系统分析师	信息系统分析师
信用专员	信用专员
信用主管	信用主管
信贷代表	信贷代表
信贷分析师	信贷分析师
信贷干事	信贷干事
信贷研究分析师	信贷研究分析师
信贷管理干事	信贷管理干事
修图师	修图师
值班经理	值班经理
假期规划师	假期规划师
健康与健身专员	健康与健身专员
健康访视员	健康访视员
健身专员	健身专员
健身协调员	健身协调员
健身总监	健身总监
健身教练	健身教练
健身经理	健身经理
健身顾问	健身顾问
储层地质学家	储层地质学家
儿科医生	儿科医生
儿科执业护士	儿科执业护士
儿童保育助理	儿童保育助理
儿童保育员	儿童保育员
儿童保育教师	儿童保育教师
全国专家	全国专家
全国人力资源经理	全国人力资源经理
全国招聘人员	全国招聘人员
全国物流经理	全国物流经理
全栈工程师	全栈工程师
全球业务发展经理	全球业务发展经理
全球人力资源副总裁	全球人力资源副总裁
全球传播经理	全球传播经理
全球公共关系经理	全球公共关系经理
全球差旅经理	全球差旅经理
全球物流经理	全球物流经理
全科医生	全科医生
全职教职员工	全职教职员工
公共关系	公共关系
公共关系与传播协调员	公共关系与传播协调员
公共关系与传播顾问	公共关系与传播顾问
公共关系专员	公共关系专员
公共关系主管	公共关系主管
公共关系代表	公共关系代表
公共关系助理	公共关系助理
公共关系协调员	公共关系协调员
公共关系客户主管	公共关系客户主管
公共关系干事	公共关系干事
公共关系总监	公共关系总监
公共关系经理	公共关系经理
公共关系部门主管	公共关系部门主管
公共关系顾问	公共关系顾问
公共卫生护士	公共卫生护士
公共广播播音员	公共广播播音员
公共政策经理	公共政策经理
公共服务图书管理员	公共服务图书管理员
公务员	公务员
公司司机	公司司机
公司律师	公司律师
公立学校教师	公立学校教师
公路司机	公路司机
共同基金专员	共同基金专员
共同基金分析师	共同基金分析师
关系主管	关系主管
关系干事	关系干事
关系经理	关系经理
关系银行家	关系银行家
兼职历史教授	兼职历史教授
兼职教授	兼职教授
兼职讲师	兼职讲师
兼职金融学教授	兼职金融学教授
兼职销售助理	兼职销售助理
兽医助理	兽医助理
兽医外科医生	兽医外科医生
兽医技术员	兽医技术员
内容主管	内容主管
内容分析师	内容分析师
内容制作人	内容制作人
内容开发人员	内容开发人员
内容战略规划师	内容战略规划师
内容撰稿人	内容撰稿人
内容经理	内容经理
内容营销经理	内容营销经理
内科住院医生	内科住院医生
内科医生	内科医生
内部会计	内部会计
内部信息系统分析师	内部信息系统分析师
内部医生	内部医生
内部地球物理学家	内部地球物理学家
内部地质学家	内部地质学家
内部应用程序工程师	内部应用程序工程师
内部开发人员	内部开发人员
内部律师	内部律师
内部批发商	内部批发商
内部技术专家	内部技术专家
内部技术支持工程师	内部技术支持工程师
内部技术项目经理	内部技术项目经理
内部护士	内部护士
内部招聘人员	内部招聘人员
内部摄影师	内部摄影师
内部收入代理	内部收入代理
内部沟通协调员	内部沟通协调员
内部沟通干事	内部沟通干事
内部电气工程师	内部电气工程师
内部研究员	内部研究员
内部研究工程师	内部研究工程师
内部硬件工程师	内部硬件工程师
内部税务会计	内部税务会计
内部翻译	内部翻译
内部设计工程师	内部设计工程师
内部顾问	内部顾问
内部麻醉师	内部麻醉师
再保险经纪人	再保险经纪人
军团成员	军团成员
农业工程师	农业工程师
农村运营商	农村运营商
农村运营商助理	农村运营商助理
冶金工程师	冶金工程师
出口地区经理	出口地区经理
出口干事	出口干事
出口经理	出口经理
出口销售主管	出口销售主管
出口销售代表	出口销售代表
出版助理	出版助理
出版协调员	出版协调员
出版商	出版商
出版总监	出版总监
出版经理	出版经理
出版编辑	出版编辑
出版设计师	出版设计师
出版部主管	出版部主管
出版顾问	出版顾问
出纳员	出纳员
分公司经理	分公司经理
分公司运营主管	分公司运营主管
分类人员	分类人员
分类广告经理	分类广告经理
分销部主管	分销部主管
刑事调查员	刑事调查员
刑事辩护律师	刑事辩护律师
创作副总监	创作副总监
创始合伙人	创始合伙人
创意制作人	创意制作人
创意实习生	创意实习生
创意平面设计师	创意平面设计师
创意开发人员	创意开发人员
创意执行总监	创意执行总监
创意撰稿人	创意撰稿人
创意文案策划	创意文案策划
创意服务主管	创意服务主管
创意服务制作人	创意服务制作人
创意服务副总裁	创意服务副总裁
创意服务实习生	创意服务实习生
创意服务经理	创意服务经理
创意经理	创意经理
创意美术师	创意美术师
创意设计经理	创意设计经理
创意负责人	创意负责人
创意项目经理	创意项目经理
创新工程师	创新工程师
初级射击教练	初级射击教练
制作人	制作人
制作艺术家	制作艺术家
制造工程师	制造工程师
制造设计工程师	制造设计工程师
前厅经理	前厅经理
前台主管	前台主管
前台代表	前台代表
前台办公室主管	前台办公室主管
前台办公室代理	前台办公室代理
前台办公室助理	前台办公室助理
前台办公室团队负责人	前台办公室团队负责人
前台办公室实习生	前台办公室实习生
前台办公室经理	前台办公室经理
前台助理	前台助理
前台经理	前台经理
前端主管	前端主管
剧院导演	剧院导演
副主厨	副主厨
副公设辩护律师	副公设辩护律师
副市检察长	副市检察长
副总检察长	副总检察长
副总法律顾问	副总法律顾问
副总编辑	副总编辑
副总裁	副总裁
副校长	副校长
副消防队长	副消防队长
副秘书	副秘书
副经理	副经理
副警长	副警长
副部长	副部长
副驾驶员	副驾驶员
力量与体能教练	力量与体能教练
办公室主管合伙人	办公室主管合伙人
办公室生产助理	办公室生产助理
办案人员	办案人员
动力系统工程师	动力系统工程师
动物护理助理	动物护理助理
动物护理技术员	动物护理技术员
动画主管	动画主管
动画实习生	动画实习生
动画导演	动画导演
动画师	动画师
动画美术师	动画美术师
动画讲师	动画讲师
动画负责人	动画负责人
助理	助理
助理主厨	助理主厨
助理公司秘书	助理公司秘书
助理公司顾问	助理公司顾问
助理公设辩护律师	助理公设辩护律师
助理关系经理	助理关系经理
助理内务经理	助理内务经理
助理内容经理	助理内容经理
助理分销经理	助理分销经理
助理制片人	助理制片人
助理前厅经理	助理前厅经理
助理前台经理	助理前台经理
助理前端经理	助理前端经理
助理副总裁	助理副总裁
助理力量与体能教练	助理力量与体能教练
助理动画师	助理动画师
助理厨师	助理厨师
助理县检察官	助理县检察官
助理品牌经理	助理品牌经理
助理地点经理	助理地点经理
助理基金经理	助理基金经理
助理夜班经理	助理夜班经理
助理学前班教师	助理学前班教师
助理客服经理	助理客服经理
助理市政工程师	助理市政工程师
助理建筑师	助理建筑师
助理律师	助理律师
助理总法律顾问	助理总法律顾问
助理总经理	助理总经理
助理技术设计师	助理技术设计师
助理投资经理	助理投资经理
助理摄影师	助理摄影师
助理收入经理	助理收入经理
助理教授	助理教授
助理新闻总监	助理新闻总监
助理施工经理	助理施工经理
助理机械工程师	助理机械工程师
助理校长	助理校长
助理档案保管员	助理档案保管员
助理检察长	助理检察长
助理消防队长	助理消防队长
助理私人银行家	助理私人银行家
助理策划师	助理策划师
助理管理会计师	助理管理会计师
助理系统分析师	助理系统分析师
助理终端经理	助理终端经理
助理经理	助理经理
助理编辑	助理编辑
助理视频编辑	助理视频编辑
助理警察局长	助理警察局长
助理设计工程师	助理设计工程师
助理设计师	助理设计师
助理足球教练	助理足球教练
助理酒吧经理	助理酒吧经理
助理银行经理	助理银行经理
助理面点师	助理面点师
助理项目工程师	助理项目工程师
助理预约经理	助理预约经理
助理餐饮主任	助理餐饮主任
助理餐饮经理	助理餐饮经理
助理首席律师	助理首席律师
助理首席飞行员	助理首席飞行员
助理驻地工程师	助理驻地工程师
劳动与就业律师	劳动与就业律师
勘探副总裁	勘探副总裁
包装工程师	包装工程师
化学工程师	化学工程师
区域出口经理	区域出口经理
区域建筑经理	区域建筑经理
区域房地产经理	区域房地产经理
区域技术专员	区域技术专员
区域招聘经理	区域招聘经理
区域支持专员	区域支持专员
区域收入经理	区域收入经理
区域法律顾问	区域法律顾问
区域物流经理	区域物流经理
区域生产经理	区域生产经理
区域系统工程师	区域系统工程师
区域调查员	区域调查员
区域运输经理	区域运输经理
区域防损总监	区域防损总监
医学博士	医学博士
医学工程师	医学工程师
医学插画师	医学插画师
医学教育主任	医学教育主任
医学科学联络员	医学科学联络员
医学系助理教授	医学系助理教授
医生助理	医生助理
医疗保健助理	医疗保健助理
医疗保健招聘人员	医疗保健招聘人员
医疗信息经理	医疗信息经理
医疗实习生	医疗实习生
医疗执行总监	医疗执行总监
医疗招聘人员	医疗招聘人员
医院院长	医院院长
博主	博主
印制电路板设计师	印制电路板设计师
印刷制作人	印刷制作人
印刷制作协调员	印刷制作协调员
印刷制作经理	印刷制作经理
印刷设计师	印刷设计师
印前协调员	印前协调员
历史教师	历史教师
历史系助理教授	历史系助理教授
压力分析师	压力分析师
压力工程师	压力工程师
厨师	厨师
厨师长	厨师长
厨房主管	厨房主管
厨房助理	厨房助理
厨房助理经理	厨房助理经理
厨房员工	厨房员工
厨房经理	厨房经理
双语教师	双语教师
双语行政秘书	双语行政秘书
发型与化妆师	发型与化妆师
发型师	发型师
发型设计师	发型设计师
发展与公共关系总监	发展与公共关系总监
发言人	发言人
发货与收货协调员	发货与收货协调员
发货与收货员	发货与收货员
发货与收货经理	发货与收货经理
发货员	发货员
受众发展总监	受众发展总监
口腔颌面外科医生	口腔颌面外科医生
司机	司机
司法助理	司法助理
司法法务员	司法法务员
合伙人	合伙人
合作伙伴协调员	合作伙伴协调员
合同制java开发人员	合同制java开发人员
合同制地质学家	合同制地质学家
合同制律师	合同制律师
合同制招聘人员	合同制招聘人员
合同制摄影师	合同制摄影师
合同制撰稿人	合同制撰稿人
合同制文案策划	合同制文案策划
合同制机械工程师	合同制机械工程师
合同制网站开发工程师	合同制网站开发工程师
合同制飞行员	合同制飞行员
合同工	合同工
吉他手	吉他手
吉他教师	吉他教师
名誉教授	名誉教授
后期制作主管	后期制作主管
后期制作人	后期制作人
后期制作助理	后期制作助理
后期制作协调员	后期制作协调员
后期制作实习生	后期制作实习生
后期制作总监	后期制作总监
后期制作经理	后期制作经理
后期制作编辑	后期制作编辑
后端开发人员	后端开发人员
听证会官员	听证会官员
呼叫中心助理	呼叫中心助理
咖啡厅经理	咖啡厅经理
咨询地质学家	咨询地质学家
咨询工程师	咨询工程师
咨询心理医生	咨询心理医生
咨询系统分析师	咨询系统分析师
咨询经理	咨询经理
咨询编辑	咨询编辑
咨询销售专员	咨询销售专员
品牌分析师	品牌分析师
品牌策划	品牌策划
品牌设计师	品牌设计师
品牌设计经理	品牌设计经理
哲学系助理教授	哲学系助理教授
哲学系教授	哲学系教授
商业代理人	商业代理人
商业作家	商业作家
商业保险代理	商业保险代理
商业保险经纪人	商业保险经纪人
商业分析师	商业分析师
商业制片人	商业制片人
商业协调员	商业协调员
商业地产专员	商业地产专员
商业地产代理	商业地产代理
商业地产经纪人	商业地产经纪人
商业地产顾问	商业地产顾问
商业律师	商业律师
商业教育教师	商业教育教师
商业线制片人	商业线制片人
商业贷款助理	商业贷款助理
商业银行专员	商业银行专员
商业银行关系经理	商业银行关系经理
商业银行家	商业银行家
商业飞行员	商业飞行员
商务专家	商务专家
商务主管	商务主管
商务顾问	商务顾问
商品分析师	商品分析师
啦啦队教练	啦啦队教练
团队负责人	团队负责人
固件设计工程师	固件设计工程师
固定收益专员	固定收益专员
固定收益交易员	固定收益交易员
固定收益分析师	固定收益分析师
固定收益投资组合经理	固定收益投资组合经理
固定收益部总监	固定收益部总监
国家业务经理	国家业务经理
国家代表	国家代表
国家记者	国家记者
国际业务发展顾问	国际业务发展顾问
国际公共关系经理	国际公共关系经理
国际律师	国际律师
国际招聘人员	国际招聘人员
国际旅行顾问	国际旅行顾问
国际物流协调员	国际物流协调员
国际物流经理	国际物流经理
国际贸易专员	国际贸易专员
国际采购经理	国际采购经理
图书管理员	图书管理员
图书馆媒体专员	图书馆媒体专员
图书馆馆长	图书馆馆长
图案设计师	图案设计师
图表专员	图表专员
图表制作美术师	图表制作美术师
图表技术员	图表技术员
图表服务经理	图表服务经理
土建工程实习生	土建工程实习生
土建工程技术员	土建工程技术员
土木工程主管	土木工程主管
土木测绘员	土木测绘员
土木设计工程师	土木设计工程师
土木设计师	土木设计师
在线广告经理	在线广告经理
地产部主管	地产部主管
地区副检察官	地区副检察官
地区助理检察官	地区助理检察官
地区培训师	地区培训师
地区工程师	地区工程师
地区总经理	地区总经理
地区护士	地区护士
地区指导	地区指导
地区星探	地区星探
地区法官	地区法官
地区经理	地区经理
地区藏品经理	地区藏品经理
地区资产保护经理	地区资产保护经理
地区销售工程师	地区销售工程师
地球物理学家	地球物理学家
地质学家	地质学家
地质工程师	地质工程师
地质技术员	地质技术员
地面作业经理	地面作业经理
场地经理	场地经理
城市编辑	城市编辑
城市规划师	城市规划师
城市送信员	城市送信员
培训与安置干事	培训与安置干事
培训队长	培训队长
基地经理	基地经理
基础设施主管	基础设施主管
基金会经理	基金会经理
基金分析师	基金分析师
基金发展协调员	基金发展协调员
基金发展部总监	基金发展部总监
基金经理	基金经理
基金赞助者	基金赞助者
壁画家	壁画家
声乐家	声乐家
声乐教练	声乐教练
声音工程师	声音工程师
处理地球物理学家	处理地球物理学家
夏令营辅导员	夏令营辅导员
外包经理	外包经理
外国法律顾问	外国法律顾问
外汇经理	外汇经理
外科医生	外科医生
外科手术护士	外科手术护士
外科手术教授	外科手术教授
外籍助理	外籍助理
外联顾问	外联顾问
外聘检查员	外聘检查员
外部顾问	外部顾问
多媒体制作人	多媒体制作人
多媒体实习生	多媒体实习生
多媒体程序员	多媒体程序员
多媒体记者	多媒体记者
多媒体设计师	多媒体设计师
夜班审计员	夜班审计员
夜班经理	夜班经理
大仓主管	大仓主管
大会协调员	大会协调员
大学图书管理员	大学图书管理员
大学教授	大学教授
大学登记员	大学登记员
大学讲师	大学讲师
大学项目实习生	大学项目实习生
大客户经理	大客户经理
大队长	大队长
大额捐赠经理	大额捐赠经理
女装设计师	女装设计师
婚姻与家庭治疗师	婚姻与家庭治疗师
婚礼与活动规划师	婚礼与活动规划师
婚礼协调员	婚礼协调员
婚礼顾问	婚礼顾问
媒体与传播经理	媒体与传播经理
媒体主管	媒体主管
媒体关系助理	媒体关系助理
媒体关系干事	媒体关系干事
媒体关系总监	媒体关系总监
媒体制作专员	媒体制作专员
媒体助理	媒体助理
媒体图书管理员	媒体图书管理员
媒体总监	媒体总监
媒体战略规划师	媒体战略规划师
媒体技术员	媒体技术员
媒体服务总监	媒体服务总监
媒体研究员	媒体研究员
媒体经理	媒体经理
媒体规划主管	媒体规划主管
媒体规划师	媒体规划师
媒体集团负责人	媒体集团负责人
季节性销售助理	季节性销售助理
学习支持教师	学习支持教师
学前班主任	学前班主任
学前班教师	学前班教师
学术专员	学术专员
学术项目协调员	学术项目协调员
学校图书馆媒体专家	学校图书馆媒体专家
学校护士	学校护士
学生安置协调员	学生安置协调员
学生志愿者	学生志愿者
学生教师	学生教师
学生记者	学生记者
学院顾问	学院顾问
安全专家	安全专家
安全工程师	安全工程师
安全管理员	安全管理员
安全部助理主任	安全部助理主任
安卓开发人员	安卓开发人员
安置顾问	安置顾问
定价主管	定价主管
定价协调员	定价协调员
实习	实习
实施主管	实施主管
实施工程师	实施工程师
宠物保姆	宠物保姆
审计员	审计员
审计文员	审计文员
客座助理教授	客座助理教授
客座教师	客座教师
客座讲师	客座讲师
客户主管	客户主管
客户企划	客户企划
客户会计	客户会计
客户关系助理	客户关系助理
客户关系经理	客户关系经理
客户宣传员	客户宣传员
客户总监	客户总监
客户战略规划师	客户战略规划师
客户招募经理	客户招募经理
客户支持专员	客户支持专员
客户支持分析师	客户支持分析师
客户支持技术员	客户支持技术员
客户支持支持工程师	客户支持支持工程师
客户服务专员	客户服务专员
客户服务代表	客户服务代表
客户服务部总监	客户服务部总监
客户服务部收银员	客户服务部收银员
客户端开发人员	客户端开发人员
客户管理部主管	客户管理部主管
客户经理	客户经理
客户部助理副总裁	客户部助理副总裁
客房部经理	客房部经理
客舱乘务员	客舱乘务员
客贷核保员	客贷核保员
宣传员	宣传员
宣传干事	宣传干事
宣传经理	宣传经理
室内自行车教练	室内自行车教练
室内设计师	室内设计师
宴席主厨	宴席主厨
宴席主管	宴席主管
宴席协调员	宴席协调员
宴席服务员	宴席服务员
宴席负责人	宴席负责人
家庭保健护士	家庭保健护士
家庭医生	家庭医生
家庭影院专员	家庭影院专员
家庭支持员	家庭支持员
家庭服务主任	家庭服务主任
家庭法律师	家庭法律师
家庭顾问	家庭顾问
家政服务主管	家政服务主管
家政服务经理	家政服务经理
宾客体验执行团队负责人	宾客体验执行团队负责人
宾客关系主管	宾客关系主管
宾客关系协调员	宾客关系协调员
宾客关系干事	宾客关系干事
宾客服务主管	宾客服务主管
宾客服务代表	宾客服务代表
宾客服务助理	宾客服务助理
宾客服务协调员	宾客服务协调员
宾客服务干事	宾客服务干事
对冲基金分析师	对冲基金分析师
对外交流经理	对外交流经理
对外关系副总裁	对外关系副总裁
寻源者	寻源者
导游	导游
寿险核保员	寿险核保员
小丑	小丑
小学教师	小学教师
小学教育教师	小学教育教师
小学校长	小学校长
小学辅导员	小学辅导员
就业专员	就业专员
局域网管理员	局域网管理员
居民贷款干事	居民贷款干事
展览策展人	展览策展人
嵌入式系统工程师	嵌入式系统工程师
嵌入式软件团队负责人	嵌入式软件团队负责人
州和地方税务经理	州和地方税务经理
州警官	州警官
巡逻警长	巡逻警长
工作台技术员	工作台技术员
工作室艺术家	工作室艺术家
工作领班	工作领班
工具开发人员	工具开发人员
工厂冶金师	工厂冶金师
工厂工艺工程师	工厂工艺工程师
工地土木工程师	工地土木工程师
工地工程师	工地工程师
工地收购经理	工地收购经理
工地领班	工地领班
工头	工头
工程招聘人员	工程招聘人员
工程设计师	工程设计师
工艺专员	工艺专员
工艺工程专员	工艺工程专员
工艺工程师	工艺工程师
工艺技术专家	工艺技术专家
工艺控制工程师	工艺控制工程师
工艺机械工程师	工艺机械工程师
工艺经理	工艺经理
工艺自动化工程师	工艺自动化工程师
工艺设计工程师	工艺设计工程师
工艺顾问	工艺顾问
市场分析师	市场分析师
市场情报分析师	市场情报分析师
市场情报总监	市场情报总监
市场数据分析师	市场数据分析师
市场研究分析师	市场研究分析师
市场记者	市场记者
市场部助理经理	市场部助理经理
市场风险经理	市场风险经理
市政工程师	市政工程师
布局工程师	布局工程师
布局设计工程师	布局设计工程师
布局设计师	布局设计师
平面美术师	平面美术师
平面设计主管	平面设计主管
平面设计助理	平面设计助理
平面设计协调员	平面设计协调员
平面设计学生	平面设计学生
平面设计实习	平面设计实习
平面设计指导员	平面设计指导员
平面设计教师	平面设计教师
平面设计经理	平面设计经理
平面设计美术师	平面设计美术师
平面设计顾问	平面设计顾问
年度基金经理	年度基金经理
年度捐赠经理	年度捐赠经理
年度资金助理主任	年度资金助理主任
幼儿园教师	幼儿园教师
广告专员	广告专员
广告主管	广告主管
广告制作协调员	广告制作协调员
广告协调员	广告协调员
广告客户代表	广告客户代表
广告客户经理	广告客户经理
广告文案策划	广告文案策划
广告经理	广告经理
广告设计师	广告设计师
广告部主管	广告部主管
广播业务总监	广播业务总监
广播制作总监	广播制作总监
广播员	广播员
广播播音员	广播播音员
广播电台主管	广播电台主管
广播电台助理	广播电台助理
广播电台协调员	广播电台协调员
广播电台工程师	广播电台工程师
广播电台技术员	广播电台技术员
广播电台系统工程师	广播电台系统工程师
广播电台经理	广播电台经理
广播电台记者	广播电台记者
广播电台设计师	广播电台设计师
广播电台谈判员	广播电台谈判员
广播电台采购员	广播电台采购员
库存控制主管	库存控制主管
库存经理	库存经理
应付账款管理员	应付账款管理员
应急管理协调员	应急管理协调员
应用程序工程师	应用程序工程师
应用程序开发员	应用程序开发员
应用程序开发团队负责人	应用程序开发团队负责人
应用程序技术专家	应用程序技术专家
应用程序支持技术员	应用程序支持技术员
应用程序测试员	应用程序测试员
庭审律师	庭审律师
庭审顾问	庭审顾问
建模师	建模师
建筑助理	建筑助理
建筑实习生	建筑实习生
建筑工人	建筑工人
建筑师	建筑师
建筑服务工程师	建筑服务工程师
建筑监察员	建筑监察员
建筑系学生	建筑系学生
建筑系教授	建筑系教授
建筑设计师	建筑设计师
建筑领班	建筑领班
开关工程师	开关工程师
开发制片人	开发制片人
开发员	开发员
开发技术专家	开发技术专家
开源代码开发人员	开源代码开发人员
录像带操作员	录像带操作员
录音工程师	录音工程师
影像主管	影像主管
影像服务主任	影像服务主任
律师	律师
微电脑专家	微电脑专家
微软系统工程师	微软系统工程师
微软系统管理员	微软系统管理员
心理健康顾问	心理健康顾问
心理分析学家	心理分析学家
心理助理	心理助理
心理学家	心理学家
心脏病学研究员	心脏病学研究员
心脏病科医生	心脏病科医生
思科网络工程师	思科网络工程师
急诊科医生	急诊科医生
急诊科技术员	急诊科技术员
总承包商	总承包商
总监	总监
总监理	总监理
总管家	总管家
总经理	总经理
总经理个人助理	总经理个人助理
总编辑	总编辑
总账主管	总账主管
惩教员	惩教员
意大利语教师	意大利语教师
戏剧教师	戏剧教师
成人执业护士	成人执业护士
成本经理	成本经理
战略与运营总监	战略与运营总监
战略与运营经理	战略与运营经理
战略业务顾问	战略业务顾问
战略主管	战略主管
战略举措副总裁	战略举措副总裁
战略发展总监	战略发展总监
战略发展部主管	战略发展部主管
战略沟通	战略沟通
战略规划分析师	战略规划分析师
战略规划经理	战略规划经理
战略部副总裁	战略部副总裁
战略顾问	战略顾问
房务部助理总监	房务部助理总监
房地产专员	房地产专员
房地产代理	房地产代理
房地产会计	房地产会计
房地产估价师	房地产估价师
房地产分析师	房地产分析师
房地产助理	房地产助理
房地产律师	房地产律师
房地产索赔理算师	房地产索赔理算师
房地产组合经理	房地产组合经理
房地产经纪人	房地产经纪人
房地产经纪人助理	房地产经纪人助理
房地产经纪人团队负责人	房地产经纪人团队负责人
房地产经纪人销售助理	房地产经纪人销售助理
房地产贷款干事	房地产贷款干事
房地产销售代理	房地产销售代理
房地产顾问	房地产顾问
房地契代理	房地契代理
房地契干事	房地契干事
房地契监察员	房地契监察员
房屋主管	房屋主管
房屋抵押贷款顾问	房屋抵押贷款顾问
房屋设计师	房屋设计师
房屋贷款专员	房屋贷款专员
房屋贷款顾问	房屋贷款顾问
托儿所助理	托儿所助理
托收总监	托收总监
执业护士	执业护士
执法部门官员	执法部门官员
执行制片人	执行制片人
执行副总裁	执行副总裁
执行招聘人员	执行招聘人员
执行法律秘书	执行法律秘书
执行艺术总监	执行艺术总监
执行资源配置	执行资源配置
技术	技术
技术人员成员	技术人员成员
技术人员杰出成员	技术人员杰出成员
技术分析师	技术分析师
技术制作人	技术制作人
技术办公室工程师	技术办公室工程师
技术办公室经理	技术办公室经理
技术动画师	技术动画师
技术员	技术员
技术客户支持代表	技术客户支持代表
技术招聘人员	技术招聘人员
技术招聘经理	技术招聘经理
技术操作员	技术操作员
技术支持	技术支持
技术支持专家	技术支持专家
技术支持主管	技术支持主管
技术支持代表	技术支持代表
技术支持分析师	技术支持分析师
技术支持助理	技术支持助理
技术支持协调员	技术支持协调员
技术支持员	技术支持员
技术支持团队负责人	技术支持团队负责人
技术支持工程师	技术支持工程师
技术教练	技术教练
技术架构师	技术架构师
技术测试负责人	技术测试负责人
技术现场工程师	技术现场工程师
技术画师	技术画师
技术监理	技术监理
技术翻译	技术翻译
技术艺术总监	技术艺术总监
技术设计师	技术设计师
技术负责人	技术负责人
技术销售支持工程师	技术销售支持工程师
投球指导员	投球指导员
投资专员	投资专员
投资人关系助理	投资人关系助理
投资分析师	投资分析师
投资战略规划师	投资战略规划师
投资研究分析师	投资研究分析师
投资组合助理	投资组合助理
投资组合助理经理	投资组合助理经理
投资组合总监	投资组合总监
投资组合管理分析师	投资组合管理分析师
投资组合经理	投资组合经理
投资绩效分析师	投资绩效分析师
投资运营经理	投资运营经理
投资部主管	投资部主管
投资银行分析师	投资银行分析师
投资银行助理	投资银行助理
投资银行实习生	投资银行实习生
投资银行暑期分析师	投资银行暑期分析师
护士	护士
护士联络员	护士联络员
护理学生	护理学生
护理指导员	护理指导员
护理部助理主任	护理部助理主任
抵押贷款专员	抵押贷款专员
抵押贷款人	抵押贷款人
抵押贷款代理	抵押贷款代理
抵押贷款副总裁	抵押贷款副总裁
抵押贷款助理	抵押贷款助理
抵押贷款协调员	抵押贷款协调员
抵押贷款发放员	抵押贷款发放员
抵押贷款干事	抵押贷款干事
抵押贷款核保员	抵押贷款核保员
抵押贷款经纪人	抵押贷款经纪人
抵押贷款结案员	抵押贷款结案员
抵押贷款银行家	抵押贷款银行家
抵押贷款销售经理	抵押贷款销售经理
拍卖师	拍卖师
招生主任	招生主任
招生办主任	招生办主任
招生处助理主任	招生处助理主任
招生大使	招生大使
招生实习生	招生实习生
招生管理主任	招生管理主任
招聘与培训经理	招聘与培训经理
招聘与选拔经理	招聘与选拔经理
招聘专员	招聘专员
招聘主管	招聘主管
招聘人	招聘人
招聘分析师	招聘分析师
招聘助理	招聘助理
招聘团队负责人	招聘团队负责人
招聘客户经理	招聘客户经理
招聘干事	招聘干事
招聘经理	招聘经理
招聘运营经理	招聘运营经理
招聘部主管	招聘部主管
招聘部副总裁	招聘部副总裁
招聘部助理经理	招聘部助理经理
招聘项目经理	招聘项目经理
招聘顾问	招聘顾问
拜神总监	拜神总监
持证专业咨询师	持证专业咨询师
持证临床专业咨询师	持证临床专业咨询师
持证临床心理学家	持证临床心理学家
持证临床社工	持证临床社工
持证保险代理	持证保险代理
持证婚姻与家庭治疗师	持证婚姻与家庭治疗师
持证心理健康咨询师	持证心理健康咨询师
持证心理学家	持证心理学家
持证房地产专业人员	持证房地产专业人员
持证房地产代理	持证房地产代理
持证房地产副经纪人	持证房地产副经纪人
持证房地产经纪人	持证房地产经纪人
持证执业护士	持证执业护士
持证抵押贷款经纪人	持证抵押贷款经纪人
持证针灸师	持证针灸师
持证销售代理	持证销售代理
指定经纪人	指定经纪人
捐赠者关系协调员	捐赠者关系协调员
捐赠者关系干事	捐赠者关系干事
捐赠者关系经理	捐赠者关系经理
排水工程师	排水工程师
排版员	排版员
控制盘操作员	控制盘操作员
控制系统专员	控制系统专员
控制系统工程师	控制系统工程师
控制系统设计师	控制系统设计师
推广制作人	推广制作人
推广工程师	推广工程师
推进器工程师	推进器工程师
插画师	插画师
搜索顾问	搜索顾问
摄像师	摄像师
摄影助理	摄影助理
摄影师	摄影师
摄影总监	摄影总监
摄影经理	摄影经理
摄影造型师	摄影造型师
播音员	播音员
撰稿人	撰稿人
操作系统分析师	操作系统分析师
支持中心分析师	支持中心分析师
支持员	支持员
支持技术员	支持技术员
收入代理	收入代理
收发室职员	收发室职员
收款助理	收款助理
收款员	收款员
收款实习生	收款实习生
收货主管	收货主管
收银员	收银员
收银员主管	收银员主管
放射科主任	放射科主任
放射科主管	放射科主管
放射科医生	放射科医生
放射科技术专家	放射科技术专家
放射科技术员	放射科技术员
放射科经理	放射科经理
政治科学系教授	政治科学系教授
政策专员	政策专员
政策分析师	政策分析师
政策协调员	政策协调员
政策干事	政策干事
政策部主管	政策部主管
救生员	救生员
教务长	教务长
教学专员	教学专员
教学助理	教学助理
教学教练	教学教练
教师	教师
教师助理	教师助理
教授	教授
教育主任	教育主任
教育学系助理教授	教育学系助理教授
教育学系教授	教育学系教授
教育教育诊断师	教育教育诊断师
教育治疗师	教育治疗师
教育顾问	教育顾问
数字主管	数字主管
数字内容工程师	数字内容工程师
数字内容经理	数字内容经理
数字制作人	数字制作人
数字媒体主管	数字媒体主管
数字媒体制作人	数字媒体制作人
数字媒体策划师	数字媒体策划师
数字媒体设计师	数字媒体设计师
数字客户总监	数字客户总监
数字客户经理	数字客户经理
数字影像技术员	数字影像技术员
数字策划师	数字策划师
数字营销经理	数字营销经理
数字设计师	数字设计师
数字销售经理	数字销售经理
数学系教授	数学系教授
数据中心主管	数据中心主管
数据中心分析师	数据中心分析师
数据中心操作员	数据中心操作员
数据中心管理员	数据中心管理员
数据安全管理员	数据安全管理员
数据库开发人员	数据库开发人员
数据网络专员	数据网络专员
数据网络工程师	数据网络工程师
数据网络顾问	数据网络顾问
文件主管	文件主管
文案主任	文案主任
文案主管	文案主管
文案策划	文案策划
文案经理	文案经理
新业务专员	新业务专员
新媒体制作人	新媒体制作人
新房销售顾问	新房销售顾问
新房顾问	新房顾问
新生儿学专家	新生儿学专家
新闻与公共关系经理	新闻与公共关系经理
新闻制作人	新闻制作人
新闻干事	新闻干事
新闻总监	新闻总监
新闻记者	新闻记者
新闻运营经理	新闻运营经理
施工前总监	施工前总监
施工前期经理	施工前期经理
施工监理	施工监理
旅游协调员	旅游协调员
旅游总监	旅游总监
旅行专员	旅行专员
旅行主管	旅行主管
旅行作家	旅行作家
旅行护士	旅行护士
旅行机构经理	旅行机构经理
旅行经理	旅行经理
旅行编辑	旅行编辑
旅行顾问	旅行顾问
旅馆老板	旅馆老板
无线专员	无线专员
无线产品经理	无线产品经理
无线工程师	无线工程师
无线技术员	无线技术员
无线电工程师	无线电工程师
无线电规划工程师	无线电规划工程师
无线网络工程师	无线网络工程师
无线顾问	无线顾问
日托机构教师	日托机构教师
日语翻译	日语翻译
日间训练营辅导员	日间训练营辅导员
早教教师	早教教师
早教教育工作者	早教教育工作者
早间新闻主播	早间新闻主播
早间节目主持人	早间节目主持人
早间节目制作人	早间节目制作人
早间节目联合主持人	早间节目联合主持人
时尚助理	时尚助理
时尚协调员	时尚协调员
时尚摄影师	时尚摄影师
时尚造型师	时尚造型师
时尚顾问	时尚顾问
时装设计实习生	时装设计实习生
时装设计师	时装设计师
普通牙科医生	普通牙科医生
景观建筑实习生	景观建筑实习生
景观建筑师	景观建筑师
景观设计师	景观设计师
暑期学校教师	暑期学校教师
暑期法律事务员	暑期法律事务员
暖气和空调工程师	暖气和空调工程师
最终用户支持专家	最终用户支持专家
有限合伙人	有限合伙人
服务中心分析师	服务中心分析师
服务中心经理	服务中心经理
服务助理人员	服务助理人员
服务台主管	服务台主管
服务台代理	服务台代理
服务台分析师	服务台分析师
服务台协调员	服务台协调员
服务台团队负责人	服务台团队负责人
服务台工程师	服务台工程师
服务台技术员	服务台技术员
服务台支持分析师	服务台支持分析师
服务台支持技术员	服务台支持技术员
服务台管理员	服务台管理员
服务员	服务员
服务员主管	服务员主管
服务器管理员	服务器管理员
服务支持专员	服务支持专员
服务设计师	服务设计师
服装设计师	服装设计师
期权交易员	期权交易员
期货交易员	期货交易员
期货经纪人	期货经纪人
木匠大师	木匠大师
本地化专员	本地化专员
本地化项目经理	本地化项目经理
本地销售助理	本地销售助理
本地销售经理	本地销售经理
本科招生部助理主任	本科招生部助理主任
机场运营主管	机场运营主管
机构代表	机构代表
机构实地专员	机构实地专员
机构实地主管	机构实地主管
机构招聘员	机构招聘员
机构经理	机构经理
机构股票销售副总裁	机构股票销售副总裁
机构负责人	机构负责人
机构销售交易员	机构销售交易员
机构销售副总裁	机构销售副总裁
机构销售总监	机构销售总监
机械专员	机械专员
机械制图员	机械制图员
机械工程学生	机械工程学生
机械工程实习生	机械工程实习生
机械工程技术员	机械工程技术员
机械工程顾问	机械工程顾问
机械开发工程师	机械开发工程师
机械系统工程师	机械系统工程师
机械设计工程师	机械设计工程师
机械设计师	机械设计师
机械设计经理	机械设计经理
机械项目工程师	机械项目工程师
机电工程师	机电工程师
机长	机长
杂货店员	杂货店员
权益合伙人	权益合伙人
材料处理员	材料处理员
杠杆融资分析师	杠杆融资分析师
杰出软件工程师	杰出软件工程师
柜台职员	柜台职员
校内治疗师	校内治疗师
校准工程师	校准工程师
校友关系干事	校友关系干事
校友关系经理	校友关系经理
校友干事	校友干事
校对员	校对员
校长	校长
核保助理	核保助理
核保总监	核保总监
核保部助理副总裁	核保部助理副总裁
核保顾问	核保顾问
核医学技术专家	核医学技术专家
核心工程师	核心工程师
核心网络工程师	核心网络工程师
核心网络经理	核心网络经理
桌边支持技术员	桌边支持技术员
桌面工程师	桌面工程师
桌面排版员	桌面排版员
桌面排版操作员	桌面排版操作员
桌面支持	桌面支持
桌面支持专员	桌面支持专员
桌面支持分析师	桌面支持分析师
桌面支持团队负责人	桌面支持团队负责人
桌面支持实习生	桌面支持实习生
桌面支持工程师	桌面支持工程师
桌面支持技术员	桌面支持技术员
桌面管理员	桌面管理员
档案助理	档案助理
档案实习生	档案实习生
档案技术员	档案技术员
桥梁工程师	桥梁工程师
楼层员工	楼层员工
楼层总监	楼层总监
楼层技术员	楼层技术员
楼层经纪人	楼层经纪人
楼层负责人	楼层负责人
概念开发人员	概念开发人员
概念艺术家	概念艺术家
概念设计师	概念设计师
模块负责人	模块负责人
模拟设计工程师	模拟设计工程师
模拟设计师	模拟设计师
次级教师	次级教师
欺诈调查员	欺诈调查员
歌剧歌手	歌剧歌手
歌手	歌手
歌曲作家	歌曲作家
止赎专家	止赎专家
正牙医生	正牙医生
武术教练	武术教练
水上有氧运动教练	水上有氧运动教练
水手长	水手长
水文学家	水文学家
水疗主管	水疗主管
水管工大师	水管工大师
水管设计师	水管设计师
沃尔玛助理	沃尔玛助理
油画艺术家	油画艺术家
治疗师	治疗师
法务主管	法务主管
法务人员	法务人员
法务部主管	法务部主管
法务部助理经理	法务部助理经理
法务部实习生	法务部实习生
法官	法官
法律与公司秘书主管	法律与公司秘书主管
法律与合规干事	法律与合规干事
法律专员	法律专员
法律个人助理	法律个人助理
法律事务员	法律事务员
法律事务总监	法律事务总监
法律事务部主管	法律事务部主管
法律从业者	法律从业者
法律助理	法律助理
法律协调员	法律协调员
法律招聘顾问	法律招聘顾问
法律研究员	法律研究员
法律秘书	法律秘书
法律系助理教授	法律系助理教授
法律编辑	法律编辑
法律顾问	法律顾问
法规事务药剂师	法规事务药剂师
法证心理学家	法证心理学家
法院律师	法院律师
注册个人教练	注册个人教练
注册临床研究协调员	注册临床研究协调员
注册住宅估价师	注册住宅估价师
注册公共会计师	注册公共会计师
注册兽医技术员	注册兽医技术员
注册房地产估价师	注册房地产估价师
注册护理助理	注册护理助理
注册抵押贷款规划师	注册抵押贷款规划师
注册法律实习生	注册法律实习生
注册牙科保健员	注册牙科保健员
注册牙科助理	注册牙科助理
注册药房技术员	注册药房技术员
泳池经理	泳池经理
活动专员	活动专员
活动主管	活动主管
活动协调员	活动协调员
活动摄影师	活动摄影师
活动策划	活动策划
活动策划助理	活动策划助理
活动管理总监	活动管理总监
活动经理	活动经理
活动设计师	活动设计师
活动顾问	活动顾问
测试中的软件开发工程师	测试中的软件开发工程师
测试工程师	测试工程师
测试自动化专员	测试自动化专员
测试自动化顾问	测试自动化顾问
测试设计工程师	测试设计工程师
海事官员	海事官员
海事监理	海事监理
海事运营经理	海事运营经理
海事顾问	海事顾问
海鲜店员	海鲜店员
消防中尉	消防中尉
消防大队长	消防大队长
消防官员	消防官员
消防局局长	消防局局长
消防队员	消防队员
消防队长	消防队长
混合信号设计工程师	混合信号设计工程师
混音师	混音师
港口工程师	港口工程师
游戏总监	游戏总监
游戏美术师	游戏美术师
游戏设计师	游戏设计师
游泳教练	游泳教练
演艺人员	演艺人员
演讲者	演讲者
灌注师	灌注师
火器指导员	火器指导员
火焰艺术家	火焰艺术家
灯光摄像师	灯光摄像师
烘焙师	烘焙师
烹饪导师	烹饪导师
烹饪教师	烹饪教师
烹饪经理	烹饪经理
照片专员	照片专员
照片实验室技术员	照片实验室技术员
照片技术员	照片技术员
照片编辑	照片编辑
爱迪生工程发展项目	爱迪生工程发展项目
爱迪生工程师	爱迪生工程师
片场制作助理	片场制作助理
片场服装师	片场服装师
片场装饰师	片场装饰师
牙科护士	牙科护士
牙髓病学家	牙髓病学家
物业经理	物业经理
物流	物流
物流专家	物流专家
物流中心经理	物流中心经理
物流主流	物流主流
物流主管	物流主管
物流代理人	物流代理人
物流分析师	物流分析师
物流助理	物流助理
物流协调员	物流协调员
物流团队负责人	物流团队负责人
物流客户经理	物流客户经理
物流工程师	物流工程师
物流师	物流师
物流总监	物流总监
物流控制员	物流控制员
物流管理员	物流管理员
物流经理	物流经理
物流规划师	物流规划师
物流部主管	物流部主管
物流部经理	物流部经理
物流顾问	物流顾问
物理治疗主任	物理治疗主任
物理设计工程师	物理设计工程师
物理设计师	物理设计师
物理设计经理	物理设计经理
特别代理	特别代理
特别服务主任	特别服务主任
特别活动主任	特别活动主任
特别活动策划	特别活动策划
特别理赔代表	特别理赔代表
特别调查员	特别调查员
特别顾问	特别顾问
特殊教育主管	特殊教育主管
特殊教育助理	特殊教育助理
特殊教育工作者	特殊教育工作者
特殊教育教学助理	特殊教育教学助理
特殊教育教师	特殊教育教师
特殊教育者	特殊教育者
特约撰稿人	特约撰稿人
特许金融分析师	特许金融分析师
特邀艺术家	特邀艺术家
犬舍助理	犬舍助理
独家代理	独家代理
猎头总监	猎头总监
猎头顾问	猎头顾问
玩家	玩家
环境保护专员	环境保护专员
环境地质学家	环境地质学家
环境工程师	环境工程师
环境平面设计师	环境平面设计师
环境技术员	环境技术员
环境科学家	环境科学家
环境项目经理	环境项目经理
环球银行家	环球银行家
现场主管	现场主管
现场工程师	现场工程师
现场工程经理	现场工程经理
现场总工程师	现场总工程师
现场技术员	现场技术员
现场支持分析师	现场支持分析师
现场支持技术员	现场支持技术员
现场服务协调员	现场服务协调员
现场核保员	现场核保员
现场调查员	现场调查员
现场运营工程师	现场运营工程师
现场运营技术员	现场运营技术员
现金干事	现金干事
现金干事值班人员	现金干事值班人员
理发师	理发师
理学学士工程师	理学学士工程师
理赔代表	理赔代表
理赔助理	理赔助理
理赔顾问	理赔顾问
生产助理	生产助理
生产协调员	生产协调员
生产单位经理	生产单位经理
生产员	生产员
生产核保员	生产核保员
生产秘书	生产秘书
生产经理	生产经理
生产药剂师	生产药剂师
生活方式编辑	生活方式编辑
生物医学设备技术员	生物医学设备技术员
生物教师	生物教师
生物系教授	生物系教授
用户支持专员	用户支持专员
用户支持技术员	用户支持技术员
用户界面工程师	用户界面工程师
用户界面设计师	用户界面设计师
电信专员	电信专员
电信专家	电信专家
电信主管	电信主管
电信助理	电信助理
电信协调员	电信协调员
电信团队负责人	电信团队负责人
电信工程师	电信工程师
电信干事	电信干事
电信技术员	电信技术员
电信系统工程师	电信系统工程师
电信部主管	电信部主管
电信项目工程师	电信项目工程师
电信顾问	电信顾问
电台制作人	电台制作人
电台播音员	电台播音员
电台脱口秀主持人	电台脱口秀主持人
电子专员	电子专员
电子开发工程师	电子开发工程师
电子系统工程师	电子系统工程师
电子设计工程师	电子设计工程师
电子设计师	电子设计师
电子销售助理	电子销售助理
电影与视频编辑	电影与视频编辑
电影作曲家	电影作曲家
电影制片人	电影制片人
电影导演	电影导演
电影编辑	电影编辑
电气与仪器工程师	电气与仪器工程师
电气与电子工程师	电气与电子工程师
电气工程	电气工程
电气工程师	电气工程师
电气工程总监	电气工程总监
电气工程经理	电气工程经理
电气测试工程师	电气测试工程师
电气部门经理	电气部门经理
电气项目工程师	电气项目工程师
电脑销售助理	电脑销售助理
电视主持人	电视主持人
电视制作人	电视制作人
电视导演	电视导演
电视新闻制作人	电视新闻制作人
电视新闻记者	电视新闻记者
电视记者	电视记者
电话工程师	电话工程师
电话接线员	电话接线员
电路设计工程师	电路设计工程师
电路设计师	电路设计师
男乘务员	男乘务员
男装设计师	男装设计师
画家	画家
画廊助理	画廊助理
画廊协调员	画廊协调员
画廊经理	画廊经理
留学顾问	留学顾问
登记员	登记员
监管特别代理	监管特别代理
监管顾问	监管顾问
知识产权专员	知识产权专员
知识产权工程师	知识产权工程师
知识产权律师	知识产权律师
石油工程师	石油工程师
矿山地质学家	矿山地质学家
研究与发展工程师	研究与发展工程师
研究与发展技术专家	研究与发展技术专家
研究与发展科学家	研究与发展科学家
研究主任	研究主任
研究助理	研究助理
研究图书管理员	研究图书管理员
研究地质学家	研究地质学家
研究学习协调员	研究学习协调员
研究律师	研究律师
研究生助理	研究生助理
研究生土木工程师	研究生土木工程师
研究生招生经理	研究生招生经理
研究生指导员	研究生指导员
研究生机械工程师	研究生机械工程师
研究生架构师	研究生架构师
研究生结构工程师	研究生结构工程师
研究生课程协调员	研究生课程协调员
破产事务专员	破产事务专员
硕士研究员	硕士研究员
硬件专员	硬件专员
硬件团队负责人	硬件团队负责人
硬件工程师	硬件工程师
硬件开发人员	硬件开发人员
硬件开发工程师	硬件开发工程师
硬件开发总监	硬件开发总监
硬件技术员	硬件技术员
硬件支持工程师	硬件支持工程师
硬件系统工程师	硬件系统工程师
硬件设计工程师	硬件设计工程师
硬件设计师	硬件设计师
礼品店助理	礼品店助理
礼宾部职员	礼宾部职员
社交媒体专家	社交媒体专家
社交媒体总监	社交媒体总监
社交媒体战略规划师	社交媒体战略规划师
社交媒体经理	社交媒体经理
社交媒体营销经理	社交媒体营销经理
社交媒体营销顾问	社交媒体营销顾问
社会学讲师	社会学讲师
社区关系助理	社区关系助理
社区销售经理	社区销售经理
社工	社工
社论撰稿人	社论撰稿人
票务代理	票务代理
福利经理	福利经理
私人主厨	私人主厨
私人厨师	私人厨师
私人培训师	私人培训师
私人培训经理	私人培训经理
私人客户服务	私人客户服务
私人客户经理	私人客户经理
私人执业	私人执业
私人抵押贷款银行家	私人抵押贷款银行家
私人活动主管	私人活动主管
私人诊所心理治疗师	私人诊所心理治疗师
私人调查员	私人调查员
私人银行业务主管	私人银行业务主管
私人银行代表	私人银行代表
私人银行关系经理	私人银行关系经理
私人银行分析师	私人银行分析师
私人银行助理	私人银行助理
私人银行干事	私人银行干事
私人银行经理	私人银行经理
私人银行顾问	私人银行顾问
私募股权分析师	私募股权分析师
私募股权助理	私募股权助理
私募股权实习生	私募股权实习生
科学招聘人员	科学招聘人员
科目工程师	科目工程师
租赁代理	租赁代理
移动工程师	移动工程师
移动应用程序开发人员	移动应用程序开发人员
程序分析师	程序分析师
税务专员	税务专员
税务主管	税务主管
税务代理	税务代理
税务分析师	税务分析师
税务助理	税务助理
税务合规经理	税务合规经理
税务审计员	税务审计员
税务律师	税务律师
税务总监	税务总监
税务技术员	税务技术员
税务管理员	税务管理员
税务经理	税务经理
税务负责人	税务负责人
税务顾问	税务顾问
空军士兵	空军士兵
空气动力学工程师	空气动力学工程师
竣工验收工程师	竣工验收工程师
第一助理总监	第一助理总监
第一助理摄影师	第一助理摄影师
第一助理编辑	第一助理编辑
第一工程师	第一工程师
第二助理	第二助理
第二助理导演	第二助理导演
第二助理经理	第二助理经理
筹款协调员	筹款协调员
筹款干事	筹款干事
筹款总监	筹款总监
筹款经理	筹款经理
筹款部主管	筹款部主管
筹款顾问	筹款顾问
筹资分析师	筹资分析师
管理主管	管理主管
管理系助理教授	管理系助理教授
管理顾问	管理顾问
簿记员	簿记员
精神病心理健康护士	精神病心理健康护士
糕点师	糕点师
系统分析师	系统分析师
系统工程实习生	系统工程实习生
系统工程师	系统工程师
系统性能工程师	系统性能工程师
系统支持主管	系统支持主管
系统支持工程师	系统支持工程师
系统支持技术员	系统支持技术员
系统管理员	系统管理员
系统网络管理员	系统网络管理员
系统设计工程师	系统设计工程师
紧急医疗技术员	紧急医疗技术员
紧急调度员	紧急调度员
纪录片制片人	纪录片制片人
纹理艺术家	纹理艺术家
纺织品设计师	纺织品设计师
线路制作人	线路制作人
线路现场工程师	线路现场工程师
组稿编辑	组稿编辑
组织发展副总裁	组织发展副总裁
组织发展顾问	组织发展顾问
组织效率总监	组织效率总监
终端经理	终端经理
经济发展干事	经济发展干事
经纪人	经纪人
经纪人助理	经纪人助理
经纪人销售助理	经纪人销售助理
结构融资主管	结构融资主管
结构融资分析师	结构融资分析师
结构融资总监	结构融资总监
结案专员	结案专员
结案主管	结案主管
结算专员	结算专员
绘图技术员	绘图技术员
绩效导师	绩效导师
绩效改善协调员	绩效改善协调员
维修工程师	维修工程师
维修技术员	维修技术员
维和警官	维和警官
综合营销经理	综合营销经理
编目员	编目员
编舞	编舞
编辑	编辑
编辑主管	编辑主管
编辑制作经理	编辑制作经理
编辑助理	编辑助理
编辑协调员	编辑协调员
编辑部主任	编辑部主任
编辑部经理	编辑部经理
编辑项目经理	编辑项目经理
编辑顾问	编辑顾问
缝纫教师	缝纫教师
网球教练	网球教练
网站内容撰稿人	网站内容撰稿人
网站内容经理	网站内容经理
网站开发团队负责人	网站开发团队负责人
网站开发实习生	网站开发实习生
网站开发工程师	网站开发工程师
网站开发经理	网站开发经理
网站经理	网站经理
网站设计师	网站设计师
网络专员	网络专员
网络供应者	网络供应者
网络出版商	网络出版商
网络分析师	网络分析师
网络制作人	网络制作人
网络基础设施工程师	网络基础设施工程师
网络基础设施经理	网络基础设施经理
网络安全专员	网络安全专员
网络安全分析师	网络安全分析师
网络安全工程师	网络安全工程师
网络安全管理员	网络安全管理员
网络安全顾问	网络安全顾问
网络实施经理	网络实施经理
网络工程师	网络工程师
网络工程经理	网络工程经理
网络工程顾问	网络工程顾问
网络干事	网络干事
网络应用程序专员	网络应用程序专员
网络应用程序开发人员	网络应用程序开发人员
网络应用程序程序员	网络应用程序程序员
网络开发主管	网络开发主管
网络性能工程师	网络性能工程师
网络技术员	网络技术员
网络控制技术员	网络控制技术员
网络支持分析师	网络支持分析师
网络支持工程师	网络支持工程师
网络支持技术员	网络支持技术员
网络架构师	网络架构师
网络用户界面开发人员	网络用户界面开发人员
网络程序员	网络程序员
网络管理员	网络管理员
网络系统工程师	网络系统工程师
网络编辑	网络编辑
网络营销人员	网络营销人员
网络规划工程师	网络规划工程师
网络记者	网络记者
网络设计工程师	网络设计工程师
网络设计师	网络设计师
网络设计经理	网络设计经理
网络设计顾问	网络设计顾问
网络运营中心分析师	网络运营中心分析师
网络运营中心团队负责人	网络运营中心团队负责人
网络运营中心总监	网络运营中心总监
网络运营中心操作员	网络运营中心操作员
网络运营主管	网络运营主管
网络运营分析师	网络运营分析师
网络运营工程师	网络运营工程师
网络运营总监	网络运营总监
网络运营经理	网络运营经理
网络通讯专员	网络通讯专员
网络集成商	网络集成商
网络集成工程师	网络集成工程师
网络顾问	网络顾问
网页和平面设计师	网页和平面设计师
网页设计师	网页设计师
美发厅协调员	美发厅协调员
美发厅经理	美发厅经理
美发厅负责人	美发厅负责人
美容师	美容师
美容顾问	美容顾问
美工	美工
美术专员	美术专员
美术家	美术家
美术摄影师	美术摄影师
美术部门协调员	美术部门协调员
美术部门经理	美术部门经理
美甲师	美甲师
翻译协调员	翻译协调员
考勤员	考勤员
职业健康护士	职业健康护士
职业足球运动员	职业足球运动员
联营经纪人	联营经纪人
联邦代理	联邦代理
联邦税务经理	联邦税务经理
股东	股东
股票专家	股票专家
股票交易员	股票交易员
股票分析师	股票分析师
股票助理	股票助理
股票战略家	股票战略家
股票投资组合经理	股票投资组合经理
股票期权交易员	股票期权交易员
股票研究主管	股票研究主管
股票研究分析师	股票研究分析师
股票研究助理	股票研究助理
股票研究实习生	股票研究实习生
股票研究总监	股票研究总监
股票衍生品交易员	股票衍生品交易员
股票衍生品经纪人	股票衍生品经纪人
股票衍生品销售	股票衍生品销售
股票销售	股票销售
股票销售交易员	股票销售交易员
背景调查员	背景调查员
脚本主管	脚本主管
脚本作者	脚本作者
脱口秀主持人	脱口秀主持人
膳食经理	膳食经理
自动化专员	自动化专员
自动化协调员	自动化协调员
自动化团队负责人	自动化团队负责人
自动化开发人员	自动化开发人员
自动化技术员	自动化技术员
自动化测试分析师	自动化测试分析师
自动化系统工程师	自动化系统工程师
自动化顾问	自动化顾问
自由职业者	自由职业者
自营交易员	自营交易员
舞蹈教师	舞蹈教师
航天器工程师	航天器工程师
航空工程师	航空工程师
航空电子技术员	航空电子技术员
航线开发经理	航线开发经理
航线飞行员	航线飞行员
船舶经纪人	船舶经纪人
船长	船长
色彩专家	色彩专家
艺术品管理员	艺术品管理员
艺术品经销商	艺术品经销商
艺术家	艺术家
艺术总监	艺术总监
艺术指导实习生	艺术指导实习生
艺术治疗师	艺术治疗师
艺术系教授	艺术系教授
艺术评论家	艺术评论家
艺术顾问	艺术顾问
节目经理	节目经理
花卉经理	花卉经理
花卉设计师	花卉设计师
英文系助理教授	英文系助理教授
英文系教授	英文系教授
英语与外语教师	英语与外语教师
英语翻译	英语翻译
英语语言教师	英语语言教师
英语语言艺术教师	英语语言艺术教师
草药师	草药师
药学常驻医师	药学常驻医师
药学部助理主任	药学部助理主任
药房主管	药房主管
药房运营经理	药房运营经理
营销与传播主管	营销与传播主管
营销与传播助理	营销与传播助理
营销与传播协调员	营销与传播协调员
营销与公共关系专员	营销与公共关系专员
营销与公共关系干事	营销与公共关系干事
营销与公共关系顾问	营销与公共关系顾问
营销代表	营销代表
营销传播专员	营销传播专员
营销战略规划师	营销战略规划师
营销文案策划	营销文案策划
营销服务协调员	营销服务协调员
营销顾问	营销顾问
董事会副主席	董事会副主席
董事总经理	董事总经理
薪资与福利协调员	薪资与福利协调员
薪资主管	薪资主管
薪资会计	薪资会计
薪资税务会计	薪资税务会计
薪酬与福利协调员	薪酬与福利协调员
血管技术专家	血管技术专家
行为健康技术员	行为健康技术员
行政分析师	行政分析师
行政副总厨	行政副总厨
行政总厨	行政总厨
行政法法官	行政法法官
行政管家	行政管家
行政糕点师	行政糕点师
衍生品专员	衍生品专员
衍生品交易员	衍生品交易员
衍生品经纪人	衍生品经纪人
衣柜造型师	衣柜造型师
补助金经理	补助金经理
表演艺术	表演艺术
装修顾问	装修顾问
装卸工	装卸工
装袋员	装袋员
装袋工	装袋工
西班牙语家庭教师	西班牙语家庭教师
西班牙语翻译	西班牙语翻译
见习助理	见习助理
规划师	规划师
视觉专员	视觉专员
视觉化艺术家	视觉化艺术家
视觉发展艺术家	视觉发展艺术家
视觉效果艺术家	视觉效果艺术家
视觉艺术家	视觉艺术家
视觉设计师	视觉设计师
视觉陈列实习生	视觉陈列实习生
视频制作专员	视频制作专员
视频制作人	视频制作人
视频制作总监	视频制作总监
视频制作经理	视频制作经理
视频工程师	视频工程师
视频编辑	视频编辑
视频记者	视频记者
角色动画师	角色动画师
角色建模师	角色建模师
角色技术总监	角色技术总监
角色控制师	角色控制师
角色画师	角色画师
角色设计师	角色设计师
解决方案开发人员	解决方案开发人员
警员	警员
警官	警官
警察	警察
警察中队长	警察中队长
警察局副局长	警察局副局长
警察局长	警察局长
警察督察	警察督察
警察队长	警察队长
警探	警探
警长	警长
计划捐赠部主任	计划捐赠部主任
计算机动画师	计算机动画师
计算机实验室技术员	计算机实验室技术员
计算机平面美术师	计算机平面美术师
计算机技术员	计算机技术员
计算机支持分析师	计算机支持分析师
计算机支持技术员	计算机支持技术员
计算机服务技术员	计算机服务技术员
计算机硬件工程师	计算机硬件工程师
计算机硬件技术员	计算机硬件技术员
计算机科学学生	计算机科学学生
计算机科学家庭教师	计算机科学家庭教师
计算机系统技术员	计算机系统技术员
计算机网络专员	计算机网络专员
计算机网络工程师	计算机网络工程师
计算机网络技术员	计算机网络技术员
订单拣选员	订单拣选员
订单选择员	订单选择员
认证工程师	认证工程师
认证抵押贷款规划专员	认证抵押贷款规划专员
训犬师	训犬师
训练营教官	训练营教官
讲师	讲师
许可证技术员	许可证技术员
设备维修技术员	设备维修技术员
设计与制作实习生	设计与制作实习生
设计与开发工程师	设计与开发工程师
设计与开发总监	设计与开发总监
设计中心经理	设计中心经理
设计助理	设计助理
设计协调员	设计协调员
设计发布工程师	设计发布工程师
设计团队负责人	设计团队负责人
设计实习生	设计实习生
设计工作室经理	设计工作室经理
设计工程实习生	设计工程实习生
设计工程师	设计工程师
设计师	设计师
设计指导员	设计指导员
设计架构师	设计架构师
设计编辑	设计编辑
设计自动化工程师	设计自动化工程师
设计部主管	设计部主管
评级分析师	评级分析师
识字专员	识字专员
识字家庭教师	识字家庭教师
识字指导员	识字指导员
诉讼专员	诉讼专员
诉讼助理	诉讼助理
诉讼合伙人	诉讼合伙人
诉讼支持分析师	诉讼支持分析师
诉讼经理	诉讼经理
诉讼部总监	诉讼部总监
诉讼顾问	诉讼顾问
诊所主管	诊所主管
诊断工程师	诊断工程师
试衣间助理	试衣间助理
语言学家	语言学家
语言艺术教师	语言艺术教师
语言顾问	语言顾问
课堂助理	课堂助理
课堂教师	课堂教师
调味师	调味师
调度主管	调度主管
调度员	调度员
调度经理	调度经理
调查专员	调查专员
调查员	调查员
调查官	调查官
调查部总监	调查部总监
调解员	调解员
调试经理	调试经理
调遣编辑	调遣编辑
贝斯手	贝斯手
财产税经理	财产税经理
财务代表	财务代表
财务分析师	财务分析师
财务助理	财务助理
财务招聘人员	财务招聘人员
财富管理主管	财富管理主管
货币交易员	货币交易员
货运经纪人	货运经纪人
质量保证技术专家	质量保证技术专家
质量保证自动化工程师	质量保证自动化工程师
质量控制操作员	质量控制操作员
贷款专员	贷款专员
贷款代表	贷款代表
贷款协调员	贷款协调员
贷款员	贷款员
贷款处理员	贷款处理员
贷款结案员	贷款结案员
贷款部总监	贷款部总监
贸易专员	贸易专员
贸易助理	贸易助理
贸易总监	贸易总监
贸易营销主管	贸易营销主管
贸易营销助理	贸易营销助理
贸易营销协调员	贸易营销协调员
贸易部主管	贸易部主管
资产管理主管	资产管理主管
资产管理副总裁	资产管理副总裁
资产负债经理	资产负债经理
资本市场分析师	资本市场分析师
资源配置专员	资源配置专员
资源配置主管	资源配置主管
资源配置经理	资源配置经理
赛艇教练	赛艇教练
超声波技术专家	超声波技术专家
足球主教练	足球主教练
足球教练	足球教练
足球运动员	足球运动员
路面工程师	路面工程师
车站工程师	车站工程师
转诊代理	转诊代理
轮班负责人	轮班负责人
软件专员	软件专员
软件公司	软件公司
软件分析师	软件分析师
软件培训生	软件培训生
软件工程培训生	软件工程培训生
软件工程实习生	软件工程实习生
软件工程师	软件工程师
软件工程师团队负责人	软件工程师团队负责人
软件应用程序开发人员	软件应用程序开发人员
软件开发分析师	软件开发分析师
软件开发实现	软件开发实现
软件开发工程师	软件开发工程师
软件支持分析师	软件支持分析师
软件支持技术员	软件支持技术员
软件质量保证工程师	软件质量保证工程师
软件项目负责人	软件项目负责人
软件顾问	软件顾问
迁居专员	迁居专员
迁居总监	迁居总监
过渡协调员	过渡协调员
迎宾员	迎宾员
运动学教练	运动学教练
运营与物流经理	运营与物流经理
运营干事	运营干事
运营负责人	运营负责人
运货经理	运货经理
运货负责人	运货负责人
进出主管	进出主管
进出口主管	进出口主管
进出口分析师	进出口分析师
进出口助理	进出口助理
进出口协调员	进出口协调员
进出口经理	进出口经理
进口专员	进口专员
进口事务员	进口事务员
进口分析师	进口分析师
进口协调员	进口协调员
进口经理	进口经理
进口部门	进口部门
远程支持工程师	远程支持工程师
退休少校	退休少校
送餐员	送餐员
选角制作人	选角制作人
选角助理	选角助理
选角总监	选角总监
通宵补货员	通宵补货员
通讯技术员	通讯技术员
造型大师	造型大师
造型师	造型师
造型顾问	造型顾问
遛狗人	遛狗人
邮件处理员	邮件处理员
邮政局长	邮政局长
邮政检验员	邮政检验员
部署团队负责人	部署团队负责人
部署技术员	部署技术员
部门工程师	部门工程师
都市编辑	都市编辑
配置技术员	配置技术员
配饰设计师	配饰设计师
酒吧主管	酒吧主管
酒吧服务员	酒吧服务员
酒吧男招待	酒吧男招待
酒吧经理	酒吧经理
酒吧调酒师	酒吧调酒师
酒席承办商	酒席承办商
酒店协调员	酒店协调员
酒店经理	酒店经理
采摘员	采摘员
采矿工程师	采矿工程师
重录混音师	重录混音师
重症医生	重症医生
重症监护护士	重症监护护士
野外地质学家	野外地质学家
金融作家	金融作家
金融市场分析师	金融市场分析师
金融服务助理	金融服务助理
金融机构负责人	金融机构负责人
金融管理项目实习生	金融管理项目实习生
金融经纪人	金融经纪人
金融记者	金融记者
针织品设计师	针织品设计师
钢琴技术员	钢琴技术员
钥匙管理员	钥匙管理员
钻井工	钻井工
钻探主管	钻探主管
钻探监理	钻探监理
钻探经理	钻探经理
钻探顾问	钻探顾问
铜管乐器教师	铜管乐器教师
银行出纳员	银行出纳员
银行员工	银行员工
银行查帐员	银行查帐员
银行经理	银行经理
银行职员	银行职员
销售与营销总监	销售与营销总监
销售与贸易主管	销售与贸易主管
销售交易员	销售交易员
销售代表	销售代表
销售助理	销售助理
销售团队成员	销售团队成员
销售招聘人员	销售招聘人员
销售经理	销售经理
销售营销经理	销售营销经理
销售规划师	销售规划师
键盘手	键盘手
长期招聘顾问	长期招聘顾问
门卫	门卫
阅读专员	阅读专员
阅读家庭教师	阅读家庭教师
阅读教师	阅读教师
阅读教练	阅读教练
防火墙工程师	防火墙工程师
院长	院长
集团人力资源经理	集团人力资源经理
集团人力资源负责人	集团人力资源负责人
集团健身教练	集团健身教练
集团出版商	集团出版商
集团协调员	集团协调员
集团媒体总监	集团媒体总监
集团工程经理	集团工程经理
集团文案主管	集团文案主管
集团法律顾问	集团法律顾问
集团物流经理	集团物流经理
集团美术主管	集团美术主管
集团规划总监	集团规划总监
集团预约协调员	集团预约协调员
集群负责人	集群负责人
雕刻家	雕刻家
零售助理	零售助理
零售商品专员	零售商品专员
零售市场经理	零售市场经理
零售销售助理	零售销售助理
零售销售员	零售销售员
面包店经理	面包店经理
面包店职员	面包店职员
鞋类设计师	鞋类设计师
鞣制顾问	鞣制顾问
音乐专业人员	音乐专业人员
音乐人	音乐人
音乐创作人	音乐创作人
音乐制作人	音乐制作人
音乐实习生	音乐实习生
音乐家	音乐家
音乐总监	音乐总监
音乐讲师	音乐讲师
音乐顾问	音乐顾问
音频制作人	音频制作人
音频工程师	音频工程师
项目估算师	项目估算师
项目制作人	项目制作人
项目助理	项目助理
项目协调经理	项目协调经理
项目地质学家	项目地质学家
项目工程师	项目工程师
项目干事	项目干事
项目档案保管员	项目档案保管员
项目水文地质学家	项目水文地质学家
项目监理	项目监理
项目编辑	项目编辑
项目融资主管	项目融资主管
项目设计师	项目设计师
项目领班	项目领班
顾问	顾问
顾问委员会成员	顾问委员会成员
顾问邮箱	顾问邮箱
预备役警官	预备役警官
预约代理	预约代理
预约协调员	预约协调员
预约销售代理	预约销售代理
领导力发展顾问	领导力发展顾问
风琴演奏者	风琴演奏者
风险投资分析师	风险投资分析师
风险控制员	风险控制员
风险管理助理	风险管理助理
风险管理实习生	风险管理实习生
飞行业务总监	飞行业务总监
飞行指导员	飞行指导员
飞行操作经理	飞行操作经理
飞行教官	飞行教官
飞行测试工程师	飞行测试工程师
食品安全经理	食品安全经理
食品工程师	食品工程师
食品店员	食品店员
食品服务员	食品服务员
食品服务总监	食品服务总监
食品服务经理	食品服务经理
食品科学家	食品科学家
餐厅主厨	餐厅主厨
餐厅主管	餐厅主管
餐厅勤杂工	餐厅勤杂工
餐厅和酒吧经理	餐厅和酒吧经理
餐厅总经理	餐厅总经理
餐厅服务员	餐厅服务员
餐厅经理	餐厅经理
餐厅负责人	餐厅负责人
餐饮主厨	餐饮主厨
餐饮主管	餐饮主管
餐饮协调员	餐饮协调员
餐饮实习生	餐饮实习生
餐饮服务总监	餐饮服务总监
餐饮活动经理	餐饮活动经理
餐饮部副总裁	餐饮部副总裁
餐饮部总监	餐饮部总监
餐饮销售总监	餐饮销售总监
饲养员	饲养员
馆长	馆长
首席业务发展官	首席业务发展官
首席交易员	首席交易员
首席会计	首席会计
首席住院医师	首席住院医师
首席信贷官	首席信贷官
首席借贷官	首席借贷官
首席创意总监	首席创意总监
首席医疗官	首席医疗官
首席土木工程师	首席土木工程师
首席地质学家	首席地质学家
首席安全工程师	首席安全工程师
首席平面设计师	首席平面设计师
首席律师	首席律师
首席心理学家	首席心理学家
首席执行官	首席执行官
首席投资官	首席投资官
首席投资组合经理	首席投资组合经理
首席招聘人员	首席招聘人员
首席政策干事	首席政策干事
首席景观建筑师	首席景观建筑师
首席机械工程师	首席机械工程师
首席核保官	首席核保官
首席水文地质学家	首席水文地质学家
首席法律顾问	首席法律顾问
首席牙医官	首席牙医官
首席电力工程师	首席电力工程师
首席研究员	首席研究员
首席硬件工程师	首席硬件工程师
首席舞者	首席舞者
首席艺术总监	首席艺术总监
首席营销与传播官	首席营销与传播官
首席记者	首席记者
首席讲师	首席讲师
首席设计工程师	首席设计工程师
首席设计师	首席设计师
首席调查员	首席调查员
首席调酒师	首席调酒师
首席软件工程师	首席软件工程师
首席运营官	首席运营官
首席银行家	首席银行家
首席风险官	首席风险官
首席飞行员	首席飞行员
首席飞行教官	首席飞行教官
首席馆长	首席馆长
首选银行家	首选银行家
驻地	驻地
驻地医疗官	驻地医疗官
驻地工程师	驻地工程师
驻地艺术家	驻地艺术家
驻场执行官	驻场执行官
驻校艺术家	驻校艺术家
驾驶测试工程师	驾驶测试工程师
骑兵	骑兵
高中教师	高中教师
高中数学教师	高中数学教师
高管教练	高管教练
高级执业护士	高级执业护士
高级执行官	高级执行官
高级服务经理	高级服务经理
高级税务顾问	高级税务顾问
高级系统工程师	高级系统工程师
鸡尾酒会女服务员	鸡尾酒会女服务员
鸡尾酒会服务员	鸡尾酒会服务员
麻醉技术员	麻醉技术员
麻醉科住院医生	麻醉科住院医生
鼓手	鼓手
