3d动画师	3d动画师
ios开发人员	ios开发人员
java开发人员	java开发人员
人才引进	人才引进
体育教练	体育教练
作曲家	作曲家
保姆	保姆
保管员	保管员
保险经纪人	保险经纪人
公共关系主管	公共关系主管
兽医	兽医
农学家	农学家
冶金师	冶金师
出版商	出版商
前台主管	前台主管
勘探地质学家	勘探地质学家
化妆师	化妆师
化学操作员	化学操作员
卡车司机	卡车司机
历史系教授	历史系教授
厨师	厨师
叉车操作员	叉车操作员
发型师	发型师
商业战略顾问	商业战略顾问
土木工程师	土木工程师
城市设计师	城市设计师
婚礼策划	婚礼策划
媒体采购员	媒体采购员
室内装饰师	室内装饰师
小学教师	小学教师
平面设计师	平面设计师
幼儿园教师	幼儿园教师
广播电台工程师	广播电台工程师
律师	律师
心理治疗师	心理治疗师
房地产经纪人	房地产经纪人
技术招聘人员	技术招聘人员
技术支持代表	技术支持代表
投资组合分析师	投资组合分析师
投资银行分析师	投资银行分析师
摄影师	摄影师
收银员	收银员
放射科技术专家	放射科技术专家
政策顾问	政策顾问
文案策划	文案策划
新闻主播	新闻主播
旅行代理	旅行代理
无线工程师	无线工程师
时装设计师	时装设计师
木匠	木匠
机械工程师	机械工程师
桌面支持技术员	桌面支持技术员
档案保管员	档案保管员
模拟设计工程师	模拟设计工程师
歌手	歌手
水文地质学家	水文地质学家
水管工	水管工
汽车工程师	汽车工程师
注册护士	注册护士
海员	海员
消防员	消防员
烘焙师	烘焙师
牙科医生	牙科医生
物流专员	物流专员
犬类美容师	犬类美容师
环境艺术家	环境艺术家
生物医学工程师	生物医学工程师
电信工程师	电信工程师
电子工程师	电子工程师
电影导演	电影导演
电脑维修技术员	电脑维修技术员
画廊总监	画廊总监
私人健身教练	私人健身教练
私人调查员	私人调查员
私募股权分析师	私募股权分析师
税务会计	税务会计
筹款人	筹款人
纺织品设计师	纺织品设计师
网站开发工程师	网站开发工程师
网络安全分析师	网络安全分析师
网络工程师	网络工程师
翻译	翻译
股票交易员	股票交易员
自动化工程师	自动化工程师
舞者	舞者
航空航天工程师	航空航天工程师
药剂师	药剂师
视频编辑	视频编辑
警探	警探
训犬师	训犬师
调解员	调解员
贷款干事	贷款干事
贸易营销分析师	贸易营销分析师
进出口专员	进出口专员
送信员	送信员
酒保	酒保
酒席承办商	酒席承办商
针灸师	针灸师
钻探工程师	钻探工程师
银行家	银行家
飞行员	飞行员
食品技术专家	食品技术专家
麻醉师	麻醉师
