Accompagnateur_(musique)	Accompagnateur (musique)
Acheteur_pour_la_diffusion	Acheteur pour la diffusion
Acteur_professionnel	Acteur professionnel
Actionnaire	Actionnaire
Acuponcteur_diplômé	Acuponcteur diplômé
Administrateur_Système	Administrateur Système
Administrateur_Système_Microsoft	Administrateur Système Microsoft
Administrateur_adjoint_des_réseaux_locaux	Administrateur adjoint des réseaux locaux
Administrateur_de_centre_de_données	Administrateur de centre de données
Administrateur_de_la_logistique	Administrateur de la logistique
Administrateur_de_la_sécurité	Administrateur de la sécurité
Administrateur_de_la_sécurité_des_données	Administrateur de la sécurité des données
Administrateur_de_la_sécurité_des_informations	Administrateur de la sécurité des informations
Administrateur_de_la_sécurité_des_réseaux	Administrateur de la sécurité des réseaux
Administrateur_de_la_sécurité_informatique	Administrateur de la sécurité informatique
Administrateur_de_l’assistance	Administrateur de l’assistance
Administrateur_de_réseaux_de_systèmes	Administrateur de réseaux de systèmes
Administrateur_de_serveurs	Administrateur de serveurs
Administrateur_des_créances	Administrateur des créances
Administrateur_des_services_postaux	Administrateur des services postaux
Administrateur_des_échanges	Administrateur des échanges
Administrateur_du_bureau	Administrateur du bureau
Administrateur_du_personnel	Administrateur du personnel
Administrateur_en_assistance_informatique	Administrateur en assistance informatique
Administrateur_fiscal	Administrateur fiscal
Administrateur_internet	Administrateur internet
Administrateur_réseaux	Administrateur réseaux
Agent_commercial	Agent commercial
Agent_commercial_agréé	Agent commercial agréé
Agent_d'entrepôt	Agent d'entrepôt
Agent_de_banque_privée	Agent de banque privée
Agent_de_bord_aérien	Agent de bord aérien
Agent_de_bord_pour_les_vols_d’affaires	Agent de bord pour les vols d’affaires
Agent_de_la_paix	Agent de la paix
Agent_de_location	Agent de location
Agent_de_police	Agent de police
Agent_de_réservations	Agent de réservations
Agent_de_trésorerie	Agent de trésorerie
Agent_de_voyages_d’affaires	Agent de voyages d’affaires
Agent_des_impôts	Agent des impôts
Agent_des_prêts_hypothécaires	Agent des prêts hypothécaires
Agent_des_recettes	Agent des recettes
Agent_des_titres	Agent des titres
Agent_du_Middle_Office	Agent du Middle Office
Agent_du_front_office	Agent du front office
Agent_du_service_d’assistance	Agent du service d’assistance
Agent_d’acheteurs	Agent d’acheteurs
Agent_d’assurance_commerciale	Agent d’assurance commerciale
Agent_d’assurances	Agent d’assurances
Agent_d’assurances_agréé	Agent d’assurances agréé
Agent_d’exportations	Agent d’exportations
Agent_en_immobilier_commercial	Agent en immobilier commercial
Agent_exclusif	Agent exclusif
Agent_fédéral	Agent fédéral
Agent_hypothécaire	Agent hypothécaire
Agent_immobilier	Agent immobilier
Agent_immobilier_agréé	Agent immobilier agréé
Agent_immobilier_agréé_associé	Agent immobilier agréé associé
Agent_immobilier_commercial	Agent immobilier commercial
Agent_immobilier_professionnel	Agent immobilier professionnel
Agent_immobilier_résidentiel	Agent immobilier résidentiel
Agent_juridique	Agent juridique
Agent_logistique	Agent logistique
Agent_maritime	Agent maritime
Agent_pénitentiaire	Agent pénitentiaire
Agent_spécial	Agent spécial
Agent_spécial_de_la_surveillance	Agent spécial de la surveillance
Aide_pédagogique_en_éducation_spécialisée	Aide pédagogique en éducation spécialisée
Aide-enseignant_préscolaire	Aide-enseignant préscolaire
Aide-soignante_diplômée	Aide-soignante diplômée
Ambassadeur_des_admissions	Ambassadeur des admissions
Analyste_RH	Analyste RH
Analyste_adjoint_du_système	Analyste adjoint du système
Analyste_administratif	Analyste administratif
Analyste_commercial	Analyste commercial
Analyste_de_banque_d’investissement	Analyste de banque d’investissement
Analyste_de_centre_de_données	Analyste de centre de données
Analyste_de_contenus	Analyste de contenus
Analyste_de_crédit	Analyste de crédit
Analyste_de_données_de_marché	Analyste de données de marché
Analyste_de_fonds	Analyste de fonds
Analyste_de_fonds_mutuels	Analyste de fonds mutuels
Analyste_de_fonds_spéculatifs	Analyste de fonds spéculatifs
Analyste_de_la_finance_structurée	Analyste de la finance structurée
Analyste_de_la_gestion_de_portefeuille	Analyste de la gestion de portefeuille
Analyste_de_la_logistique	Analyste de la logistique
Analyste_de_la_marque	Analyste de la marque
Analyste_de_la_programmation	Analyste de la programmation
Analyste_de_la_recherche_de_crédits	Analyste de la recherche de crédits
Analyste_de_l’aide_en_matière_de_contentieux	Analyste de l’aide en matière de contentieux
Analyste_de_l’assistance	Analyste de l’assistance
Analyste_de_l’assistance_de_deuxième_ligne	Analyste de l’assistance de deuxième ligne
Analyste_de_l’assistance_de_terrain	Analyste de l’assistance de terrain
Analyste_de_l’estimation	Analyste de l’estimation
Analyste_de_réseaux	Analyste de réseaux
Analyste_des_Investissement_privés	Analyste des Investissement privés
Analyste_des_actions	Analyste des actions
Analyste_des_contraintes	Analyste des contraintes
Analyste_des_crédits_professionnels	Analyste des crédits professionnels
Analyste_des_financements	Analyste des financements
Analyste_des_importations	Analyste des importations
Analyste_des_importations_et_exportations	Analyste des importations et exportations
Analyste_des_marchandises	Analyste des marchandises
Analyste_des_marchés_de_capitaux	Analyste des marchés de capitaux
Analyste_des_marchés_financiers	Analyste des marchés financiers
Analyste_des_notations	Analyste des notations
Analyste_des_opérations_de_réseau	Analyste des opérations de réseau
Analyste_des_performances_des_investissements	Analyste des performances des investissements
Analyste_des_renseignements_sur_les_marchés	Analyste des renseignements sur les marchés
Analyste_des_salaires_fixes	Analyste des salaires fixes
Analyste_des_systèmes_d'information	Analyste des systèmes d'information
Analyste_des_systèmes_d'information_RH	Analyste des systèmes d'information RH
Analyste_des_systèmes_d'information_employé	Analyste des systèmes d'information employé
Analyste_des_systèmes_d’exploitation	Analyste des systèmes d’exploitation
Analyste_des_tests_d’automatisation	Analyste des tests d’automatisation
Analyste_des_transactions	Analyste des transactions
Analyste_du_capital_de_risque	Analyste du capital de risque
Analyste_du_centre_d’assistance	Analyste du centre d’assistance
Analyste_du_développement_commercial	Analyste du développement commercial
Analyste_du_développement_logiciel	Analyste du développement logiciel
Analyste_du_financement_à_effet_de_levier	Analyste du financement à effet de levier
Analyste_du_marketing_de_produits	Analyste du marketing de produits
Analyste_du_recrutement	Analyste du recrutement
Analyste_du_soutien_informatique	Analyste du soutien informatique
Analyste_du_support_clients	Analyste du support clients
Analyste_du_support_réseau	Analyste du support réseau
Analyste_du_support_technique	Analyste du support technique
Analyste_du_support_technologique	Analyste du support technologique
Analyste_en_assistance_logicielle	Analyste en assistance logicielle
Analyste_en_banque_financière	Analyste en banque financière
Analyste_en_banque_privée	Analyste en banque privée
Analyste_en_centre_d’opération_du_réseau	Analyste en centre d’opération du réseau
Analyste_en_financement_d’entreprise	Analyste en financement d’entreprise
Analyste_en_immobilier	Analyste en immobilier
Analyste_en_planification_stratégique	Analyste en planification stratégique
Analyste_en_recherche_d’actions	Analyste en recherche d’actions
Analyste_en_recherche_d’investissement	Analyste en recherche d’investissement
Analyste_en_support_client	Analyste en support client
Analyste_en_support_informatique	Analyste en support informatique
Analyste_en_sécurité_de_l'information	Analyste en sécurité de l'information
Analyste_en_sécurité_des_réseaux	Analyste en sécurité des réseaux
Analyste_en_sécurité_informatique	Analyste en sécurité informatique
Analyste_en_technologie	Analyste en technologie
Analyste_en_étude_de_marché	Analyste en étude de marché
Analyste_estival_de_la_banque_d’investissement	Analyste estival de la banque d’investissement
Analyste_financier	Analyste financier
Analyste_financier_agréé	Analyste financier agréé
Analyste_fiscal	Analyste fiscal
Analyste_logiciel	Analyste logiciel
Analyste_marketing	Analyste marketing
Analyste_politique	Analyste politique
Analyste_système	Analyste système
Analyste_système_consultatif	Analyste système consultatif
Anesthésiste	Anesthésiste
Anesthésiste_résident	Anesthésiste résident
Animateur	Animateur
Animateur_Flash	Animateur Flash
Animateur_assistant	Animateur assistant
Animateur_de_personnage	Animateur de personnage
Animateur_de_personnage_3D	Animateur de personnage 3D
Animateur_par_ordinateur	Animateur par ordinateur
Animateur_radio	Animateur radio
Animateur_technique	Animateur technique
Animateur_télé	Animateur télé
Annonceur_via_le_système_de_sonorisation	Annonceur via le système de sonorisation
Annonceur_à_l’antenne	Annonceur à l’antenne
Approvisionneur_de_nuit	Approvisionneur de nuit
Architecte	Architecte
Architecte_Java	Architecte Java
Architecte_adjoint	Architecte adjoint
Architecte_concepteur	Architecte concepteur
Architecte_diplômé	Architecte diplômé
Architecte_intermédiaire	Architecte intermédiaire
Architecte_paysagiste	Architecte paysagiste
Architecte_paysagiste_principal	Architecte paysagiste principal
Architecte_réseau	Architecte réseau
Architecte_technique	Architecte technique
Architecte_technologique	Architecte technologique
Archiviste_adjoint	Archiviste adjoint
Archiviste_de_projet	Archiviste de projet
Aromaticien	Aromaticien
Art-thérapeute	Art-thérapeute
Artisan_charpentier	Artisan charpentier
Artiste	Artiste
Artiste_(beaux-arts)	Artiste (beaux-arts)
Artiste_/_Animateur	Artiste / Animateur
Artiste_/_Artisan	Artiste / Artisan
Artiste_3D	Artiste 3D
Artiste_créatif	Artiste créatif
Artiste_de_spectacle	Artiste de spectacle
Artiste_de_studio	Artiste de studio
Artiste_d’animation	Artiste d’animation
Artiste_en_développement_visuel	Artiste en développement visuel
Artiste_en_effets_visuels	Artiste en effets visuels
Artiste_en_résidence	Artiste en résidence
Artiste_environnemental_3D	Artiste environnemental 3D
Artiste_floral	Artiste floral
Artiste_graphiste	Artiste graphiste
Artiste_infographiste	Artiste infographiste
Artiste_invité	Artiste invité
Artiste_peintre	Artiste peintre
Artiste_professionnel	Artiste professionnel
Artiste_résident	Artiste résident
Artiste_technique	Artiste technique
Artiste_visuel	Artiste visuel
Assistance_de_première_ligne	Assistance de première ligne
Assistance_technique	Assistance technique
Assistant_Litiges	Assistant Litiges
Assistant_Marketing_commercial	Assistant Marketing commercial
Assistant_Soins_de_santé	Assistant Soins de santé
Assistant_Souscription	Assistant Souscription
Assistant_Ventes_de_détail	Assistant Ventes de détail
Assistant_archiviste	Assistant archiviste
Assistant_chef_pâtissier	Assistant chef pâtissier
Assistant_commercial	Assistant commercial
Assistant_cuisinier	Assistant cuisinier
Assistant_de_chenil	Assistant de chenil
Assistant_de_conférence	Assistant de conférence
Assistant_de_diffusion	Assistant de diffusion
Assistant_de_galerie	Assistant de galerie
Assistant_de_justice_pour_la_période_estivale	Assistant de justice pour la période estivale
Assistant_de_post-production	Assistant de post-production
Assistant_de_production_en_plateau	Assistant de production en plateau
Assistant_de_projet	Assistant de projet
Assistant_de_recherche	Assistant de recherche
Assistant_dentaire_diplômé	Assistant dentaire diplômé
Assistant_des_ventes_locales	Assistant des ventes locales
Assistant_en_architecture	Assistant en architecture
Assistant_en_banque_privée	Assistant en banque privée
Assistant_en_conception	Assistant en conception
Assistant_en_cuisine	Assistant en cuisine
Assistant_en_dépôt_fiduciaire	Assistant en dépôt fiduciaire
Assistant_en_développement_de_produits	Assistant en développement de produits
Assistant_en_enseignement_spécialisé	Assistant en enseignement spécialisé
Assistant_en_garde_d’enfant	Assistant en garde d’enfant
Assistant_en_importation-exportation	Assistant en importation-exportation
Assistant_en_planification_d’évènements	Assistant en planification d’évènements
Assistant_en_production_de_bureau	Assistant en production de bureau
Assistant_en_prêts_commerciaux	Assistant en prêts commerciaux
Assistant_en_publications	Assistant en publications
Assistant_en_recrutement	Assistant en recrutement
Assistant_en_recrutement_RH	Assistant en recrutement RH
Assistant_en_relations_communautaires	Assistant en relations communautaires
Assistant_en_télécommunications	Assistant en télécommunications
Assistant_graphiste	Assistant graphiste
Assistant_ingénieur_en_conception	Assistant ingénieur en conception
Assistant_juridique	Assistant juridique
Assistant_juridique_d’entreprise	Assistant juridique d’entreprise
Assistant_logistique	Assistant logistique
Assistant_mode	Assistant mode
Assistant_médical	Assistant médical
Assistant_personnel_du_directeur_général	Assistant personnel du directeur général
Assistant_personnel_juridique	Assistant personnel juridique
Assistant_photographe	Assistant photographe
Assistant_photographes	Assistant photographes
Assistant_psychologique	Assistant psychologique
Assistant_pédagogique	Assistant pédagogique
Assistant_stagiaire	Assistant stagiaire
Assistant_vétérinaire	Assistant vétérinaire
Assistant_éditorial	Assistant éditorial
Assistante_maternelle	Assistante maternelle
Associé	Associé
Associé_Banque_d’investissement	Associé Banque d’investissement
Associé_Casting	Associé Casting
Associé_Courtage_commercial	Associé Courtage commercial
Associé_Développement_commercial	Associé Développement commercial
Associé_Front_Office	Associé Front Office
Associé_Hypothèques	Associé Hypothèques
Associé_Logistique	Associé Logistique
Associé_Recrutement	Associé Recrutement
Associé_Relations_avec_les_investisseurs	Associé Relations avec les investisseurs
Associé_Relations_avec_les_médias	Associé Relations avec les médias
Associé_Relations_publiques	Associé Relations publiques
Associé_Services_aux_invités	Associé Services aux invités
Associé_Transporteur_rural	Associé Transporteur rural
Associé_Vente_de_détail	Associé Vente de détail
Associé_Ventes_immobilières	Associé Ventes immobilières
Associé_Ventes_informatiques	Associé Ventes informatiques
Associé_aux_contentieux	Associé aux contentieux
Associé_aux_ventes_saisonnières	Associé aux ventes saisonnières
Associé_aux_ventes_électroniques	Associé aux ventes électroniques
Associé_chargé_des_réclamations_/_demandes_d’indemnisation	Associé chargé des réclamations / demandes d’indemnisation
Associé_comptabilité	Associé comptabilité
Associé_de_portefeuille	Associé de portefeuille
Associé_de_trésorerie	Associé de trésorerie
Associé_des_estimations	Associé des estimations
Associé_diplômé	Associé diplômé
Associé_en_Trading	Associé en Trading
Associé_en_architecture	Associé en architecture
Associé_en_développement_de_produits	Associé en développement de produits
Associé_en_soins_des_animaux	Associé en soins des animaux
Associé_immobilier	Associé immobilier
Associé_juridique	Associé juridique
Associé_temporaire	Associé temporaire
Associé_à_la_section_des_litiges	Associé à la section des litiges
Associé_à_l’accueil	Associé à l’accueil
Associé_étranger	Associé étranger
Associé-gérant	Associé-gérant
Athlète_professionnel	Athlète professionnel
Attaché_de_presse	Attaché de presse
Aubergiste	Aubergiste
Auditeur	Auditeur
Auditeur_de_nuit	Auditeur de nuit
Auditeur_fiscal	Auditeur fiscal
Auteur	Auteur
Auteur_contractuel	Auteur contractuel
Auteur_créatif	Auteur créatif
Auteur-compositeur	Auteur-compositeur
Auxiliaire_juridique	Auxiliaire juridique
Auxiliaire_juridique_d’entreprise	Auxiliaire juridique d’entreprise
Auxiliaire_scolaire	Auxiliaire scolaire
Aviateur	Aviateur
Avocat	Avocat
Avocat_/_Conseiller_juridique	Avocat / Conseiller juridique
Avocat_/_Substitut_du_procureur	Avocat / Substitut du procureur
Avocat_Travail_&_Emploi	Avocat Travail & Emploi
Avocat_adjoint	Avocat adjoint
Avocat_adjoint_du_comté	Avocat adjoint du comté
Avocat_assistant	Avocat assistant
Avocat_commercial	Avocat commercial
Avocat_conseil_adjoint_de_corporation	Avocat conseil adjoint de corporation
Avocat_d'entreprise	Avocat d'entreprise
Avocat_de_la_propriété_intellectuelle	Avocat de la propriété intellectuelle
Avocat_des_contrats	Avocat des contrats
Avocat_d’entreprise	Avocat d’entreprise
Avocat_en_charge_des_recherches	Avocat en charge des recherches
Avocat_en_chef	Avocat en chef
Avocat_en_droit_de_la_famille	Avocat en droit de la famille
Avocat_en_immobilier	Avocat en immobilier
Avocat_fiscal	Avocat fiscal
Avocat_fiscaliste	Avocat fiscaliste
Avocat_général_adjoint	Avocat général adjoint
Avocat_international	Avocat international
Avocat_municipal_adjoint	Avocat municipal adjoint
Avocat_plaidant	Avocat plaidant
Avocat_principal	Avocat principal
Avocat_pénal	Avocat pénal
Avocat-conseil_en_entreprise	Avocat-conseil en entreprise
Avocat-conseil_général_adjoint	Avocat-conseil général adjoint
Avocat-conseil_régional	Avocat-conseil régional
Babysitter	Babysitter
Banquier_commercial	Banquier commercial
Banquier_en_charge_des_relations	Banquier en charge des relations
Banquier_en_hypothèques	Banquier en hypothèques
Banquier_en_hypothèques_privées	Banquier en hypothèques privées
Banquier_principal	Banquier principal
Banquier_privé_adjoint	Banquier privé adjoint
Banquier_préférentiel	Banquier préférentiel
Banquier_universel	Banquier universel
Barbier	Barbier
Barman	Barman
Barman_en_chef	Barman en chef
Bassiste	Bassiste
Batteur	Batteur
Bibliothécaire	Bibliothécaire
Bibliothécaire_de_recherche	Bibliothécaire de recherche
Bibliothécaire_des_services_publics	Bibliothécaire des services publics
Bibliothécaire_d’entreprise	Bibliothécaire d’entreprise
Bibliothécaire_en_chef	Bibliothécaire en chef
Bibliothécaire_universitaire	Bibliothécaire universitaire
Blogueur	Blogueur
Boulanger	Boulanger
Cabinet_privé	Cabinet privé
Cadre_dans_les_assurances	Cadre dans les assurances
Cadre_dans_les_relations_avec_les_invités	Cadre dans les relations avec les invités
Cadre_en_résidence	Cadre en résidence
Cadre_juridique	Cadre juridique
Cadre_médiatique	Cadre médiatique
Cadre_supérieur_de_direction	Cadre supérieur de direction
Caissier	Caissier
Caissier_principal	Caissier principal
Caissier·ère	Caissier·ère
Caméraman	Caméraman
Caméraman_éclaireur	Caméraman éclaireur
Candidat_MBA	Candidat MBA
Capitaine	Capitaine
Capitaine_au_long_cours	Capitaine au long cours
Capitaine_de_formation	Capitaine de formation
Capitaine_de_police	Capitaine de police
Capitaine_des_banquets	Capitaine des banquets
Capitaine_des_pompiers	Capitaine des pompiers
Capitaine_d’aviation	Capitaine d’aviation
Caporal	Caporal
Cardiologue	Cardiologue
Catalogueur	Catalogueur
Chanteur	Chanteur
Chanteur_/_Vocaliste	Chanteur / Vocaliste
Chanteur_d’opéra	Chanteur d’opéra
Chanteur_professionnel	Chanteur professionnel
Character_Artist	Character Artist
Chargeur	Chargeur
Chargé_Front_Office	Chargé Front Office
Chargé_commercial_à_temps_partiel	Chargé commercial à temps partiel
Chargé_de_cabines_d’essayage	Chargé de cabines d’essayage
Chargé_de_comptes	Chargé de comptes
Chargé_de_diffusion	Chargé de diffusion
Chargé_de_galerie	Chargé de galerie
Chargé_de_la_chaîne_d'approvisionnement	Chargé de la chaîne d'approvisionnement
Chargé_de_la_clôture_des_prêts	Chargé de la clôture des prêts
Chargé_de_la_documentation	Chargé de la documentation
Chargé_de_la_dotation_en_ressources	Chargé de la dotation en ressources
Chargé_de_la_fiscalité	Chargé de la fiscalité
Chargé_de_la_logistique	Chargé de la logistique
Chargé_de_l’administration_des_crédits	Chargé de l’administration des crédits
Chargé_de_l’ouverture_et_de_la_fermeture	Chargé de l’ouverture et de la fermeture
Chargé_de_l’événementiel	Chargé de l’événementiel
Chargé_de_prêt_hypothécaire	Chargé de prêt hypothécaire
Chargé_de_prêts_hypothécaires	Chargé de prêts hypothécaires
Chargé_de_recrutement	Chargé de recrutement
Chargé_de_ventes	Chargé de ventes
Chargé_des_RH	Chargé des RH
Chargé_des_anciens_élèves	Chargé des anciens élèves
Chargé_des_clôtures_hypothécaires	Chargé des clôtures hypothécaires
Chargé_des_communications_internes	Chargé des communications internes
Chargé_des_comptes_Relations_publiques	Chargé des comptes Relations publiques
Chargé_des_déplacements	Chargé des déplacements
Chargé_des_importations-exportations	Chargé des importations-exportations
Chargé_des_médias	Chargé des médias
Chargé_des_opérations	Chargé des opérations
Chargé_des_produits	Chargé des produits
Chargé_des_recommandations	Chargé des recommandations
Chargé_des_recouvrements	Chargé des recouvrements
Chargé_des_relations	Chargé des relations
Chargé_des_relations_avec_les_anciens_élèves	Chargé des relations avec les anciens élèves
Chargé_des_relations_avec_les_donateurs	Chargé des relations avec les donateurs
Chargé_des_relations_avec_les_invités	Chargé des relations avec les invités
Chargé_des_relations_avec_les_médias	Chargé des relations avec les médias
Chargé_des_relations_clients	Chargé des relations clients
Chargé_des_réservations	Chargé des réservations
Chargé_des_services_aux_membres	Chargé des services aux membres
Chargé_des_services_financiers	Chargé des services financiers
Chargé_des_stocks_/_d’actions	Chargé des stocks / d’actions
Chargé_des_télécommunications	Chargé des télécommunications
Chargé_du_développement_de_l’entreprise	Chargé du développement de l’entreprise
Chargé_du_financement_d’entreprise	Chargé du financement d’entreprise
Chargé_du_marketing_et_de_la_communication	Chargé du marketing et de la communication
Chargé_du_recrutement	Chargé du recrutement
Chargé_du_repérage	Chargé du repérage
Chargé_du_support_technique	Chargé du support technique
Chargé_du_traitement_du_courrier	Chargé du traitement du courrier
Chargé_d’entrepôt	Chargé d’entrepôt
Chargé_d’étude_sur_les_actions	Chargé d’étude sur les actions
Chargés_de_comptes_numériques	Chargés de comptes numériques
Chauffeur	Chauffeur
Chauffeur_/_Pilote_professionnel	Chauffeur / Pilote professionnel
Chef_Copy	Chef Copy
Chef_adjoint_de_la_police	Chef adjoint de la police
Chef_adjoint_des_pompiers	Chef adjoint des pompiers
Chef_adjoint_du_service_incendie	Chef adjoint du service incendie
Chef_cuisinier	Chef cuisinier
Chef_d'équipe	Chef d'équipe
Chef_de_Partie	Chef de Partie
Chef_de_bataillon	Chef de bataillon
Chef_de_la_Banque_privée	Chef de la Banque privée
Chef_de_la_distribution	Chef de la distribution
Chef_de_la_dotation_en_ressources	Chef de la dotation en ressources
Chef_de_la_gestion_clients	Chef de la gestion clients
Chef_de_la_gestion_de_talents	Chef de la gestion de talents
Chef_de_la_gestion_des_actifs	Chef de la gestion des actifs
Chef_de_la_levée_de_fonds	Chef de la levée de fonds
Chef_de_la_logistique	Chef de la logistique
Chef_de_la_négociation_commerciale	Chef de la négociation commerciale
Chef_de_la_police	Chef de la police
Chef_de_la_politique	Chef de la politique
Chef_de_la_postproduction	Chef de la postproduction
Chef_de_la_radiologie	Chef de la radiologie
Chef_de_la_recherche_sur_les_actions	Chef de la recherche sur les actions
Chef_de_ligne	Chef de ligne
Chef_de_l’acquisition_de_talents	Chef de l’acquisition de talents
Chef_de_l’animation	Chef de l’animation
Chef_de_l’immobilier	Chef de l’immobilier
Chef_de_l’équipe_Automatisation	Chef de l’équipe Automatisation
Chef_de_l’équipe_Design	Chef de l’équipe Design
Chef_de_l’équipe_Développement_web	Chef de l’équipe Développement web
Chef_de_l’équipe_Front_Office	Chef de l’équipe Front Office
Chef_de_l’équipe_Immobilier	Chef de l’équipe Immobilier
Chef_de_l’équipe_Java	Chef de l’équipe Java
Chef_de_l’équipe_Soutien_informatique	Chef de l’équipe Soutien informatique
Chef_de_l’équipe_Soutien_technique	Chef de l’équipe Soutien technique
Chef_de_l’équipe_chargée_des_entrepôts	Chef de l’équipe chargée des entrepôts
Chef_de_l’équipe_de_déploiement	Chef de l’équipe de déploiement
Chef_de_l’équipe_de_recrutement	Chef de l’équipe de recrutement
Chef_de_l’équipe_du_matériel	Chef de l’équipe du matériel
Chef_de_l’équipe_d’assistance	Chef de l’équipe d’assistance
Chef_de_l’équipe_exécutive_Expérience_invité	Chef de l’équipe exécutive Expérience invité
Chef_de_module	Chef de module
Chef_de_projet_logiciel	Chef de projet logiciel
Chef_de_quart	Chef de quart
Chef_de_restaurant	Chef de restaurant
Chef_de_service_infirmier	Chef de service infirmier
Chef_des_RH	Chef des RH
Chef_des_RH_du_groupe	Chef des RH du groupe
Chef_des_affaires_juridiques	Chef des affaires juridiques
Chef_des_communications	Chef des communications
Chef_des_contenus	Chef des contenus
Chef_des_créatifs	Chef des créatifs
Chef_des_expéditions	Chef des expéditions
Chef_des_institutions_financières	Chef des institutions financières
Chef_des_investissements	Chef des investissements
Chef_des_opérations_de_réseau	Chef des opérations de réseau
Chef_des_pompiers	Chef des pompiers
Chef_des_relations_publiques	Chef des relations publiques
Chef_des_tests_techniques	Chef des tests techniques
Chef_des_télécommunications	Chef des télécommunications
Chef_des_ventes_&_du_trading	Chef des ventes & du trading
Chef_du_Middle_Office	Chef du Middle Office
Chef_du_département_Logistique	Chef du département Logistique
Chef_du_département_Relations_publiques	Chef du département Relations publiques
Chef_du_département_juridique	Chef du département juridique
Chef_du_développement_commercial	Chef du développement commercial
Chef_du_développement_des_activités	Chef du développement des activités
Chef_du_développement_web	Chef du développement web
Chef_du_financement_de_projets	Chef du financement de projets
Chef_du_financement_d’entreprise	Chef du financement d’entreprise
Chef_du_recrutement	Chef du recrutement
Chef_du_service_juridique	Chef du service juridique
Chef_d’entreprise	Chef d’entreprise
Chef_d’équipe_Centre_d’opération_du_réseau	Chef d’équipe Centre d’opération du réseau
Chef_d’équipe_Ingénierie_logicielle	Chef d’équipe Ingénierie logicielle
Chef_d’équipe_Logiciel_intégré	Chef d’équipe Logiciel intégré
Chef_d’équipe_Logistique	Chef d’équipe Logistique
Chef_d’équipe_Télécommunications	Chef d’équipe Télécommunications
Chef_d’équipe_du_développement_d’applications	Chef d’équipe du développement d’applications
Chef_d’étage	Chef d’étage
Chef_exécutif	Chef exécutif
Chef_exécutif_d’entreprise	Chef exécutif d’entreprise
Chef_média_du_groupe	Chef média du groupe
Chef_personnel	Chef personnel
Chef_privé	Chef privé
Chef_pâtissier	Chef pâtissier
Chef_pâtissier_exécutif	Chef pâtissier exécutif
Chef_technique	Chef technique
Chef_technique_Java	Chef technique Java
Chef_traiteur	Chef traiteur
Chercheur_de_troisième_cycle	Chercheur de troisième cycle
Chercheur_employé	Chercheur employé
Chercheur_juridique	Chercheur juridique
Chercheur_médias	Chercheur médias
Chercheur_principal	Chercheur principal
Chirurgien	Chirurgien
Chirurgien_bucco-dentaire_&_maxillofaciale	Chirurgien bucco-dentaire & maxillofaciale
Chirurgien_vétérinaire	Chirurgien vétérinaire
Chorégraphe	Chorégraphe
Chroniqueur	Chroniqueur
Cinéaste	Cinéaste
Claviériste	Claviériste
Client_comptable	Client comptable
Clown	Clown
Co-pilote	Co-pilote
Co-présentateur_de_la_matinale	Co-présentateur de la matinale
Coach_assistant_de_football	Coach assistant de football
Coach_assistant_renforcement_et_remise_en_forme	Coach assistant renforcement et remise en forme
Coach_de_fitness	Coach de fitness
Coach_de_natation	Coach de natation
Coach_de_tennis	Coach de tennis
Coach_en_alphabétisation	Coach en alphabétisation
Coach_en_lecture	Coach en lecture
Coach_en_performance	Coach en performance
Coach_en_préparation_physique	Coach en préparation physique
Coach_en_technologie	Coach en technologie
Coach_exécutif	Coach exécutif
Coach_principal	Coach principal
Coach_pédagogique	Coach pédagogique
Coach_sectoriel	Coach sectoriel
Coach_vocal	Coach vocal
Coiffeur	Coiffeur
Coiffeur-Maquilleur	Coiffeur-Maquilleur
Collaborateur_Walmart	Collaborateur Walmart
Collaborateur_en_gestion_des_risques	Collaborateur en gestion des risques
Commanditaire_/_Partenaire_en_commandite	Commanditaire / Partenaire en commandite
Commis_de_cuisine	Commis de cuisine
Commis_à_la_clientèle	Commis à la clientèle
Commissaire-priseur	Commissaire-priseur
Communications_stratégiques	Communications stratégiques
Compositeur	Compositeur
Compositeur_de_musique_de_film	Compositeur de musique de film
Compositeur_musical	Compositeur musical
Comptable	Comptable
Comptable_de_gestion_adjoint	Comptable de gestion adjoint
Comptable_des_taxes_salariales	Comptable des taxes salariales
Comptable_employé	Comptable employé
Comptable_fiscaliste_employé	Comptable fiscaliste employé
Comptable_immobilier	Comptable immobilier
Comptable_intermédiaire	Comptable intermédiaire
Comptable_principal	Comptable principal
Comptable_professionnel	Comptable professionnel
Comptable_public_agréé	Comptable public agréé
Comptable_salarial	Comptable salarial
Comptable_temporaire	Comptable temporaire
Concept_Artist	Concept Artist
Concepteur	Concepteur
Concepteur_UI	Concepteur UI
Concepteur_analogique	Concepteur analogique
Concepteur_architectural	Concepteur architectural
Concepteur_civil	Concepteur civil
Concepteur_d'intérieur	Concepteur d'intérieur
Concepteur_de_carte_de_circuit_imprimé	Concepteur de carte de circuit imprimé
Concepteur_de_circuits	Concepteur de circuits
Concepteur_de_communications	Concepteur de communications
Concepteur_de_configuration	Concepteur de configuration
Concepteur_de_diffusion	Concepteur de diffusion
Concepteur_de_la_plomberie	Concepteur de la plomberie
Concepteur_de_marque	Concepteur de marque
Concepteur_de_personnage	Concepteur de personnage
Concepteur_de_produits	Concepteur de produits
Concepteur_de_projets	Concepteur de projets
Concepteur_de_publications	Concepteur de publications
Concepteur_de_publicité	Concepteur de publicité
Concepteur_de_réseaux	Concepteur de réseaux
Concepteur_de_service	Concepteur de service
Concepteur_de_site_web	Concepteur de site web
Concepteur_de_vêtements	Concepteur de vêtements
Concepteur_du_système_de_contrôle	Concepteur du système de contrôle
Concepteur_d’accessoires	Concepteur d’accessoires
Concepteur_d’impression	Concepteur d’impression
Concepteur_d’évènement	Concepteur d’évènement
Concepteur_en_chef	Concepteur en chef
Concepteur_en_ingénierie	Concepteur en ingénierie
Concepteur_graphique_créatif	Concepteur graphique créatif
Concepteur_graphique_environnemental	Concepteur graphique environnemental
Concepteur_graphique_et_Web	Concepteur graphique et Web
Concepteur_graphique_principal	Concepteur graphique principal
Concepteur_matériel	Concepteur matériel
Concepteur_multimédia	Concepteur multimédia
Concepteur_mécanique	Concepteur mécanique
Concepteur_numérique	Concepteur numérique
Concepteur_physique	Concepteur physique
Concepteur_pour_les_médias_numériques	Concepteur pour les médias numériques
Concepteur_technique	Concepteur technique
Concepteur_technique_adjoint	Concepteur technique adjoint
Concepteur_textile	Concepteur textile
Concepteur_visuelle	Concepteur visuelle
Concepteur_électronique	Concepteur électronique
Concierge	Concierge
Conférencier	Conférencier
Conseil_en_demandes_d’indemnisation	Conseil en demandes d’indemnisation
Conseil_externe	Conseil externe
Conseil_réglementaire	Conseil réglementaire
Conseiller	Conseiller
Conseiller_clinique	Conseiller clinique
Conseiller_clinique_professionnel_agréé	Conseiller clinique professionnel agréé
Conseiller_de_camp_de_jour	Conseiller de camp de jour
Conseiller_de_camp_de_vacances	Conseiller de camp de vacances
Conseiller_diplômé_en_santé_mentale	Conseiller diplômé en santé mentale
Conseiller_en_beauté	Conseiller en beauté
Conseiller_en_investissements	Conseiller en investissements
Conseiller_en_programmes_d’études_à_l’étranger	Conseiller en programmes d’études à l’étranger
Conseiller_en_santé_mentale	Conseiller en santé mentale
Conseiller_en_sensibilisation	Conseiller en sensibilisation
Conseiller_en_services_bancaires_personnels	Conseiller en services bancaires personnels
Conseiller_en_vente_de_nouvelles_constructions	Conseiller en vente de nouvelles constructions
Conseiller_en_voyages	Conseiller en voyages
Conseiller_en_école_primaire	Conseiller en école primaire
Conseiller_en_éducation	Conseiller en éducation
Conseiller_facultaire	Conseiller facultaire
Conseiller_familial	Conseiller familial
Conseiller_fiscal	Conseiller fiscal
Conseiller_juridique	Conseiller juridique
Conseiller_juridique_du_groupe	Conseiller juridique du groupe
Conseiller_juridique_employé	Conseiller juridique employé
Conseiller_juridique_principal	Conseiller juridique principal
Conseiller_principal_adjoint	Conseiller principal adjoint
Conseiller_professionnel_agréé	Conseiller professionnel agréé
Conseiller_spécial	Conseiller spécial
Conseiller-auditeur	Conseiller-auditeur
Conservateur	Conservateur
Conservateur_d’exposition	Conservateur d’exposition
Conservateur_en_chef	Conservateur en chef
Constructeur_/_Entrepreneur_de_construction	Constructeur / Entrepreneur de construction
Consultant_IT	Consultant IT
Consultant_Java	Consultant Java
Consultant_RH	Consultant RH
Consultant_de_l’acquisition_des_talents	Consultant de l’acquisition des talents
Consultant_du_marketing	Consultant du marketing
Consultant_en_Marketing_sur_les_médias_sociaux	Consultant en Marketing sur les médias sociaux
Consultant_en_activités_stratégiques	Consultant en activités stratégiques
Consultant_en_adhésions	Consultant en adhésions
Consultant_en_art	Consultant en art
Consultant_en_assurances	Consultant en assurances
Consultant_en_automatisation	Consultant en automatisation
Consultant_en_automatisation_des_tests	Consultant en automatisation des tests
Consultant_en_commerce_international	Consultant en commerce international
Consultant_en_communications	Consultant en communications
Consultant_en_décoration	Consultant en décoration
Consultant_en_développement_commercial	Consultant en développement commercial
Consultant_en_développement_commercial_international	Consultant en développement commercial international
Consultant_en_développement_de_l’organisation	Consultant en développement de l’organisation
Consultant_en_développement_du_leadership	Consultant en développement du leadership
Consultant_en_entreprises	Consultant en entreprises
Consultant_en_fitness	Consultant en fitness
Consultant_en_forage	Consultant en forage
Consultant_en_gestion	Consultant en gestion
Consultant_en_gestion_commerciale	Consultant en gestion commerciale
Consultant_en_gestion_de_talents	Consultant en gestion de talents
Consultant_en_hypothèque	Consultant en hypothèque
Consultant_en_hypothèques	Consultant en hypothèques
Consultant_en_immobilier	Consultant en immobilier
Consultant_en_immobilier_commercial	Consultant en immobilier commercial
Consultant_en_impôts_sur_les_sociétés	Consultant en impôts sur les sociétés
Consultant_en_ingénierie_mécanique	Consultant en ingénierie mécanique
Consultant_en_ingénierie_réseaux	Consultant en ingénierie réseaux
Consultant_en_langues	Consultant en langues
Consultant_en_levée_de_fonds	Consultant en levée de fonds
Consultant_en_litiges	Consultant en litiges
Consultant_en_logiciels	Consultant en logiciels
Consultant_en_logistique	Consultant en logistique
Consultant_en_mariage	Consultant en mariage
Consultant_en_marketing_&_relations_publiques	Consultant en marketing & relations publiques
Consultant_en_mode	Consultant en mode
Consultant_en_nouvelles_constructions	Consultant en nouvelles constructions
Consultant_en_placements	Consultant en placements
Consultant_en_processus	Consultant en processus
Consultant_en_recherche	Consultant en recherche
Consultant_en_recherche_exécutive	Consultant en recherche exécutive
Consultant_en_recrutement	Consultant en recrutement
Consultant_en_recrutement_IT	Consultant en recrutement IT
Consultant_en_relations_publiques	Consultant en relations publiques
Consultant_en_relations_publiques_et_communication	Consultant en relations publiques et communication
Consultant_en_réseau_de_données	Consultant en réseau de données
Consultant_en_réseaux	Consultant en réseaux
Consultant_en_sans_fil	Consultant en sans fil
Consultant_en_santé_mentale	Consultant en santé mentale
Consultant_en_souscription	Consultant en souscription
Consultant_en_stratégie	Consultant en stratégie
Consultant_en_sécurité_des_réseaux	Consultant en sécurité des réseaux
Consultant_en_tannage_/_bronzage	Consultant en tannage / bronzage
Consultant_en_télécommunications	Consultant en télécommunications
Consultant_en_ventes_de_nouvelles_maisons	Consultant en ventes de nouvelles maisons
Consultant_en_édition	Consultant en édition
Consultant_en_événements	Consultant en événements
Consultant_juridique_en_recrutement	Consultant juridique en recrutement
Consultant_permanent_en_recrutement	Consultant permanent en recrutement
Consultant_éditorial	Consultant éditorial
Consultant·e	Consultant·e
Consultant·e_en_conception_de_produits	Consultant·e en conception de produits
Consultant·e_en_conception_de_réseaux	Consultant·e en conception de réseaux
Consultant·e_en_graphisme	Consultant·e en graphisme
Consultant·e_en_style	Consultant·e en style
Consultant·e_fiscal	Consultant·e fiscal
Consultant·e_juridique_étranger	Consultant·e juridique étranger
Consultant·e_maritime	Consultant·e maritime
Consultant·e_musical	Consultant·e musical
Contremaitre_du_forage	Contremaitre du forage
Contremaître	Contremaître
Contremaître_dans_la_construction	Contremaître dans la construction
Contremaître_de_projet	Contremaître de projet
Contremaître_de_site	Contremaître de site
Contributeur	Contributeur
Contrôleur_de_produit	Contrôleur de produit
Contrôleur_des_risques	Contrôleur des risques
Contrôleur_des_transmissions	Contrôleur des transmissions
Contrôleur_logistique	Contrôleur logistique
Coordinateur_Conférences_&_Évènements	Coordinateur Conférences & Évènements
Coordinateur_Expédition_&_Réception	Coordinateur Expédition & Réception
Coordinateur_Marketing_et_communication	Coordinateur Marketing et communication
Coordinateur_Mode	Coordinateur Mode
Coordinateur_RH	Coordinateur RH
Coordinateur_Rémunération_et_avantages	Coordinateur Rémunération et avantages
Coordinateur_athlétique	Coordinateur athlétique
Coordinateur_commercial	Coordinateur commercial
Coordinateur_de_banquet	Coordinateur de banquet
Coordinateur_de_fitness	Coordinateur de fitness
Coordinateur_de_galerie	Coordinateur de galerie
Coordinateur_de_la_communication	Coordinateur de la communication
Coordinateur_de_la_conception	Coordinateur de la conception
Coordinateur_de_la_diffusion	Coordinateur de la diffusion
Coordinateur_de_la_gestion_des_urgences	Coordinateur de la gestion des urgences
Coordinateur_de_la_logistique_internationale	Coordinateur de la logistique internationale
Coordinateur_de_la_politique_de_prix	Coordinateur de la politique de prix
Coordinateur_de_la_post-production	Coordinateur de la post-production
Coordinateur_de_la_production	Coordinateur de la production
Coordinateur_de_la_production_de_publicité	Coordinateur de la production de publicité
Coordinateur_de_la_production_d’imprimés	Coordinateur de la production d’imprimés
Coordinateur_de_la_publicité	Coordinateur de la publicité
Coordinateur_de_la_restauration	Coordinateur de la restauration
Coordinateur_de_la_transition	Coordinateur de la transition
Coordinateur_de_levées_de_fonds	Coordinateur de levées de fonds
Coordinateur_de_l’amélioration_des_performances	Coordinateur de l’amélioration des performances
Coordinateur_de_l’assistance_technique	Coordinateur de l’assistance technique
Coordinateur_de_l’automatisation	Coordinateur de l’automatisation
Coordinateur_de_l’hôtellerie	Coordinateur de l’hôtellerie
Coordinateur_de_l’édition	Coordinateur de l’édition
Coordinateur_de_mariage	Coordinateur de mariage
Coordinateur_de_partenariats	Coordinateur de partenariats
Coordinateur_de_politique	Coordinateur de politique
Coordinateur_de_programmes_académiques	Coordinateur de programmes académiques
Coordinateur_de_prêts	Coordinateur de prêts
Coordinateur_de_prêts_hypothécaires	Coordinateur de prêts hypothécaires
Coordinateur_de_recherches_cliniques	Coordinateur de recherches cliniques
Coordinateur_de_recherches_cliniques_certifié	Coordinateur de recherches cliniques certifié
Coordinateur_de_salon	Coordinateur de salon
Coordinateur_de_services_de_terrain	Coordinateur de services de terrain
Coordinateur_de_traductions	Coordinateur de traductions
Coordinateur_de_visites	Coordinateur de visites
Coordinateur_des_communications_d’entreprise	Coordinateur des communications d’entreprise
Coordinateur_des_communications_internes	Coordinateur des communications internes
Coordinateur_des_conventions	Coordinateur des conventions
Coordinateur_des_importations	Coordinateur des importations
Coordinateur_des_importations_et_exportations	Coordinateur des importations et exportations
Coordinateur_des_programmes_de_mastère	Coordinateur des programmes de mastère
Coordinateur_des_relations_avec_les_donateurs	Coordinateur des relations avec les donateurs
Coordinateur_des_relations_avec_les_invités	Coordinateur des relations avec les invités
Coordinateur_des_relations_publiques	Coordinateur des relations publiques
Coordinateur_des_relations_publiques_et_de_la_communication	Coordinateur des relations publiques et de la communication
Coordinateur_des_réservations	Coordinateur des réservations
Coordinateur_des_réservations_du_groupe	Coordinateur des réservations du groupe
Coordinateur_des_salaires_&_avantages	Coordinateur des salaires & avantages
Coordinateur_des_services_de_conférence	Coordinateur des services de conférence
Coordinateur_des_services_de_marketing	Coordinateur des services de marketing
Coordinateur_des_services_à_la_clientèle	Coordinateur des services à la clientèle
Coordinateur_des_télécommunications	Coordinateur des télécommunications
Coordinateur_du_département_Art	Coordinateur du département Art
Coordinateur_du_développement_de_fonds	Coordinateur du développement de fonds
Coordinateur_du_graphisme	Coordinateur du graphisme
Coordinateur_du_marketing_Internet	Coordinateur du marketing Internet
Coordinateur_du_marketing_commercial	Coordinateur du marketing commercial
Coordinateur_du_placement_des_étudiants	Coordinateur du placement des étudiants
Coordinateur_du_recrutement_RH	Coordinateur du recrutement RH
Coordinateur_du_service_d’assistance	Coordinateur du service d’assistance
Coordinateur_d’étude_de_cas	Coordinateur d’étude de cas
Coordinateur_juridique	Coordinateur juridique
Coordinateur_logistique	Coordinateur logistique
Coordinateur_prépresse	Coordinateur prépresse
Coordinateur_sportif	Coordinateur sportif
Coordinateur_éditorial	Coordinateur éditorial
Coordinateur_événementiel	Coordinateur événementiel
Copywriter_/_Rédacteur_publicitaire	Copywriter / Rédacteur publicitaire
Copywriter_contractuel	Copywriter contractuel
Correcteur_/_Réviseur	Correcteur / Réviseur
Correspondant_national	Correspondant national
Correspondant_principal	Correspondant principal
Cosmétologue	Cosmétologue
Courtier_affilié	Courtier affilié
Courtier_assistant	Courtier assistant
Courtier_de_fret	Courtier de fret
Courtier_de_plancher	Courtier de plancher
Courtier_désigné	Courtier désigné
Courtier_en_assurances_commerciales	Courtier en assurances commerciales
Courtier_en_dérivés	Courtier en dérivés
Courtier_en_dérivés_d’actions	Courtier en dérivés d’actions
Courtier_en_finance	Courtier en finance
Courtier_en_hypothèques	Courtier en hypothèques
Courtier_en_hypothèques_agréé	Courtier en hypothèques agréé
Courtier_en_immobilier	Courtier en immobilier
Courtier_en_obligations_à_terme	Courtier en obligations à terme
Courtier_en_produits_dérivés	Courtier en produits dérivés
Courtier_en_produits_dérivés_sur_actions	Courtier en produits dérivés sur actions
Courtier_en_réassurance	Courtier en réassurance
Courtier_maritime	Courtier maritime
Critique_d’art	Critique d’art
Créateur_de_chaussures	Créateur de chaussures
Créateur_de_concept	Créateur de concept
Créateur_de_mailles	Créateur de mailles
Créateur_de_mode	Créateur de mode
Créateur_de_vêtements_pour_femme	Créateur de vêtements pour femme
Créateur_de_vêtements_pour_homme	Créateur de vêtements pour homme
Cueilleur_/_Préparateur	Cueilleur / Préparateur
Cuisinier	Cuisinier
Dameur	Dameur
Danseur_principal	Danseur principal
Danseur_professionnel	Danseur professionnel
Dentiste_généraliste	Dentiste généraliste
Designer_adjoint	Designer adjoint
Dessinateur_civil	Dessinateur civil
Dessinateur_mécanique	Dessinateur mécanique
Deuxième_agent	Deuxième agent
Deuxième_directeur_adjoint	Deuxième directeur adjoint
Deuxième_lieutenant	Deuxième lieutenant
Deuxième_responsable_adjoint	Deuxième responsable adjoint
Diagnosticien_pédagogique	Diagnosticien pédagogique
Directeur	Directeur
Directeur_Alimentation_et_boissons	Directeur Alimentation et boissons
Directeur_Conception_&_Développement	Directeur Conception & Développement
Directeur_Marketing_et_communication	Directeur Marketing et communication
Directeur_Médias_&_Communications	Directeur Médias & Communications
Directeur_Recrutement_&_Sélection	Directeur Recrutement & Sélection
Directeur_Services_avancés	Directeur Services avancés
Directeur_Stratégie_&_Opérations	Directeur Stratégie & Opérations
Directeur_Ventes_&_Marketing	Directeur Ventes & Marketing
Directeur_adjoint	Directeur adjoint
Directeur_adjoint_de_la_communication	Directeur adjoint de la communication
Directeur_adjoint_de_la_construction	Directeur adjoint de la construction
Directeur_adjoint_de_la_pharmacie	Directeur adjoint de la pharmacie
Directeur_adjoint_de_la_sécurité	Directeur adjoint de la sécurité
Directeur_adjoint_de_l’entretien_domestique	Directeur adjoint de l’entretien domestique
Directeur_adjoint_de_l’information	Directeur adjoint de l’information
Directeur_adjoint_de_marque	Directeur adjoint de marque
Directeur_adjoint_des_admissions_des_étudiants_de_premier_cycle	Directeur adjoint des admissions des étudiants de premier cycle
Directeur_adjoint_des_communications_d’entreprise	Directeur adjoint des communications d’entreprise
Directeur_adjoint_des_services_aux_invités	Directeur adjoint des services aux invités
Directeur_adjoint_des_soins_infirmiers_/_de_la_garde_d’enfants	Directeur adjoint des soins infirmiers / de la garde d’enfants
Directeur_adjoint_du_développement_commercial	Directeur adjoint du développement commercial
Directeur_adjoint_du_fonds_annuel	Directeur adjoint du fonds annuel
Directeur_adjoint_du_service_Restauration	Directeur adjoint du service Restauration
Directeur_adjoint_du_terminal	Directeur adjoint du terminal
Directeur_artistique	Directeur artistique
Directeur_artistique_exécutif	Directeur artistique exécutif
Directeur_artistique_principal	Directeur artistique principal
Directeur_consultant	Directeur consultant
Directeur_copy	Directeur copy
Directeur_créatif_principal	Directeur créatif principal
Directeur_culinaire	Directeur culinaire
Directeur_d'entrepôt	Directeur d'entrepôt
Directeur_de_boulangerie	Directeur de boulangerie
Directeur_de_casting	Directeur de casting
Directeur_de_centre_de_conception	Directeur de centre de conception
Directeur_de_centre_d’activités_commerciales	Directeur de centre d’activités commerciales
Directeur_de_centre_d’opérations_de_réseaux	Directeur de centre d’opérations de réseaux
Directeur_de_centre_logistique	Directeur de centre logistique
Directeur_de_développement_commercial	Directeur de développement commercial
Directeur_de_fitness	Directeur de fitness
Directeur_de_fondation	Directeur de fondation
Directeur_de_galerie	Directeur de galerie
Directeur_de_jeu	Directeur de jeu
Directeur_de_l'acquisition_des_talents	Directeur de l'acquisition des talents
Directeur_de_l'éducation	Directeur de l'éducation
Directeur_de_la_construction	Directeur de la construction
Directeur_de_la_diffusion	Directeur de la diffusion
Directeur_de_la_finance_structurée	Directeur de la finance structurée
Directeur_de_la_fiscalité	Directeur de la fiscalité
Directeur_de_la_formation_personnelle	Directeur de la formation personnelle
Directeur_de_la_gestion_des_inscriptions	Directeur de la gestion des inscriptions
Directeur_de_la_gestion_événementielle	Directeur de la gestion événementielle
Directeur_de_la_kinésithérapie	Directeur de la kinésithérapie
Directeur_de_la_levée_de_fonds	Directeur de la levée de fonds
Directeur_de_la_logistique	Directeur de la logistique
Directeur_de_la_photographie	Directeur de la photographie
Directeur_de_la_planification_des_dons	Directeur de la planification des dons
Directeur_de_la_planification_du_groupe	Directeur de la planification du groupe
Directeur_de_la_politique_publique	Directeur de la politique publique
Directeur_de_la_postproduction	Directeur de la postproduction
Directeur_de_la_production	Directeur de la production
Directeur_de_la_production_de_diffusion	Directeur de la production de diffusion
Directeur_de_la_production_vidéo	Directeur de la production vidéo
Directeur_de_la_préconstruction	Directeur de la préconstruction
Directeur_de_la_publication	Directeur de la publication
Directeur_de_la_publicité	Directeur de la publicité
Directeur_de_la_radiologie	Directeur de la radiologie
Directeur_de_la_stratégie	Directeur de la stratégie
Directeur_de_l’agencement	Directeur de l’agencement
Directeur_de_l’art_interactif	Directeur de l’art interactif
Directeur_de_l’efficacité_organisationnelle	Directeur de l’efficacité organisationnelle
Directeur_de_l’enseignement_médical	Directeur de l’enseignement médical
Directeur_de_l’enseignement_spécialisé	Directeur de l’enseignement spécialisé
Directeur_de_l’impôt_foncier	Directeur de l’impôt foncier
Directeur_de_l’information	Directeur de l’information
Directeur_de_l’ingénierie_des_réseaux	Directeur de l’ingénierie des réseaux
Directeur_de_l’ingénierie_du_groupe	Directeur de l’ingénierie du groupe
Directeur_de_l’ingénierie_électrique	Directeur de l’ingénierie électrique
Directeur_de_l’unité_de_production	Directeur de l’unité de production
Directeur_de_l’évolution_des_talents	Directeur de l’évolution des talents
Directeur_de_l’événementiel	Directeur de l’événementiel
Directeur_de_pharmacie_clinique	Directeur de pharmacie clinique
Directeur_de_plateau	Directeur de plateau
Directeur_de_portefeuille	Directeur de portefeuille
Directeur_de_projet	Directeur de projet
Directeur_de_recherche_sur_les_actions	Directeur de recherche sur les actions
Directeur_de_recrutement	Directeur de recrutement
Directeur_de_rédaction	Directeur de rédaction
Directeur_de_salon	Directeur de salon
Directeur_de_service	Directeur de service
Directeur_de_spa	Directeur de spa
Directeur_de_théâtre	Directeur de théâtre
Directeur_de_visites	Directeur de visites
Directeur_dentaire	Directeur dentaire
Directeur_des_activités_dans_le_pays	Directeur des activités dans le pays
Directeur_des_actualités	Directeur des actualités
Directeur_des_admissions	Directeur des admissions
Directeur_des_affaires_juridiques	Directeur des affaires juridiques
Directeur_des_aspects_techniques	Directeur des aspects techniques
Directeur_des_assurances	Directeur des assurances
Directeur_des_assurances_aux_particuliers	Directeur des assurances aux particuliers
Directeur_des_clients_privés	Directeur des clients privés
Directeur_des_comptes	Directeur des comptes
Directeur_des_comptes_numériques	Directeur des comptes numériques
Directeur_des_contentieux	Directeur des contentieux
Directeur_des_entrepôts_et_de_la_distribution	Directeur des entrepôts et de la distribution
Directeur_des_expéditions	Directeur des expéditions
Directeur_des_forages	Directeur des forages
Directeur_des_importations	Directeur des importations
Directeur_des_informations_sur_les_marchés	Directeur des informations sur les marchés
Directeur_des_inscriptions	Directeur des inscriptions
Directeur_des_médias_numériques	Directeur des médias numériques
Directeur_des_médias_sociaux	Directeur des médias sociaux
Directeur_des_opérations	Directeur des opérations
Directeur_des_opérations_aériennes	Directeur des opérations aériennes
Directeur_des_opérations_commerciales	Directeur des opérations commerciales
Directeur_des_opérations_de_diffusion	Directeur des opérations de diffusion
Directeur_des_opérations_de_pharmacie	Directeur des opérations de pharmacie
Directeur_des_opérations_de_production	Directeur des opérations de production
Directeur_des_opérations_de_réseau	Directeur des opérations de réseau
Directeur_des_partenariats_d’entreprises	Directeur des partenariats d’entreprises
Directeur_des_placements_/_investissements	Directeur des placements / investissements
Directeur_des_programmes_techniques	Directeur des programmes techniques
Directeur_des_prêts	Directeur des prêts
Directeur_des_recherches_exécutives	Directeur des recherches exécutives
Directeur_des_recouvrements	Directeur des recouvrements
Directeur_des_relations_avec_les_donateurs	Directeur des relations avec les donateurs
Directeur_des_relations_avec_les_entreprises_et_la_fondation	Directeur des relations avec les entreprises et la fondation
Directeur_des_relations_de_la_banque_commerciale	Directeur des relations de la banque commerciale
Directeur_des_relations_médias	Directeur des relations médias
Directeur_des_relations_publiques	Directeur des relations publiques
Directeur_des_relations_publiques_mondiales	Directeur des relations publiques mondiales
Directeur_des_relocalisations	Directeur des relocalisations
Directeur_des_ressources_humaines	Directeur des ressources humaines
Directeur_des_services_aux_invités	Directeur des services aux invités
Directeur_des_services_aux_membres	Directeur des services aux membres
Directeur_des_services_bancaires_aux_entreprises	Directeur des services bancaires aux entreprises
Directeur_des_services_bancaires_personnels	Directeur des services bancaires personnels
Directeur_des_services_créatifs	Directeur des services créatifs
Directeur_des_services_d’imagerie	Directeur des services d’imagerie
Directeur_des_services_familiaux	Directeur des services familiaux
Directeur_des_services_liés_aux_comptes-restaurants	Directeur des services liés aux comptes-restaurants
Directeur_des_services_médias	Directeur des services médias
Directeur_des_services_spéciaux	Directeur des services spéciaux
Directeur_des_souscriptions	Directeur des souscriptions
Directeur_des_talents	Directeur des talents
Directeur_des_télécommunications	Directeur des télécommunications
Directeur_des_ventes	Directeur des ventes
Directeur_des_ventes_Loisirs	Directeur des ventes Loisirs
Directeur_des_ventes_de_restauration	Directeur des ventes de restauration
Directeur_des_ventes_d’exportation	Directeur des ventes d’exportation
Directeur_des_ventes_institutionnelles	Directeur des ventes institutionnelles
Directeur_des_voyages_d’affaires	Directeur des voyages d’affaires
Directeur_des_études	Directeur des études
Directeur_des_évènements_privés	Directeur des évènements privés
Directeur_des_évènements_spéciaux	Directeur des évènements spéciaux
Directeur_du_capital_humain	Directeur du capital humain
Directeur_du_culte	Directeur du culte
Directeur_du_dispatching	Directeur du dispatching
Directeur_du_département_Art	Directeur du département Art
Directeur_du_département_Logistique	Directeur du département Logistique
Directeur_du_développement_Commercial	Directeur du développement Commercial
Directeur_du_développement_Web	Directeur du développement Web
Directeur_du_développement_de_l’audience	Directeur du développement de l’audience
Directeur_du_développement_des_fonds	Directeur du développement des fonds
Directeur_du_développement_et_des_relations_publiques	Directeur du développement et des relations publiques
Directeur_du_développement_matériel	Directeur du développement matériel
Directeur_du_développement_stratégique	Directeur du développement stratégique
Directeur_du_marketing_intégré	Directeur du marketing intégré
Directeur_du_programme_de_localisation	Directeur du programme de localisation
Directeur_du_recrutement	Directeur du recrutement
Directeur_du_recrutement_de_diplômés	Directeur du recrutement de diplômés
Directeur_du_salaire_fixe	Directeur du salaire fixe
Directeur_du_service_clients	Directeur du service clients
Directeur_du_service_de_restauration	Directeur du service de restauration
Directeur_du_service_d’assistance	Directeur du service d’assistance
Directeur_du_trading	Directeur du trading
Directeur_d’agence	Directeur d’agence
Directeur_d’art_technique	Directeur d’art technique
Directeur_d’enquêtes	Directeur d’enquêtes
Directeur_d’hôpital	Directeur d’hôpital
Directeur_d’hôtellerie	Directeur d’hôtellerie
Directeur_d’école_/_Proviseur	Directeur d’école / Proviseur
Directeur_d’école_primaire	Directeur d’école primaire
Directeur_en_finance_structurée	Directeur en finance structurée
Directeur_exécutif_de_la_création	Directeur exécutif de la création
Directeur_exécutif_médical	Directeur exécutif médical
Directeur_fiscal	Directeur fiscal
Directeur_fiscal_d’entreprise	Directeur fiscal d’entreprise
Directeur_général	Directeur général
Directeur_général_adjoint	Directeur général adjoint
Directeur_général_sectoriel	Directeur général sectoriel
Directeur_musical	Directeur musical
Directeur_médias	Directeur médias
Directeur_médias_du_groupe	Directeur médias du groupe
Directeur_opérationnel	Directeur opérationnel
Directeur_préscolaire	Directeur préscolaire
Directeur_régional_de_la_construction	Directeur régional de la construction
Directeur_régional_de_la_prévention_des_pertes_/_des_sinistres	Directeur régional de la prévention des pertes / des sinistres
Directeur_sportif	Directeur sportif
Directrice_créatif_adjoint	Directrice créatif adjoint
Dispatcher_/_Répartiteur	Dispatcher / Répartiteur
Doyen	Doyen
Doyen_adjoint_des_admissions	Doyen adjoint des admissions
Doyen_des_admissions	Doyen des admissions
Décorateur_de_plateau	Décorateur de plateau
Défenseur_/_Porte-parole	Défenseur / Porte-parole
Défenseur_des_clients	Défenseur des clients
Défenseur_public_adjoint	Défenseur public adjoint
Département_des_importations	Département des importations
Détective_de_police	Détective de police
Détective_privé	Détective privé
Développeur	Développeur
Développeur_/_Formateur_du_personnel	Développeur / Formateur du personnel
Développeur_Android	Développeur Android
Développeur_App_iOS	Développeur App iOS
Développeur_Html5	Développeur Html5
Développeur_J2EE	Développeur J2EE
Développeur_Java	Développeur Java
Développeur_Java_intérimaire	Développeur Java intérimaire
Développeur_Java/J2EE	Développeur Java/J2EE
Développeur_Open_Source	Développeur Open Source
Développeur_ServiceNow	Développeur ServiceNow
Développeur_Web_Java	Développeur Web Java
Développeur_Web_PHP	Développeur Web PHP
Développeur_Web_UI	Développeur Web UI
Développeur_Web_intérimaire	Développeur Web intérimaire
Développeur_back_end	Développeur back end
Développeur_commercial	Développeur commercial
Développeur_créatif	Développeur créatif
Développeur_côté_client	Développeur côté client
Développeur_de_base_de_données	Développeur de base de données
Développeur_de_concept	Développeur de concept
Développeur_de_contenu	Développeur de contenu
Développeur_de_l’automatisation	Développeur de l’automatisation
Développeur_de_produits	Développeur de produits
Développeur_de_solutions	Développeur de solutions
Développeur_du_matériel	Développeur du matériel
Développeur_d’applications	Développeur d’applications
Développeur_d’applications_Java	Développeur d’applications Java
Développeur_d’applications_Web	Développeur d’applications Web
Développeur_d’applications_logicielles	Développeur d’applications logicielles
Développeur_d’applications_mobiles	Développeur d’applications mobiles
Développeur_d’outils	Développeur d’outils
Développeur_interactif	Développeur interactif
Employé_de_banque	Employé de banque
Employé_de_bar	Employé de bar
Employé_de_billetterie	Employé de billetterie
Employé_de_boutique_de_souvenirs	Employé de boutique de souvenirs
Endodontiste	Endodontiste
Enquêteur	Enquêteur
Enquêteur_criminel	Enquêteur criminel
Enquêteur_de_fonds	Enquêteur de fonds
Enquêteur_de_terrain	Enquêteur de terrain
Enquêteur_des_fraudes	Enquêteur des fraudes
Enquêteur_des_postes	Enquêteur des postes
Enquêteur_d’entreprise	Enquêteur d’entreprise
Enquêteur_en_chef	Enquêteur en chef
Enquêteur_régional	Enquêteur régional
Enquêteur_spécial	Enquêteur spécial
Ensacheur	Ensacheur
Enseignant	Enseignant
Enseignant_au_lycée	Enseignant au lycée
Enseignant_bilingue	Enseignant bilingue
Enseignant_dans_le_primaire	Enseignant dans le primaire
Enseignant_dans_le_secondaire_inférieur	Enseignant dans le secondaire inférieur
Enseignant_dans_l’enseignement_spécialisé	Enseignant dans l’enseignement spécialisé
Enseignant_dans_une_école_publique	Enseignant dans une école publique
Enseignant_de_lecture	Enseignant de lecture
Enseignant_de_maternelle	Enseignant de maternelle
Enseignant_de_programme_d’été	Enseignant de programme d’été
Enseignant_de_science_informatique	Enseignant de science informatique
Enseignant_d’histoire	Enseignant d’histoire
Enseignant_d’école_primaire	Enseignant d’école primaire
Enseignant_en_sciences_commerciales	Enseignant en sciences commerciales
Enseignant_en_soutien_scolaire	Enseignant en soutien scolaire
Enseignant_en_école_primaire	Enseignant en école primaire
Enseignant_pré-scolaire	Enseignant pré-scolaire
Enseignant_préscolaire	Enseignant préscolaire
Enseignant_remplaçant	Enseignant remplaçant
Enseignant_spécialisé	Enseignant spécialisé
Entraîneur_de_chiens	Entraîneur de chiens
Entraîneur_de_football	Entraîneur de football
Entraîneur_de_football_américain	Entraîneur de football américain
Entraîneur_de_football_en_chef	Entraîneur de football en chef
Entraîneur_personnel	Entraîneur personnel
Entraîneur_personnel_diplômé	Entraîneur personnel diplômé
Entrepreneur_général	Entrepreneur général
Estimateur_immobilier	Estimateur immobilier
Examinateur_bancaire	Examinateur bancaire
Examinateur_de_titres	Examinateur de titres
Examinateur_externe	Examinateur externe
Expert_en_activité_commerciale	Expert en activité commerciale
Expert_en_déclarations_de_sinistre_relatives_aux_accidents	Expert en déclarations de sinistre relatives aux accidents
Expert_en_déclarations_de_sinistre_relatives_aux_biens_immobiliers	Expert en déclarations de sinistre relatives aux biens immobiliers
Expert_en_logistique	Expert en logistique
Expert_en_support_technique	Expert en support technique
Expert_en_sécurité	Expert en sécurité
Expert_en_télécommunications	Expert en télécommunications
Expert_national	Expert national
Exploitant_de_centre_d’opération_du_réseau	Exploitant de centre d’opération du réseau
Expéditeur_/_Transporteur	Expéditeur / Transporteur
Facilitateur_de_groupe	Facilitateur de groupe
Facteur_en_zone_rurale	Facteur en zone rurale
Facteur_municipal	Facteur municipal
Financeur	Financeur
Flame_Artist	Flame Artist
Fonctionnaire	Fonctionnaire
Footballeur_américain_professionnel	Footballeur américain professionnel
Footballeur_professionnel	Footballeur professionnel
Foreur	Foreur
Formateur_de_district	Formateur de district
Formateur_en_armes	Formateur en armes
Fournisseur_réseau	Fournisseur réseau
Freelance	Freelance
Game_Artist	Game Artist
Game_Designer	Game Designer
Gardien_/_Concierge	Gardien / Concierge
Gardien_/_Conservateur_en_chef	Gardien / Conservateur en chef
Gardien_d’animaux_domestiques	Gardien d’animaux domestiques
Gestionnaire_actifs/passifs	Gestionnaire actifs/passifs
Gestionnaire_adjoint_de_fonds	Gestionnaire adjoint de fonds
Gestionnaire_de_banque_privée	Gestionnaire de banque privée
Gestionnaire_de_base	Gestionnaire de base
Gestionnaire_de_comptes	Gestionnaire de comptes
Gestionnaire_de_contenus	Gestionnaire de contenus
Gestionnaire_de_contenus_de_site_web	Gestionnaire de contenus de site web
Gestionnaire_de_contenus_numériques	Gestionnaire de contenus numériques
Gestionnaire_de_fonds	Gestionnaire de fonds
Gestionnaire_de_la_logistique	Gestionnaire de la logistique
Gestionnaire_de_la_logistique_du_groupe	Gestionnaire de la logistique du groupe
Gestionnaire_de_l’inventaire	Gestionnaire de l’inventaire
Gestionnaire_de_pool	Gestionnaire de pool
Gestionnaire_de_portefeuille	Gestionnaire de portefeuille
Gestionnaire_de_portefeuille_de_titres_à_revenus_fixes	Gestionnaire de portefeuille de titres à revenus fixes
Gestionnaire_de_portefeuille_immobilier	Gestionnaire de portefeuille immobilier
Gestionnaire_de_site_Web	Gestionnaire de site Web
Gestionnaire_de_talents	Gestionnaire de talents
Gestionnaire_des_avantages	Gestionnaire des avantages
Gestionnaire_des_comptes_Recrutement	Gestionnaire des comptes Recrutement
Gestionnaire_des_conférences	Gestionnaire des conférences
Gestionnaire_des_coûts	Gestionnaire des coûts
Gestionnaire_des_entrepôts_et_de_la_logistique	Gestionnaire des entrepôts et de la logistique
Gestionnaire_des_impôts_étatiques_et_locaux	Gestionnaire des impôts étatiques et locaux
Gestionnaire_des_informations_médicales	Gestionnaire des informations médicales
Gestionnaire_des_litiges	Gestionnaire des litiges
Gestionnaire_des_risques_de_marché	Gestionnaire des risques de marché
Gestionnaire_des_réserves_de_change	Gestionnaire des réserves de change
Gestionnaire_des_taxes_fédérales	Gestionnaire des taxes fédérales
Gestionnaire_des_ventes_hypothécaires	Gestionnaire des ventes hypothécaires
Gestionnaire_du_fonds_annuel	Gestionnaire du fonds annuel
Gestionnaire_du_portefeuille_de_produits	Gestionnaire du portefeuille de produits
Gestionnaire_du_rendement	Gestionnaire du rendement
Gestionnaire_immobilier	Gestionnaire immobilier
Graphiste	Graphiste
Greffier_/_Registraire_/_Officier_de_l’État_civil	Greffier / Registraire / Officier de l’État civil
Greffier_/_Registraire_universitaire	Greffier / Registraire universitaire
Grossiste_interne	Grossiste interne
Guichetier_en_banque	Guichetier en banque
Guide_touristique	Guide touristique
Guitariste	Guitariste
Généraliste_3D	Généraliste 3D
Généraliste_IT	Généraliste IT
Généraliste_RH	Généraliste RH
Géologue	Géologue
Géologue_chercheur	Géologue chercheur
Géologue_consultant	Géologue consultant
Géologue_de_projet	Géologue de projet
Géologue_de_terrain	Géologue de terrain
Géologue_des_réservoirs	Géologue des réservoirs
Géologue_employé	Géologue employé
Géologue_en_chef	Géologue en chef
Géologue_environnemental	Géologue environnemental
Géologue_minier	Géologue minier
Géologue_principal	Géologue principal
Géologue_temporaire	Géologue temporaire
Géophysicien	Géophysicien
Géophysicien_qui_traite_les_données	Géophysicien qui traite les données
Géoscientifique	Géoscientifique
Gérant_adjoint_de_banque	Gérant adjoint de banque
Gérant_adjoint_de_bar	Gérant adjoint de bar
Gérant_adjoint_de_portefeuille	Gérant adjoint de portefeuille
Gérant_adjoint_en_restauration	Gérant adjoint en restauration
Gérant_de_banque	Gérant de banque
Gérant_de_bar	Gérant de bar
Gérant_de_café	Gérant de café
Gérant_de_cuisine	Gérant de cuisine
Gérant_de_cuisine_adjoint	Gérant de cuisine adjoint
Gérant_de_lieu	Gérant de lieu
Gérant_de_marque	Gérant de marque
Gérant_de_portefeuille_d’actions	Gérant de portefeuille d’actions
Gérant_de_restaurant	Gérant de restaurant
Gérant_de_restaurant_&_bar	Gérant de restaurant & bar
Gérant_d’agence	Gérant d’agence
Gérant_d’agence_de_voyage	Gérant d’agence de voyage
Gérant_principal_de_portefeuille	Gérant principal de portefeuille
Habilleur_de_plateau	Habilleur de plateau
Herboriste	Herboriste
Home_Stager	Home Stager
Hydrogéologue_de_projet	Hydrogéologue de projet
Hydrogéologue_principal	Hydrogéologue principal
Hydrologue	Hydrologue
Hygiéniste_dentaire_diplômé	Hygiéniste dentaire diplômé
Hôte_/_Hébergeur	Hôte / Hébergeur
Hôte(sse)_d’accueil	Hôte(sse) d’accueil
Illustrateur_médical	Illustrateur médical
Illustrator	Illustrator
Infirmier_/_Infirmière	Infirmier / Infirmière
Infirmier_auxiliaire_autorisé	Infirmier auxiliaire autorisé
Infirmier_de_district	Infirmier de district
Infirmier_de_liaison	Infirmier de liaison
Infirmier_dentaire	Infirmier dentaire
Infirmier_des_voyages	Infirmier des voyages
Infirmier_en_chirurgie	Infirmier en chirurgie
Infirmier_en_pratique_avancée	Infirmier en pratique avancée
Infirmier_en_santé_au_travail	Infirmier en santé au travail
Infirmier_en_santé_publique	Infirmier en santé publique
Infirmier_en_soins_intensifs	Infirmier en soins intensifs
Infirmier_en_soins_à_domicile	Infirmier en soins à domicile
Infirmier_psychiatrique_praticien_de_la_santé_mentale	Infirmier psychiatrique praticien de la santé mentale
Infirmier_scolaire	Infirmier scolaire
Infirmière_praticienne	Infirmière praticienne
Infirmière_praticienne_pour_les_adultes	Infirmière praticienne pour les adultes
Infirmière_pédiatrique_praticienne	Infirmière pédiatrique praticienne
Ingénierie_des_chaussées	Ingénierie des chaussées
Ingénierie_en_conception_de_versions	Ingénierie en conception de versions
Ingénierie_électrique	Ingénierie électrique
Ingénieur_Bsc	Ingénieur Bsc
Ingénieur_Design_&_Développement	Ingénieur Design & Développement
Ingénieur_Design_&_Développement_des_produits	Ingénieur Design & Développement des produits
Ingénieur_Développement_Web	Ingénieur Développement Web
Ingénieur_Edison	Ingénieur Edison
Ingénieur_SCADA	Ingénieur SCADA
Ingénieur_Sécurité	Ingénieur Sécurité
Ingénieur_Sécurité_du_réseau	Ingénieur Sécurité du réseau
Ingénieur_Sécurité_informatique	Ingénieur Sécurité informatique
Ingénieur_UI	Ingénieur UI
Ingénieur_VoIP	Ingénieur VoIP
Ingénieur_Web	Ingénieur Web
Ingénieur_adjoint_de_la_ville	Ingénieur adjoint de la ville
Ingénieur_affecté_à_un_projet	Ingénieur affecté à un projet
Ingénieur_agricole	Ingénieur agricole
Ingénieur_alimentaire	Ingénieur alimentaire
Ingénieur_aéronautique	Ingénieur aéronautique
Ingénieur_chargé_du_contrôle_des_processus	Ingénieur chargé du contrôle des processus
Ingénieur_chimiste	Ingénieur chimiste
Ingénieur_civil_concepteur	Ingénieur civil concepteur
Ingénieur_civil_de_site	Ingénieur civil de site
Ingénieur_civil_diplômé	Ingénieur civil diplômé
Ingénieur_civil_principal	Ingénieur civil principal
Ingénieur_clinique	Ingénieur clinique
Ingénieur_commercial_sectoriel	Ingénieur commercial sectoriel
Ingénieur_complet	Ingénieur complet
Ingénieur_concepteur_de_processus	Ingénieur concepteur de processus
Ingénieur_concepteur_de_réseaux	Ingénieur concepteur de réseaux
Ingénieur_concepteur_de_systèmes	Ingénieur concepteur de systèmes
Ingénieur_concepteur_employé	Ingénieur concepteur employé
Ingénieur_conception_électronique	Ingénieur conception électronique
Ingénieur_consultant	Ingénieur consultant
Ingénieur_d'intégration_réseau	Ingénieur d'intégration réseau
Ingénieur_de_base	Ingénieur de base
Ingénieur_de_bureau	Ingénieur de bureau
Ingénieur_de_calibration	Ingénieur de calibration
Ingénieur_de_complétion	Ingénieur de complétion
Ingénieur_de_conditionnement	Ingénieur de conditionnement
Ingénieur_de_diagnostic	Ingénieur de diagnostic
Ingénieur_de_district	Ingénieur de district
Ingénieur_de_drainage	Ingénieur de drainage
Ingénieur_de_fabrication	Ingénieur de fabrication
Ingénieur_de_la_mise_en_œuvre	Ingénieur de la mise en œuvre
Ingénieur_de_la_planification_réseaux	Ingénieur de la planification réseaux
Ingénieur_de_la_propriété_intellectuelle	Ingénieur de la propriété intellectuelle
Ingénieur_de_la_sécurité_des_informations	Ingénieur de la sécurité des informations
Ingénieur_de_l’intégrité_des_signaux	Ingénieur de l’intégrité des signaux
Ingénieur_de_matériel	Ingénieur de matériel
Ingénieur_de_motopropulseur	Ingénieur de motopropulseur
Ingénieur_de_pare-feu	Ingénieur de pare-feu
Ingénieur_de_plan	Ingénieur de plan
Ingénieur_de_projet_adjoint	Ingénieur de projet adjoint
Ingénieur_de_radio_et_télédiffusion	Ingénieur de radio et télédiffusion
Ingénieur_de_recherche	Ingénieur de recherche
Ingénieur_de_section	Ingénieur de section
Ingénieur_de_site	Ingénieur de site
Ingénieur_de_terrain	Ingénieur de terrain
Ingénieur_de_tests	Ingénieur de tests
Ingénieur_de_tests_électriques	Ingénieur de tests électriques
Ingénieur_den_déploiement	Ingénieur den déploiement
Ingénieur_des_commutateurs	Ingénieur des commutateurs
Ingénieur_des_essais	Ingénieur des essais
Ingénieur_des_ponts	Ingénieur des ponts
Ingénieur_des_procédés_/_processus	Ingénieur des procédés / processus
Ingénieur_des_procédés_d’usine	Ingénieur des procédés d’usine
Ingénieur_des_services_de_construction	Ingénieur des services de construction
Ingénieur_des_systèmes_de_contrôle	Ingénieur des systèmes de contrôle
Ingénieur_des_tests_aériens	Ingénieur des tests aériens
Ingénieur_des_télécommunications	Ingénieur des télécommunications
Ingénieur_diplômé_en_structures	Ingénieur diplômé en structures
Ingénieur_du_bureau_technique	Ingénieur du bureau technique
Ingénieur_du_déploiement	Ingénieur du déploiement
Ingénieur_du_son	Ingénieur du son
Ingénieur_d’applications	Ingénieur d’applications
Ingénieur_d’applications_employé	Ingénieur d’applications employé
Ingénieur_d’appui_à_distance	Ingénieur d’appui à distance
Ingénieur_d’assistance	Ingénieur d’assistance
Ingénieur_d’entreprise	Ingénieur d’entreprise
Ingénieur_d’infrastructures_réseaux	Ingénieur d’infrastructures réseaux
Ingénieur_en_BSS_(Business_Support_System)	Ingénieur en BSS (Business Support System)
Ingénieur_en_applications_d’entreprise	Ingénieur en applications d’entreprise
Ingénieur_en_appui_aux_systèmes	Ingénieur en appui aux systèmes
Ingénieur_en_appui_informatique	Ingénieur en appui informatique
Ingénieur_en_appui_réseaux	Ingénieur en appui réseaux
Ingénieur_en_appui_technique	Ingénieur en appui technique
Ingénieur_en_appui_technique_employé	Ingénieur en appui technique employé
Ingénieur_en_appui_technique_pour_la_clientèle	Ingénieur en appui technique pour la clientèle
Ingénieur_en_assurance_qualité_des_logiciels	Ingénieur en assurance qualité des logiciels
Ingénieur_en_automatisation_de_la_conception	Ingénieur en automatisation de la conception
Ingénieur_en_automatisation_de_l’assurance_qualité	Ingénieur en automatisation de l’assurance qualité
Ingénieur_en_automatisation_des_procédés	Ingénieur en automatisation des procédés
Ingénieur_en_automatisation_des_systèmes	Ingénieur en automatisation des systèmes
Ingénieur_en_aérodynamique	Ingénieur en aérodynamique
Ingénieur_en_certification	Ingénieur en certification
Ingénieur_en_charge_des_ponts	Ingénieur en charge des ponts
Ingénieur_en_chauffage_et_climatisation	Ingénieur en chauffage et climatisation
Ingénieur_en_conception	Ingénieur en conception
Ingénieur_en_conception_analogique	Ingénieur en conception analogique
Ingénieur_en_conception_de_circuits	Ingénieur en conception de circuits
Ingénieur_en_conception_de_fabrication	Ingénieur en conception de fabrication
Ingénieur_en_conception_de_signaux_mixtes	Ingénieur en conception de signaux mixtes
Ingénieur_en_conception_de_tests	Ingénieur en conception de tests
Ingénieur_en_conception_firmware	Ingénieur en conception firmware
Ingénieur_en_conception_machine	Ingénieur en conception machine
Ingénieur_en_conception_matérielle	Ingénieur en conception matérielle
Ingénieur_en_conception_mécanique	Ingénieur en conception mécanique
Ingénieur_en_conception_numérique	Ingénieur en conception numérique
Ingénieur_en_développement_de_matériel	Ingénieur en développement de matériel
Ingénieur_en_développement_logiciel	Ingénieur en développement logiciel
Ingénieur_en_développement_logiciel_en_test	Ingénieur en développement logiciel en test
Ingénieur_en_développement_mécanique	Ingénieur en développement mécanique
Ingénieur_en_développement_électronique	Ingénieur en développement électronique
Ingénieur_en_engins_spatiaux	Ingénieur en engins spatiaux
Ingénieur_en_innovation	Ingénieur en innovation
Ingénieur_en_logiciel_distingué	Ingénieur en logiciel distingué
Ingénieur_en_matériel	Ingénieur en matériel
Ingénieur_en_matériel_informatique	Ingénieur en matériel informatique
Ingénieur_en_opérations_de_terrain	Ingénieur en opérations de terrain
Ingénieur_en_opérations_réseaux	Ingénieur en opérations réseaux
Ingénieur_en_performance_des_réseaux	Ingénieur en performance des réseaux
Ingénieur_en_performance_des_systèmes	Ingénieur en performance des systèmes
Ingénieur_en_projets_de_télécommunications	Ingénieur en projets de télécommunications
Ingénieur_en_recherche_&_développement	Ingénieur en recherche & développement
Ingénieur_en_réparation	Ingénieur en réparation
Ingénieur_en_réseaux_mobiles	Ingénieur en réseaux mobiles
Ingénieur_en_résistance	Ingénieur en résistance
Ingénieur_en_sans_fil	Ingénieur en sans fil
Ingénieur_en_schéma_de_configuration	Ingénieur en schéma de configuration
Ingénieur_en_services_d’appui_matériels	Ingénieur en services d’appui matériels
Ingénieur_en_simulation	Ingénieur en simulation
Ingénieur_en_systèmes_de_télécommunications	Ingénieur en systèmes de télécommunications
Ingénieur_en_tests	Ingénieur en tests
Ingénieur_en_transmission	Ingénieur en transmission
Ingénieur_en_téléphonie	Ingénieur en téléphonie
Ingénieur_en_électricité_&_instrumentation	Ingénieur en électricité & instrumentation
Ingénieur_environnemental	Ingénieur environnemental
Ingénieur_filaire_de_terrain	Ingénieur filaire de terrain
Ingénieur_général_de_terrain	Ingénieur général de terrain
Ingénieur_géologue	Ingénieur géologue
Ingénieur_logiciel	Ingénieur logiciel
Ingénieur_logiciel_Java	Ingénieur logiciel Java
Ingénieur_logiciel_en_chef	Ingénieur logiciel en chef
Ingénieur_logistique	Ingénieur logistique
Ingénieur_minier	Ingénieur minier
Ingénieur_mobile	Ingénieur mobile
Ingénieur_municipal	Ingénieur municipal
Ingénieur_mécanicien_adjoint	Ingénieur mécanicien adjoint
Ingénieur_mécanicien_des_processus	Ingénieur mécanicien des processus
Ingénieur_mécanicien_diplômé	Ingénieur mécanicien diplômé
Ingénieur_mécanicien_en_chef	Ingénieur mécanicien en chef
Ingénieur_mécanicien_intérimaire	Ingénieur mécanicien intérimaire
Ingénieur_mécanicien_principal	Ingénieur mécanicien principal
Ingénieur_mécanique_de_projet	Ingénieur mécanique de projet
Ingénieur_médical	Ingénieur médical
Ingénieur_métallurgique	Ingénieur métallurgique
Ingénieur_portuaire	Ingénieur portuaire
Ingénieur_principal_de_sécurité	Ingénieur principal de sécurité
Ingénieur_principal_en_conception	Ingénieur principal en conception
Ingénieur_principal_en_matériel	Ingénieur principal en matériel
Ingénieur_produits	Ingénieur produits
Ingénieur_professionnel	Ingénieur professionnel
Ingénieur_propulsion	Ingénieur propulsion
Ingénieur_pétrolier	Ingénieur pétrolier
Ingénieur_radio	Ingénieur radio
Ingénieur_réseau	Ingénieur réseau
Ingénieur_réseau_Cisco	Ingénieur réseau Cisco
Ingénieur_réseau_VoIP	Ingénieur réseau VoIP
Ingénieur_réseau_de_base	Ingénieur réseau de base
Ingénieur_réseau_de_données	Ingénieur réseau de données
Ingénieur_réseau_d’entreprise	Ingénieur réseau d’entreprise
Ingénieur_réseau_informatique	Ingénieur réseau informatique
Ingénieur_réseaux_sans_fil	Ingénieur réseaux sans fil
Ingénieur_résident	Ingénieur résident
Ingénieur_résident_adjoint	Ingénieur résident adjoint
Ingénieur_système	Ingénieur système
Ingénieur_système_Microsoft	Ingénieur système Microsoft
Ingénieur_système_avancé	Ingénieur système avancé
Ingénieur_système_informatique	Ingénieur système informatique
Ingénieur_système_intégré	Ingénieur système intégré
Ingénieur_système_régional	Ingénieur système régional
Ingénieur_systèmes_de_diffusion	Ingénieur systèmes de diffusion
Ingénieur_systèmes_de_réseau	Ingénieur systèmes de réseau
Ingénieur_systèmes_matériels	Ingénieur systèmes matériels
Ingénieur_systèmes_mécaniques	Ingénieur systèmes mécaniques
Ingénieur_systèmes_électroniques	Ingénieur systèmes électroniques
Ingénieur_technique_de_terrain	Ingénieur technique de terrain
Ingénieur_technique_en_appui_aux_ventes	Ingénieur technique en appui aux ventes
Ingénieur_vocal	Ingénieur vocal
Ingénieur_électricien	Ingénieur électricien
Ingénieur_électricien_de_projet	Ingénieur électricien de projet
Ingénieur_électricien_employé	Ingénieur électricien employé
Ingénieur_électricien_principal	Ingénieur électricien principal
Ingénieur_électrique_et_électronique	Ingénieur électrique et électronique
Ingénieur_électromécanicien	Ingénieur électromécanicien
Initiateur_de_prêt_hypothécaire	Initiateur de prêt hypothécaire
Inspecteur_de_police	Inspecteur de police
Inspecteur_en_construction	Inspecteur en construction
Instructeur_clinique	Instructeur clinique
Instructeur_de_Crossfit	Instructeur de Crossfit
Instructeur_de_bootcamp	Instructeur de bootcamp
Instructeur_de_cheerleading	Instructeur de cheerleading
Instructeur_de_fitness_collectif	Instructeur de fitness collectif
Instructeur_de_pilotage	Instructeur de pilotage
Instructeur_de_vol	Instructeur de vol
Instructeur_de_vol_en_chef	Instructeur de vol en chef
Instructeur_de_vélo_en_salle	Instructeur de vélo en salle
Instructeur_primaire_de_tir	Instructeur primaire de tir
Intensiviste	Intensiviste
Interne_en_génie_civil	Interne en génie civil
Interprète	Interprète
Intégrateur_de_réseau	Intégrateur de réseau
Investisseur_privé_associé	Investisseur privé associé
Joueur	Joueur
Joueur_de_football_américain	Joueur de football américain
Joueur_de_guitare	Joueur de guitare
Journalisme_de_radiotélévision	Journalisme de radiotélévision
Journaliste_Web	Journaliste Web
Journaliste_de_la_circulation_/_Rédacteur_de_rapports_sur_le_trafic	Journaliste de la circulation / Rédacteur de rapports sur le trafic
Journaliste_de_marché	Journaliste de marché
Journaliste_de_télévision	Journaliste de télévision
Journaliste_d’information	Journaliste d’information
Journaliste_en_chef	Journaliste en chef
Journaliste_financier	Journaliste financier
Journaliste_multimédia	Journaliste multimédia
Journaliste_pour_le_journal_télévisé	Journaliste pour le journal télévisé
Journaliste_sportif	Journaliste sportif
Journaliste_sportif_en_télévision	Journaliste sportif en télévision
Juge	Juge
Juge_de_district	Juge de district
Juge_en_droit_administratif	Juge en droit administratif
Juriste	Juriste
Liaison_clinique	Liaison clinique
Liaison_de_la_science_médicale	Liaison de la science médicale
Libraire_médias	Libraire médias
Lieutenant	Lieutenant
Lieutenant_de_police	Lieutenant de police
Lieutenant_pompier	Lieutenant pompier
Linguiste	Linguiste
Linguiste_russe	Linguiste russe
Logisticien	Logisticien
Logistique	Logistique
Magasinier	Magasinier
Major_à_la_retraite	Major à la retraite
Manipulateur_en_électroradiologie_médicale	Manipulateur en électroradiologie médicale
Manucure	Manucure
Manutentionnaire	Manutentionnaire
Manutentionnaire_d’œuvres_d’art	Manutentionnaire d’œuvres d’art
Maquettiste	Maquettiste
Maquilleur_professionnel	Maquilleur professionnel
Marchand_d’art	Marchand d’art
Marchandiseur_en_vente_au_détail	Marchandiseur en vente au détail
Marketeur_en_ligne	Marketeur en ligne
Membre_de_l’équipe_commerciale	Membre de l’équipe commerciale
Membre_distingué_du_personnel_technique	Membre distingué du personnel technique
Membre_du_Conseil_consultatif	Membre du Conseil consultatif
Membre_du_corps_(groupe_de_personnes)	Membre du corps (groupe de personnes)
Membre_du_personnel_professionnel	Membre du personnel professionnel
Membre_du_personnel_technique	Membre du personnel technique
Membre_d’un_groupe_(musique)	Membre d’un groupe (musique)
Micro-éditeur	Micro-éditeur
Mixeur_cinéma	Mixeur cinéma
Mixeur_de_son	Mixeur de son
Mixologue	Mixologue
Modélisateur	Modélisateur
Modélisateur_3D	Modélisateur 3D
Modélisateur_de_personnages	Modélisateur de personnages
Moniteur_de_fitness	Moniteur de fitness
Moniteur_de_sport	Moniteur de sport
Moniteur_d’aquagym	Moniteur d’aquagym
Moniteur_d’arts_martiaux	Moniteur d’arts martiaux
Moniteur_d’aviron	Moniteur d’aviron
Monteur_Avid	Monteur Avid
Monteur_de_films	Monteur de films
Monteur_film_et_vidéo	Monteur film et vidéo
Monteur_son	Monteur son
Monteur_vidéo	Monteur vidéo
Monteur_vidéo_adjoint	Monteur vidéo adjoint
Monteur_vidéo_en_postproduction	Monteur vidéo en postproduction
Muraliste	Muraliste
Musicien	Musicien
Musicien_professionnel	Musicien professionnel
Médecin	Médecin
Médecin_de_famille	Médecin de famille
Médecin_de_garde	Médecin de garde
Médecin_employé	Médecin employé
Médecin_en_néonatalogie	Médecin en néonatalogie
Médecin_généraliste	Médecin généraliste
Médecin_interniste	Médecin interniste
Médecin_interniste_résident	Médecin interniste résident
Médecin_militaire	Médecin militaire
Médecin_militaire_en_chef	Médecin militaire en chef
Médecin_urgentiste	Médecin urgentiste
Médiateur	Médiateur
Métallurgiste	Métallurgiste
Négociant	Négociant
Négociant_en_actions	Négociant en actions
Négociant_en_chef	Négociant en chef
Négociant_en_devises	Négociant en devises
Négociant_en_obligations_à_terme	Négociant en obligations à terme
Négociant_en_ventes_institutionnelles	Négociant en ventes institutionnelles
Négociant_exécutif	Négociant exécutif
Négociant_pour_compte_propre	Négociant pour compte propre
Négociants_d’options	Négociants d’options
Négociants_d’options_sur_actions	Négociants d’options sur actions
Négociateur_de_droits_de_diffusion	Négociateur de droits de diffusion
Négociateur_de_titres_à_revenus_fixes	Négociateur de titres à revenus fixes
Officier_de_marine	Officier de marine
Officier_de_quart	Officier de quart
Opérateur_Datacenter	Opérateur Datacenter
Opérateur_d'entrepôt	Opérateur d'entrepôt
Opérateur_de_l’édition_assistée_par_ordinateur	Opérateur de l’édition assistée par ordinateur
Opérateur_de_tableau_de_commande	Opérateur de tableau de commande
Opérateur_de_traitement_des_prêts	Opérateur de traitement des prêts
Opérateur_du_contrôle_qualité	Opérateur du contrôle qualité
Opérateur_d’enregistrements	Opérateur d’enregistrements
Opérateur_technique	Opérateur technique
Opérateur_téléphonique	Opérateur téléphonique
Organisateur_de_conférence	Organisateur de conférence
Organisateur_d’évènements	Organisateur d’évènements
Organiste	Organiste
Orthodontiste	Orthodontiste
Paraéducateur	Paraéducateur
Parrain_du_produit_/_Meilleur_vendeur	Parrain du produit / Meilleur vendeur
Partenaire	Partenaire
Partenaire_commercial_RH	Partenaire commercial RH
Partenaire_de_gestion	Partenaire de gestion
Partenaire_en_gestion_administrative	Partenaire en gestion administrative
Partenaire_fondateur	Partenaire fondateur
Participant_à_un_MBA	Participant à un MBA
Patroniste	Patroniste
Paysagiste	Paysagiste
Peintre	Peintre
Perfusionniste	Perfusionniste
Personnalité_à_l’antenne	Personnalité à l’antenne
Personnel_comptable	Personnel comptable
Personnel_de_cuisine	Personnel de cuisine
Personnel_d’étage	Personnel d’étage
Pharmacien_clinique	Pharmacien clinique
Pharmacien_clinique_employé	Pharmacien clinique employé
Pharmacien_de_production	Pharmacien de production
Pharmacien_diplômé	Pharmacien diplômé
Pharmacien_en_affaires_réglementaires	Pharmacien en affaires réglementaires
Photographe	Photographe
Photographe_de_mode	Photographe de mode
Photographe_professionnel	Photographe professionnel
Photographe_sportif	Photographe sportif
Photographe_événementiel	Photographe événementiel
Photographie_contractuel	Photographie contractuel
Photographie_de_beaux-arts	Photographie de beaux-arts
Pilote_commercial	Pilote commercial
Pilote_contractuel	Pilote contractuel
Pilote_de_ligne	Pilote de ligne
Pilote_d’entreprise	Pilote d’entreprise
Pilote_en_chef	Pilote en chef
Pilote_en_chef_adjoint	Pilote en chef adjoint
Planificateur_/_Urbaniste	Planificateur / Urbaniste
Planificateur_Mariages_et_évènements	Planificateur Mariages et évènements
Planificateur_assistant	Planificateur assistant
Planificateur_commercial	Planificateur commercial
Planificateur_de_comptes	Planificateur de comptes
Planificateur_de_la_marque	Planificateur de la marque
Planificateur_de_vacances	Planificateur de vacances
Planificateur_des_évènements_d’entreprise	Planificateur des évènements d’entreprise
Planificateur_d’hypothèques_certifié	Planificateur d’hypothèques certifié
Planificateur_d’évènements_spéciaux	Planificateur d’évènements spéciaux
Planificateur_logisticien	Planificateur logisticien
Planificateur_médias	Planificateur médias
Planificateur_médias_numériques	Planificateur médias numériques
Planificateur_numérique	Planificateur numérique
Planificateur_urbaine_/_Urbaniste	Planificateur urbaine / Urbaniste
Plombier	Plombier
Policier	Policier
Policier_de_réserve	Policier de réserve
Policier_d’État	Policier d’État
Pompier	Pompier
Porte-parole	Porte-parole
Post-producteur	Post-producteur
Premier_assistant_caméraman	Premier assistant caméraman
Premier_assistant_monteur	Premier assistant monteur
Premier_assistant_opérateur	Premier assistant opérateur
Premier_directeur_adjoint	Premier directeur adjoint
Premier_ingénieur	Premier ingénieur
Premier_officier	Premier officier
Prestataire_de_garde_d’enfants	Prestataire de garde d’enfants
Principal_adjoint	Principal adjoint
Procureur_adjoint_de_district	Procureur adjoint de district
Procureur_général_adjoint	Procureur général adjoint
Producteur	Producteur
Producteur_Web	Producteur Web
Producteur_adjoint	Producteur adjoint
Producteur_audio	Producteur audio
Producteur_commercial	Producteur commercial
Producteur_créatif	Producteur créatif
Producteur_de_casting	Producteur de casting
Producteur_de_contenu	Producteur de contenu
Producteur_de_film	Producteur de film
Producteur_de_journal_télévisé	Producteur de journal télévisé
Producteur_de_la_matinale	Producteur de la matinale
Producteur_de_ligne_commerciale	Producteur de ligne commerciale
Producteur_de_médias_numériques	Producteur de médias numériques
Producteur_de_nouveaux_médias	Producteur de nouveaux médias
Producteur_de_programme	Producteur de programme
Producteur_de_promotions	Producteur de promotions
Producteur_de_services_créatifs	Producteur de services créatifs
Producteur_de_talent	Producteur de talent
Producteur_de_télévision	Producteur de télévision
Producteur_du_développement	Producteur du développement
Producteur_du_journal_télévisé	Producteur du journal télévisé
Producteur_délégué	Producteur délégué
Producteur_d’assurance	Producteur d’assurance
Producteur_d’imprimés	Producteur d’imprimés
Producteur_exécutif	Producteur exécutif
Producteur_interactif	Producteur interactif
Producteur_multimédias	Producteur multimédias
Producteur_musical	Producteur musical
Producteur_numérique	Producteur numérique
Producteur_radio	Producteur radio
Producteur_sports	Producteur sports
Producteur_technique	Producteur technique
Producteur_vidéo	Producteur vidéo
Professeur	Professeur
Professeur_adjoint	Professeur adjoint
Professeur_adjoint_de_gestion	Professeur adjoint de gestion
Professeur_adjoint_de_médecine	Professeur adjoint de médecine
Professeur_adjoint_de_philosophie	Professeur adjoint de philosophie
Professeur_adjoint_d’histoire	Professeur adjoint d’histoire
Professeur_adjoint_invité	Professeur adjoint invité
Professeur_clinique_associé	Professeur clinique associé
Professeur_dans_l’enseignement_fondamental	Professeur dans l’enseignement fondamental
Professeur_de_barre	Professeur de barre
Professeur_de_biologie	Professeur de biologie
Professeur_de_chirurgie	Professeur de chirurgie
Professeur_de_comptabilité	Professeur de comptabilité
Professeur_de_conception	Professeur de conception
Professeur_de_couture	Professeur de couture
Professeur_de_cuisine	Professeur de cuisine
Professeur_de_cuivres	Professeur de cuivres
Professeur_de_danse	Professeur de danse
Professeur_de_droit_adjoint	Professeur de droit adjoint
Professeur_de_finance_adjoint	Professeur de finance adjoint
Professeur_de_graphisme	Professeur de graphisme
Professeur_de_guitare	Professeur de guitare
Professeur_de_kinésiologie	Professeur de kinésiologie
Professeur_de_lancer	Professeur de lancer
Professeur_de_mathématique_au_collège	Professeur de mathématique au collège
Professeur_de_mathématiques	Professeur de mathématiques
Professeur_de_mathématiques_au_lycée	Professeur de mathématiques au lycée
Professeur_de_musique	Professeur de musique
Professeur_de_philosophie	Professeur de philosophie
Professeur_de_science_dans_le_secondaire	Professeur de science dans le secondaire
Professeur_de_science_politique	Professeur de science politique
Professeur_de_sociologie	Professeur de sociologie
Professeur_de_sport	Professeur de sport
Professeur_de_théâtre	Professeur de théâtre
Professeur_du_secondaire	Professeur du secondaire
Professeur_d’anglais	Professeur d’anglais
Professeur_d’anglais_adjoint	Professeur d’anglais adjoint
Professeur_d’anglais_dans_le_secondaire	Professeur d’anglais dans le secondaire
Professeur_d’anglais_langue_étrangère	Professeur d’anglais langue étrangère
Professeur_d’animation	Professeur d’animation
Professeur_d’anthropologie	Professeur d’anthropologie
Professeur_d’architecture	Professeur d’architecture
Professeur_d’art	Professeur d’art
Professeur_d’arts_du_langage	Professeur d’arts du langage
Professeur_d’espagnol	Professeur d’espagnol
Professeur_d’histoire_adjoint	Professeur d’histoire adjoint
Professeur_d’italien	Professeur d’italien
Professeur_d’université	Professeur d’université
Professeur_en_soins_infirmiers	Professeur en soins infirmiers
Professeur_invité	Professeur invité
Professeur_principal	Professeur principal
Professeur_principal_adjoint	Professeur principal adjoint
Professeur_remplaçant	Professeur remplaçant
Professeur_émérite	Professeur émérite
Professeur_étudiant	Professeur étudiant
Professeurs_de_faculté_à_temps_plein	Professeurs de faculté à temps plein
Professionnel_de_la_musique	Professionnel de la musique
Programme_de_développement_d’ingénierie_Edison	Programme de développement d’ingénierie Edison
Programmeur_PHP	Programmeur PHP
Programmeur_Web	Programmeur Web
Programmeur_d’applications_Web	Programmeur d’applications Web
Programmeur_multimédia	Programmeur multimédia
Promeneur_de_chiens	Promeneur de chiens
Propriétaire_de_restaurant	Propriétaire de restaurant
Propriétaire_de_salon	Propriétaire de salon
Propriétaire_d’agence	Propriétaire d’agence
Préparateur_de_commande	Préparateur de commande
Préparateur_de_commandes	Préparateur de commandes
Préparateur_fiscal	Préparateur fiscal
Préposé_Expédition_&_Réception	Préposé Expédition & Réception
Préposé_au_bac_à_courrier	Préposé au bac à courrier
Préposé_au_comptoir	Préposé au comptoir
Préposé_aux_audits	Préposé aux audits
Préposé_aux_cas_/_dossiers	Préposé aux cas / dossiers
Préposé_aux_importations	Préposé aux importations
Préposé_aux_produits	Préposé aux produits
Préposé_aux_produits_de_la_mer	Préposé aux produits de la mer
Préposé_aux_prêts	Préposé aux prêts
Préposé_aux_recouvrements	Préposé aux recouvrements
Préposé_aux_tables	Préposé aux tables
Préposé_de_boulangerie	Préposé de boulangerie
Préposé_en_épicerie	Préposé en épicerie
Présentateur	Présentateur
Présentateur_de_la_matinale	Présentateur de la matinale
Présentateur_de_télévision	Présentateur de télévision
Présentateur_du_journal_matinal	Présentateur du journal matinal
Prévôt	Prévôt
Prêteur_hypothécaire	Prêteur hypothécaire
Psychanalyste	Psychanalyste
Psychologue	Psychologue
Psychologue_clinique	Psychologue clinique
Psychologue_clinique_diplômé	Psychologue clinique diplômé
Psychologue_consultant	Psychologue consultant
Psychologue_diplômé	Psychologue diplômé
Psychologue_en_chef	Psychologue en chef
Psychologue_médico-légale	Psychologue médico-légale
Psychothérapeute_en_cabinet_privé	Psychothérapeute en cabinet privé
Publiciste	Publiciste
Puériculteur_/_Puéricultrice	Puériculteur / Puéricultrice
Pâtissier	Pâtissier
Pédiatre	Pédiatre
Radiodiffuseur	Radiodiffuseur
Recruteur	Recruteur
Recruteur_RH	Recruteur RH
Recruteur_commercial	Recruteur commercial
Recruteur_dans_le_secteur_de_la_technologie	Recruteur dans le secteur de la technologie
Recruteur_d’agence	Recruteur d’agence
Recruteur_en_IT	Recruteur en IT
Recruteur_en_acquisition_de_talents	Recruteur en acquisition de talents
Recruteur_en_ingénierie	Recruteur en ingénierie
Recruteur_en_soins_de_santé	Recruteur en soins de santé
Recruteur_exécutif	Recruteur exécutif
Recruteur_financier	Recruteur financier
Recruteur_international	Recruteur international
Recruteur_interne	Recruteur interne
Recruteur_médical	Recruteur médical
Recruteur_national	Recruteur national
Recruteur_principal	Recruteur principal
Recruteur_scientifique	Recruteur scientifique
Recruteur_sur_contrat	Recruteur sur contrat
Recruteur_technique_IT	Recruteur technique IT
Relations_publiques	Relations publiques
Représentant_de_l’appui_technique	Représentant de l’appui technique
Représentant_de_services_bancaires_personnels	Représentant de services bancaires personnels
Représentant_des_comptes_publicitaires	Représentant des comptes publicitaires
Représentant_des_relations_publiques	Représentant des relations publiques
Représentant_du_compte_assurance	Représentant du compte assurance
Représentant_du_front_desk	Représentant du front desk
Représentant_du_service_après-vente_technique	Représentant du service après-vente technique
Représentant_du_service_aux_invités	Représentant du service aux invités
Représentant_du_service_clients	Représentant du service clients
Représentant_financier	Représentant financier
Représentant_marketing	Représentant marketing
Représentant·e_Crédits	Représentant·e Crédits
Représentant·e_Réclamations_/_Demandes_d’indemnisation	Représentant·e Réclamations / Demandes d’indemnisation
Représentant·e_commercial·e	Représentant·e commercial·e
Représentant·e_des_ventes_d’assurance	Représentant·e des ventes d’assurance
Représentant·e_des_ventes_d’exportation	Représentant·e des ventes d’exportation
Représentant·e_d’agence	Représentant·e d’agence
Représentant·e_en_prêts	Représentant·e en prêts
Représentant·e_pays	Représentant·e pays
Représentant·e_spécialisé_en_réclamations_/_demandes_d’indemnisation	Représentant·e spécialisé en réclamations / demandes d’indemnisation
Responsable_/_Directeur_/_Surintendant_de_site	Responsable / Directeur / Surintendant de site
Responsable_Comptes_logistiques	Responsable Comptes logistiques
Responsable_Exportations	Responsable Exportations
Responsable_Expédition_&_Réception	Responsable Expédition & Réception
Responsable_Fitness	Responsable Fitness
Responsable_Formation_&_Placement	Responsable Formation & Placement
Responsable_Front_Office	Responsable Front Office
Responsable_Marketing_&_Relations_publiques	Responsable Marketing & Relations publiques
Responsable_RH_du_groupe	Responsable RH du groupe
Responsable_RH_national	Responsable RH national
Responsable_Recrutement_&_Formation	Responsable Recrutement & Formation
Responsable_adjoint_Alimentation_et_boissons	Responsable adjoint Alimentation et boissons
Responsable_adjoint_Front_Office	Responsable adjoint Front Office
Responsable_adjoint_Frontend	Responsable adjoint Frontend
Responsable_adjoint_de_la_réception	Responsable adjoint de la réception
Responsable_adjoint_de_magasin	Responsable adjoint de magasin
Responsable_adjoint_de_nuit	Responsable adjoint de nuit
Responsable_adjoint_des_contenus	Responsable adjoint des contenus
Responsable_adjoint_des_investissements	Responsable adjoint des investissements
Responsable_adjoint_des_marchés	Responsable adjoint des marchés
Responsable_adjoint_des_recettes	Responsable adjoint des recettes
Responsable_adjoint_des_réservations	Responsable adjoint des réservations
Responsable_adjoint_des_tâches_administratives_/_de_l’entretien_domestique	Responsable adjoint des tâches administratives / de l’entretien domestique
Responsable_adjoint_du_recrutement	Responsable adjoint du recrutement
Responsable_adjoints_des_relations	Responsable adjoints des relations
Responsable_commercial_local	Responsable commercial local
Responsable_communications_&_marketing	Responsable communications & marketing
Responsable_communications_mondiales	Responsable communications mondiales
Responsable_copy	Responsable copy
Responsable_créatif	Responsable créatif
Responsable_de_affaires_juridiques_et_de_la_conformité	Responsable de affaires juridiques et de la conformité
Responsable_de_bureau_technique	Responsable de bureau technique
Responsable_de_centre_de_conférence	Responsable de centre de conférence
Responsable_de_centre_de_service	Responsable de centre de service
Responsable_de_cluster	Responsable de cluster
Responsable_de_coffre-fort	Responsable de coffre-fort
Responsable_de_conception_de_studio	Responsable de conception de studio
Responsable_de_district_pour_la_protection_des_actifs	Responsable de district pour la protection des actifs
Responsable_de_l'accueil	Responsable de l'accueil
Responsable_de_l'acquisition_de_site	Responsable de l'acquisition de site
Responsable_de_l'acquisition_des_talents	Responsable de l'acquisition des talents
Responsable_de_la_circulation	Responsable de la circulation
Responsable_de_la_conception_créative	Responsable de la conception créative
Responsable_de_la_conception_de_la_marque	Responsable de la conception de la marque
Responsable_de_la_conception_graphique	Responsable de la conception graphique
Responsable_de_la_conception_matérielle	Responsable de la conception matérielle
Responsable_de_la_conception_mécanique	Responsable de la conception mécanique
Responsable_de_la_conception_réseaux	Responsable de la conception réseaux
Responsable_de_la_conformité_fiscale	Responsable de la conformité fiscale
Responsable_de_la_coordination_de_projets	Responsable de la coordination de projets
Responsable_de_la_dotation_en_personne	Responsable de la dotation en personne
Responsable_de_la_dotation_en_ressources	Responsable de la dotation en ressources
Responsable_de_la_formation_personnelle	Responsable de la formation personnelle
Responsable_de_la_garantie_de_l’information	Responsable de la garantie de l’information
Responsable_de_la_gestion_patrimoniale	Responsable de la gestion patrimoniale
Responsable_de_la_levée_de_fonds	Responsable de la levée de fonds
Responsable_de_la_logistique	Responsable de la logistique
Responsable_de_la_logistique_internationale	Responsable de la logistique internationale
Responsable_de_la_logistique_mondiale	Responsable de la logistique mondiale
Responsable_de_la_logistique_nationale	Responsable de la logistique nationale
Responsable_de_la_logistique_régionale	Responsable de la logistique régionale
Responsable_de_la_mise_en_service	Responsable de la mise en service
Responsable_de_la_mise_en_œuvre_des_réseaux	Responsable de la mise en œuvre des réseaux
Responsable_de_la_photographie	Responsable de la photographie
Responsable_de_la_planification_stratégique	Responsable de la planification stratégique
Responsable_de_la_politique_de_prix	Responsable de la politique de prix
Responsable_de_la_post-production	Responsable de la post-production
Responsable_de_la_production_imprimée	Responsable de la production imprimée
Responsable_de_la_production_vidéo	Responsable de la production vidéo
Responsable_de_la_préconstruction	Responsable de la préconstruction
Responsable_de_la_publicité_en_ligne	Responsable de la publicité en ligne
Responsable_de_la_restauration	Responsable de la restauration
Responsable_de_la_sécurité_des_aliments	Responsable de la sécurité des aliments
Responsable_de_l’aide_humanitaire	Responsable de l’aide humanitaire
Responsable_de_l’appui_aux_systèmes	Responsable de l’appui aux systèmes
Responsable_de_l’appui_technique	Responsable de l’appui technique
Responsable_de_l’exploitation_de_filiales	Responsable de l’exploitation de filiales
Responsable_de_l’exploitation_des_entrepôts	Responsable de l’exploitation des entrepôts
Responsable_de_l’externalisation	Responsable de l’externalisation
Responsable_de_l’imagerie	Responsable de l’imagerie
Responsable_de_l’import-export	Responsable de l’import-export
Responsable_de_l’infrastructure_réseau	Responsable de l’infrastructure réseau
Responsable_de_l’ingénierie_de_terrain	Responsable de l’ingénierie de terrain
Responsable_de_l’ingénierie_électrique	Responsable de l’ingénierie électrique
Responsable_de_l’édition	Responsable de l’édition
Responsable_de_marché_de_détail	Responsable de marché de détail
Responsable_de_nuit	Responsable de nuit
Responsable_de_pharmacie	Responsable de pharmacie
Responsable_de_production_régional	Responsable de production régional
Responsable_de_production_éditoriale	Responsable de production éditoriale
Responsable_de_programme_environnemental	Responsable de programme environnemental
Responsable_de_projet	Responsable de projet
Responsable_de_projet_créatif	Responsable de projet créatif
Responsable_de_projet_de_recrutement	Responsable de projet de recrutement
Responsable_de_projet_environnemental	Responsable de projet environnemental
Responsable_de_projet_éditorial	Responsable de projet éditorial
Responsable_de_restaurant	Responsable de restaurant
Responsable_de_réceptions	Responsable de réceptions
Responsable_de_spectacle	Responsable de spectacle
Responsable_de_succursale	Responsable de succursale
Responsable_des_achats_internationaux	Responsable des achats internationaux
Responsable_des_bourses	Responsable des bourses
Responsable_des_communications	Responsable des communications
Responsable_des_communications_externes	Responsable des communications externes
Responsable_des_communications_internes	Responsable des communications internes
Responsable_des_comptes_Publicité	Responsable des comptes Publicité
Responsable_des_comptes_marché_intermédiaire	Responsable des comptes marché intermédiaire
Responsable_des_comptes_numériques	Responsable des comptes numériques
Responsable_des_crédits	Responsable des crédits
Responsable_des_dons_annuels	Responsable des dons annuels
Responsable_des_dons_individuels	Responsable des dons individuels
Responsable_des_dons_majeurs	Responsable des dons majeurs
Responsable_des_exportations	Responsable des exportations
Responsable_des_exportations_régionales	Responsable des exportations régionales
Responsable_des_expéditions	Responsable des expéditions
Responsable_des_grands_comptes	Responsable des grands comptes
Responsable_des_médias	Responsable des médias
Responsable_des_médias_interactifs	Responsable des médias interactifs
Responsable_des_médias_numériques	Responsable des médias numériques
Responsable_des_opérations_au_sol	Responsable des opérations au sol
Responsable_des_opérations_aéroportuaires	Responsable des opérations aéroportuaires
Responsable_des_opérations_de_recrutement	Responsable des opérations de recrutement
Responsable_des_opérations_de_réseau	Responsable des opérations de réseau
Responsable_des_opérations_d’investissement	Responsable des opérations d’investissement
Responsable_des_opérations_et_de_la_logistique	Responsable des opérations et de la logistique
Responsable_des_opérations_maritimes	Responsable des opérations maritimes
Responsable_des_petites_annonces	Responsable des petites annonces
Responsable_des_processus	Responsable des processus
Responsable_des_produits_sans_fil	Responsable des produits sans fil
Responsable_des_programmes	Responsable des programmes
Responsable_des_prêts	Responsable des prêts
Responsable_des_publications	Responsable des publications
Responsable_des_recettes_régionales	Responsable des recettes régionales
Responsable_des_relations	Responsable des relations
Responsable_des_relations_avec_les_anciens_élèves	Responsable des relations avec les anciens élèves
Responsable_des_relations_avec_les_clients_Banque_privée	Responsable des relations avec les clients Banque privée
Responsable_des_relations_avec_les_invités	Responsable des relations avec les invités
Responsable_des_relations_clients	Responsable des relations clients
Responsable_des_relations_publiques	Responsable des relations publiques
Responsable_des_relations_publiques_et_presse	Responsable des relations publiques et presse
Responsable_des_relations_publiques_internationales	Responsable des relations publiques internationales
Responsable_des_réceptions	Responsable des réceptions
Responsable_des_services_aux_invités	Responsable des services aux invités
Responsable_des_services_créatifs	Responsable des services créatifs
Responsable_des_services_de_conférence	Responsable des services de conférence
Responsable_des_services_de_restauration	Responsable des services de restauration
Responsable_des_services_de_transport	Responsable des services de transport
Responsable_des_titres	Responsable des titres
Responsable_des_transports_régionaux	Responsable des transports régionaux
Responsable_des_tâches_administratives_/_de_l’entretien_domestique	Responsable des tâches administratives / de l’entretien domestique
Responsable_des_ventes_communautaires	Responsable des ventes communautaires
Responsable_des_ventes_interactives	Responsable des ventes interactives
Responsable_des_ventes_numériques	Responsable des ventes numériques
Responsable_des_voyages	Responsable des voyages
Responsable_des_voyages_monde	Responsable des voyages monde
Responsable_du_département_Conception	Responsable du département Conception
Responsable_du_département_électricité	Responsable du département électricité
Responsable_du_développement_commercial	Responsable du développement commercial
Responsable_du_développement_d’itinéraires	Responsable du développement d’itinéraires
Responsable_du_développement_économique	Responsable du développement économique
Responsable_du_front_desk	Responsable du front desk
Responsable_du_graphisme	Responsable du graphisme
Responsable_du_marketing_d’acquisition	Responsable du marketing d’acquisition
Responsable_du_marketing_secondaire	Responsable du marketing secondaire
Responsable_du_personnel_d’entretien	Responsable du personnel d’entretien
Responsable_du_plaidoyer	Responsable du plaidoyer
Responsable_du_rayon_Fleurs	Responsable du rayon Fleurs
Responsable_du_recrutement	Responsable du recrutement
Responsable_du_recrutement_Compte	Responsable du recrutement Compte
Responsable_du_recrutement_régional	Responsable du recrutement régional
Responsable_du_recrutement_technique	Responsable du recrutement technique
Responsable_du_terminal	Responsable du terminal
Responsable_en_acquisition_de_talents	Responsable en acquisition de talents
Responsable_en_chef_des_souscriptions	Responsable en chef des souscriptions
Responsable_en_marketing_sur_les_médias_sociaux	Responsable en marketing sur les médias sociaux
Responsable_frontend	Responsable frontend
Responsable_général	Responsable général
Responsable_général_de_restaurant	Responsable général de restaurant
Responsable_immobilier_résidentiel	Responsable immobilier résidentiel
Responsable_juridique_adjoint	Responsable juridique adjoint
Responsable_marketing_de_contenu	Responsable marketing de contenu
Responsable_marketing_numérique	Responsable marketing numérique
Responsable_mondial_du_développement_commercial	Responsable mondial du développement commercial
Responsable_nutritionnel	Responsable nutritionnel
Responsable_opérationnel_de_navire	Responsable opérationnel de navire
Responsable_principal_de_politique	Responsable principal de politique
Responsable_principal_des_risques	Responsable principal des risques
Responsable_principal_du_développement_commercial	Responsable principal du développement commercial
Responsable_régional_de_l’immobilier	Responsable régional de l’immobilier
Responsable_réseau_de_base	Responsable réseau de base
Responsable_réseaux	Responsable réseaux
Responsable_technique	Responsable technique
Responsable_éditorial	Responsable éditorial
Responsables_des_collections_spécifiques	Responsables des collections spécifiques
Retoucheur	Retoucheur
Rigger_de_personnage	Rigger de personnage
Réalisateur	Réalisateur
Réalisateur_de_documentaire	Réalisateur de documentaire
Réalisateur_de_télévision	Réalisateur de télévision
Réalisateur_d’animation	Réalisateur d’animation
Rédacteur_adjoint	Rédacteur adjoint
Rédacteur_commercial	Rédacteur commercial
Rédacteur_de_contenus	Rédacteur de contenus
Rédacteur_de_contenus_web	Rédacteur de contenus web
Rédacteur_de_scénario	Rédacteur de scénario
Rédacteur_de_voyage	Rédacteur de voyage
Rédacteur_d’articles	Rédacteur d’articles
Rédacteur_en_chef	Rédacteur en chef
Rédacteur_en_chef_Voyages	Rédacteur en chef Voyages
Rédacteur_en_chef_adjoint	Rédacteur en chef adjoint
Rédacteur_en_chef_consultant	Rédacteur en chef consultant
Rédacteur_en_chef_de_la_rubrique_Lifestyle	Rédacteur en chef de la rubrique Lifestyle
Rédacteur_en_chef_de_projet	Rédacteur en chef de projet
Rédacteur_en_chef_général	Rédacteur en chef général
Rédacteur_en_chef_juridique	Rédacteur en chef juridique
Rédacteur_financier	Rédacteur financier
Rédacteur_marketing	Rédacteur marketing
Rédacteur_municipal	Rédacteur municipal
Rédacteur_métro	Rédacteur métro
Rédacteur_publicitaire	Rédacteur publicitaire
Rédacteur_publicitaire_créatif	Rédacteur publicitaire créatif
Rédacteur_sportif	Rédacteur sportif
Rédacteur_web	Rédacteur web
Rédacteur_éditorial	Rédacteur éditorial
Régisseur_adjoint_de_plateau_extérieur	Régisseur adjoint de plateau extérieur
Régisseur_d’extérieur	Régisseur d’extérieur
Répartiteur_d’urgences	Répartiteur d’urgences
Résident	Résident
Résident_en_chef	Résident en chef
Résident_en_pharmacie	Résident en pharmacie
Sauveteur	Sauveteur
Scientifique_alimentaire	Scientifique alimentaire
Scientifique_environnemental	Scientifique environnemental
Scientifique_spécialiste_en_recherche_&_développement	Scientifique spécialiste en recherche & développement
Sculpteur	Sculpteur
Second_assistant	Second assistant
Secrétaire_adjoint	Secrétaire adjoint
Secrétaire_adjoint_d’entreprise	Secrétaire adjoint d’entreprise
Secrétaire_de_production	Secrétaire de production
Secrétaire_exécutif_bilingue	Secrétaire exécutif bilingue
Secrétaire_juridique	Secrétaire juridique
Secrétaire_juridique_et_d’entreprise_en_chef	Secrétaire juridique et d’entreprise en chef
Secrétaire_juridique_exécutif	Secrétaire juridique exécutif
Secrétaire_scolaire	Secrétaire scolaire
Sergent	Sergent
Sergent_de_patrouille	Sergent de patrouille
Sergent_de_police	Sergent de police
Serveur	Serveur
Serveur_de_banquet	Serveur de banquet
Serveur_de_cocktails	Serveur de cocktails
Serveur_de_restaurant	Serveur de restaurant
Serveur_en_chef	Serveur en chef
Serveur_en_restauration	Serveur en restauration
Serveuse_de_cocktails	Serveuse de cocktails
Service_caisse_et_clientèle	Service caisse et clientèle
Services_destinés_aux_clients_privés	Services destinés aux clients privés
Sheriff	Sheriff
Sheriff_adjoint	Sheriff adjoint
Société_de_logiciels	Société de logiciels
Soldat	Soldat
Sourceur	Sourceur
Sous-chef	Sous-chef
Sous-chef_exécutif	Sous-chef exécutif
Sous-traitant	Sous-traitant
Souscripteur_de_lignes_personnelles	Souscripteur de lignes personnelles
Souscripteur_de_terrain	Souscripteur de terrain
Souscripteur_d’assurances	Souscripteur d’assurances
Souscripteur_en_assurance_vie	Souscripteur en assurance vie
Souscripteur_en_production	Souscripteur en production
Souscripteur_en_prêt_à_la_consommation	Souscripteur en prêt à la consommation
Souscripteur_hypothécaire	Souscripteur hypothécaire
Soutien_informatique	Soutien informatique
Spécialiste_IT	Spécialiste IT
Spécialiste_Marketing_&_Relations_publiques	Spécialiste Marketing & Relations publiques
Spécialiste_Santé_&_Fitness	Spécialiste Santé & Fitness
Spécialiste_académique	Spécialiste académique
Spécialiste_de_la_banque_d’entreprise	Spécialiste de la banque d’entreprise
Spécialiste_de_la_dotation_en_personnel	Spécialiste de la dotation en personnel
Spécialiste_de_la_dotation_en_ressources	Spécialiste de la dotation en ressources
Spécialiste_de_la_lecture	Spécialiste de la lecture
Spécialiste_de_la_localisation	Spécialiste de la localisation
Spécialiste_de_la_planification_hypothécaire_certifié	Spécialiste de la planification hypothécaire certifié
Spécialiste_de_la_production_média	Spécialiste de la production média
Spécialiste_de_la_production_vidéo	Spécialiste de la production vidéo
Spécialiste_de_la_protection_environnementale	Spécialiste de la protection environnementale
Spécialiste_de_la_relocalisation	Spécialiste de la relocalisation
Spécialiste_de_l’acquisition_des_talents	Spécialiste de l’acquisition des talents
Spécialiste_de_l’alphabétisation	Spécialiste de l’alphabétisation
Spécialiste_de_l’automatisation	Spécialiste de l’automatisation
Spécialiste_de_l’instruction	Spécialiste de l’instruction
Spécialiste_de_l’évènementiel	Spécialiste de l’évènementiel
Spécialiste_de_terrain_d’agence	Spécialiste de terrain d’agence
Spécialiste_des_applications_Web	Spécialiste des applications Web
Spécialiste_des_bibliothèques_médias	Spécialiste des bibliothèques médias
Spécialiste_des_bibliothèques_médias_scolaires	Spécialiste des bibliothèques médias scolaires
Spécialiste_des_biens	Spécialiste des biens
Spécialiste_des_couleurs	Spécialiste des couleurs
Spécialiste_des_dérivés	Spécialiste des dérivés
Spécialiste_des_entrepôts	Spécialiste des entrepôts
Spécialiste_des_exportations	Spécialiste des exportations
Spécialiste_des_faillites	Spécialiste des faillites
Spécialiste_des_fonds_mutuels	Spécialiste des fonds mutuels
Spécialiste_des_importations	Spécialiste des importations
Spécialiste_des_litiges	Spécialiste des litiges
Spécialiste_des_microordinateurs	Spécialiste des microordinateurs
Spécialiste_des_médias_sociaux	Spécialiste des médias sociaux
Spécialiste_des_processus	Spécialiste des processus
Spécialiste_des_prêts	Spécialiste des prêts
Spécialiste_des_prêts_au_logement	Spécialiste des prêts au logement
Spécialiste_des_prêts_hypothécaires	Spécialiste des prêts hypothécaires
Spécialiste_des_relations_publiques	Spécialiste des relations publiques
Spécialiste_des_revenus_fixes	Spécialiste des revenus fixes
Spécialiste_des_réseaux_informatiques	Spécialiste des réseaux informatiques
Spécialiste_des_saisies	Spécialiste des saisies
Spécialiste_des_tests_d’automatisation	Spécialiste des tests d’automatisation
Spécialiste_du_networking	Spécialiste du networking
Spécialiste_du_recrutement_RH	Spécialiste du recrutement RH
Spécialiste_du_réseau_de_données	Spécialiste du réseau de données
Spécialiste_du_trading	Spécialiste du trading
Spécialiste_du_voyage	Spécialiste du voyage
Spécialiste_en_actions_/_capitaux_propres	Spécialiste en actions / capitaux propres
Spécialiste_en_applications_cliniques	Spécialiste en applications cliniques
Spécialiste_en_appui_aux_services	Spécialiste en appui aux services
Spécialiste_en_art	Spécialiste en art
Spécialiste_en_assistance_aux_utilisateurs	Spécialiste en assistance aux utilisateurs
Spécialiste_en_assistance_informatique	Spécialiste en assistance informatique
Spécialiste_en_assistance_régionale	Spécialiste en assistance régionale
Spécialiste_en_assistance_à_la_clientèle	Spécialiste en assistance à la clientèle
Spécialiste_en_assurances	Spécialiste en assurances
Spécialiste_en_clôture	Spécialiste en clôture
Spécialiste_en_commerce_international	Spécialiste en commerce international
Spécialiste_en_communications	Spécialiste en communications
Spécialiste_en_communications_Web	Spécialiste en communications Web
Spécialiste_en_communications_marketing	Spécialiste en communications marketing
Spécialiste_en_crédit	Spécialiste en crédit
Spécialiste_en_développement_commercial	Spécialiste en développement commercial
Spécialiste_en_emploi	Spécialiste en emploi
Spécialiste_en_enquêtes	Spécialiste en enquêtes
Spécialiste_en_fitness	Spécialiste en fitness
Spécialiste_en_gestion_des_talents	Spécialiste en gestion des talents
Spécialiste_en_home_cinéma	Spécialiste en home cinéma
Spécialiste_en_immobilier	Spécialiste en immobilier
Spécialiste_en_immobilier_commercial	Spécialiste en immobilier commercial
Spécialiste_en_ingénierie_des_processus	Spécialiste en ingénierie des processus
Spécialiste_en_investissement	Spécialiste en investissement
Spécialiste_en_logiciels	Spécialiste en logiciels
Spécialiste_en_matériel	Spécialiste en matériel
Spécialiste_en_nouvelles_entreprises	Spécialiste en nouvelles entreprises
Spécialiste_en_pharmacie_clinique	Spécialiste en pharmacie clinique
Spécialiste_en_photo	Spécialiste en photo
Spécialiste_en_propriété_intellectuelle	Spécialiste en propriété intellectuelle
Spécialiste_en_publicité	Spécialiste en publicité
Spécialiste_en_recrutement	Spécialiste en recrutement
Spécialiste_en_règlements	Spécialiste en règlements
Spécialiste_en_sans_fil	Spécialiste en sans fil
Spécialiste_en_systèmes_de_contrôle	Spécialiste en systèmes de contrôle
Spécialiste_en_sécurité_des_réseaux	Spécialiste en sécurité des réseaux
Spécialiste_en_télécommunications	Spécialiste en télécommunications
Spécialiste_en_ventes_consultatives	Spécialiste en ventes consultatives
Spécialiste_en_électronique	Spécialiste en électronique
Spécialiste_fiscal	Spécialiste fiscal
Spécialiste_graphique	Spécialiste graphique
Spécialiste_informatique_personnel	Spécialiste informatique personnel
Spécialiste_juridique	Spécialiste juridique
Spécialiste_mécanique	Spécialiste mécanique
Spécialiste_opérationnel	Spécialiste opérationnel
Spécialiste_politique	Spécialiste politique
Spécialiste_service_clientèle	Spécialiste service clientèle
Spécialiste_technique_régional	Spécialiste technique régional
Spécialiste_visuel	Spécialiste visuel
Stagiaire	Stagiaire
Stagiaire_Alimentation_et_boissons	Stagiaire Alimentation et boissons
Stagiaire_Conception_&_Production	Stagiaire Conception & Production
Stagiaire_au_département_juridique	Stagiaire au département juridique
Stagiaire_au_front_office	Stagiaire au front office
Stagiaire_aux_admissions	Stagiaire aux admissions
Stagiaire_dans_la_construction	Stagiaire dans la construction
Stagiaire_dans_les_services_créatifs	Stagiaire dans les services créatifs
Stagiaire_de_programme_universitaire	Stagiaire de programme universitaire
Stagiaire_du_développement_web	Stagiaire du développement web
Stagiaire_en_acquisition_de_talents	Stagiaire en acquisition de talents
Stagiaire_en_animation	Stagiaire en animation
Stagiaire_en_appui_informatique	Stagiaire en appui informatique
Stagiaire_en_architecture_du_paysage	Stagiaire en architecture du paysage
Stagiaire_en_banque_d’investissement	Stagiaire en banque d’investissement
Stagiaire_en_capital_privé	Stagiaire en capital privé
Stagiaire_en_cardiologie	Stagiaire en cardiologie
Stagiaire_en_conception	Stagiaire en conception
Stagiaire_en_création	Stagiaire en création
Stagiaire_en_création_de_mode	Stagiaire en création de mode
Stagiaire_en_direction_artistique	Stagiaire en direction artistique
Stagiaire_en_développement_de_logiciel	Stagiaire en développement de logiciel
Stagiaire_en_finance_d’entreprise	Stagiaire en finance d’entreprise
Stagiaire_en_gestion_des_risques	Stagiaire en gestion des risques
Stagiaire_en_graphisme	Stagiaire en graphisme
Stagiaire_en_ingénierie_de_conception	Stagiaire en ingénierie de conception
Stagiaire_en_ingénierie_des_systèmes	Stagiaire en ingénierie des systèmes
Stagiaire_en_ingénierie_logicielle	Stagiaire en ingénierie logicielle
Stagiaire_en_ingénierie_mécanique	Stagiaire en ingénierie mécanique
Stagiaire_en_logiciel	Stagiaire en logiciel
Stagiaire_en_musique	Stagiaire en musique
Stagiaire_en_post-production	Stagiaire en post-production
Stagiaire_en_programme_de_gestion_financière	Stagiaire en programme de gestion financière
Stagiaire_en_présentation_visuelle_des_marchandises	Stagiaire en présentation visuelle des marchandises
Stagiaire_en_recherche_d’actions	Stagiaire en recherche d’actions
Stagiaire_en_recouvrement	Stagiaire en recouvrement
Stagiaire_en_sports	Stagiaire en sports
Stagiaire_juridique_certifié	Stagiaire juridique certifié
Stagiaire_multimédia	Stagiaire multimédia
Stagiaire_médical	Stagiaire médical
Stagiaires_aux_archives	Stagiaires aux archives
Standardiste	Standardiste
Steward	Steward
Steward_en_chef	Steward en chef
Stratège_d’investissement	Stratège d’investissement
Stratège_médiatique	Stratège médiatique
Stratégiste_actions	Stratégiste actions
Stratégiste_de_contenus	Stratégiste de contenus
Stratégiste_des_comptes	Stratégiste des comptes
Stratégiste_en_médias_sociaux	Stratégiste en médias sociaux
Stratégiste_marketing	Stratégiste marketing
Stratégiste_produits	Stratégiste produits
Styliste	Styliste
Styliste_mode	Styliste mode
Styliste_photo	Styliste photo
Superviseur_Copy_du_groupe	Superviseur Copy du groupe
Superviseur_Marketing_commercial	Superviseur Marketing commercial
Superviseur_artistique_du_groupe	Superviseur artistique du groupe
Superviseur_civil	Superviseur civil
Superviseur_clinique	Superviseur clinique
Superviseur_commercial	Superviseur commercial
Superviseur_de_centre_de_données	Superviseur de centre de données
Superviseur_de_cuisine	Superviseur de cuisine
Superviseur_de_la_mise_en_œuvre_/_de_l’implémentation	Superviseur de la mise en œuvre / de l’implémentation
Superviseur_de_la_post-production	Superviseur de la post-production
Superviseur_de_la_publicité	Superviseur de la publicité
Superviseur_de_l’accueil	Superviseur de l’accueil
Superviseur_de_l’animation	Superviseur de l’animation
Superviseur_de_l’entretien_domestique	Superviseur de l’entretien domestique
Superviseur_de_l’ingénierie_des_produits	Superviseur de l’ingénierie des produits
Superviseur_de_rédaction	Superviseur de rédaction
Superviseur_des_clôtures	Superviseur des clôtures
Superviseur_des_comptes	Superviseur des comptes
Superviseur_des_contenus	Superviseur des contenus
Superviseur_des_crédits	Superviseur des crédits
Superviseur_des_infrastructures	Superviseur des infrastructures
Superviseur_des_réceptions	Superviseur des réceptions
Superviseur_des_salaires	Superviseur des salaires
Superviseur_des_scripts	Superviseur des scripts
Superviseur_du_centre_de_distribution	Superviseur du centre de distribution
Superviseur_du_contrôle_de_l’inventaire	Superviseur du contrôle de l’inventaire
Superviseur_du_forage	Superviseur du forage
Superviseur_du_grand_livre	Superviseur du grand livre
Superviseur_du_graphisme	Superviseur du graphisme
Superviseur_en_planification_médiatique	Superviseur en planification médiatique
Superviseur_fiscal	Superviseur fiscal
Superviseur_médias	Superviseur médias
Superviseur_numérique	Superviseur numérique
Superviseur_éditorial	Superviseur éditorial
Supporter	Supporter
Technicien	Technicien
Technicien_anesthésiste	Technicien anesthésiste
Technicien_au_services_des_autorisations	Technicien au services des autorisations
Technicien_avionique	Technicien avionique
Technicien_certifié_en_pharmacie	Technicien certifié en pharmacie
Technicien_chargé_de_l’archivage	Technicien chargé de l’archivage
Technicien_chargé_de_l’assistance	Technicien chargé de l’assistance
Technicien_chargé_du_support_IT	Technicien chargé du support IT
Technicien_chargé_du_support_aux_utilisateurs	Technicien chargé du support aux utilisateurs
Technicien_chargé_du_support_de_station_de_travail	Technicien chargé du support de station de travail
Technicien_chargé_du_support_informatique	Technicien chargé du support informatique
Technicien_chargé_du_support_logiciel	Technicien chargé du support logiciel
Technicien_chargé_du_support_produits	Technicien chargé du support produits
Technicien_chargé_du_support_réseau	Technicien chargé du support réseau
Technicien_chargé_du_support_sur_le_terrain	Technicien chargé du support sur le terrain
Technicien_chargé_du_support_systèmes	Technicien chargé du support systèmes
Technicien_chargé_du_support_technologique	Technicien chargé du support technologique
Technicien_chargé_du_support_à_la_clientèle	Technicien chargé du support à la clientèle
Technicien_de_diffusion	Technicien de diffusion
Technicien_de_laboratoire_informatique	Technicien de laboratoire informatique
Technicien_de_laboratoire_photo	Technicien de laboratoire photo
Technicien_de_maintenance	Technicien de maintenance
Technicien_de_maintenance_de_l’équipement	Technicien de maintenance de l’équipement
Technicien_de_réseaux	Technicien de réseaux
Technicien_de_réseaux_informatiques	Technicien de réseaux informatiques
Technicien_de_service_d’assistance	Technicien de service d’assistance
Technicien_de_service_informatique	Technicien de service informatique
Technicien_de_sol	Technicien de sol
Technicien_des_opérations_de_terrain	Technicien des opérations de terrain
Technicien_dessinateur	Technicien dessinateur
Technicien_du_contrôle_des_réseaux	Technicien du contrôle des réseaux
Technicien_du_département_des_urgences	Technicien du département des urgences
Technicien_du_service_d’assistance	Technicien du service d’assistance
Technicien_du_support_clientèle	Technicien du support clientèle
Technicien_d’essais_électroniques	Technicien d’essais électroniques
Technicien_d’ingénierie_civile	Technicien d’ingénierie civile
Technicien_en_Support_aux_applications	Technicien en Support aux applications
Technicien_en_appui	Technicien en appui
Technicien_en_automatisation	Technicien en automatisation
Technicien_en_communications	Technicien en communications
Technicien_en_configuration	Technicien en configuration
Technicien_en_déploiement	Technicien en déploiement
Technicien_en_imagerie_numérique	Technicien en imagerie numérique
Technicien_en_ingénierie_mécanique	Technicien en ingénierie mécanique
Technicien_en_matériel	Technicien en matériel
Technicien_en_matériel_informatique	Technicien en matériel informatique
Technicien_en_radiologie	Technicien en radiologie
Technicien_en_réparation	Technicien en réparation
Technicien_en_réparation_d’ordinateurs_personnels	Technicien en réparation d’ordinateurs personnels
Technicien_en_santé_comportementale	Technicien en santé comportementale
Technicien_en_soin_des_animaux	Technicien en soin des animaux
Technicien_en_systèmes_informatiques	Technicien en systèmes informatiques
Technicien_en_télécommunications	Technicien en télécommunications
Technicien_en_équipement_biomédical	Technicien en équipement biomédical
Technicien_environnemental	Technicien environnemental
Technicien_fiscal	Technicien fiscal
Technicien_graphique	Technicien graphique
Technicien_géologue	Technicien géologue
Technicien_informatique	Technicien informatique
Technicien_informatique_de_terrain	Technicien informatique de terrain
Technicien_informatique_personnel	Technicien informatique personnel
Technicien_média	Technicien média
Technicien_médical_pour_les_urgences	Technicien médical pour les urgences
Technicien_photo	Technicien photo
Technicien_piano	Technicien piano
Technicien_sans_fil	Technicien sans fil
Technicien_sur_site	Technicien sur site
Technicien_vétérinaire	Technicien vétérinaire
Technicien_vétérinaire_diplômé	Technicien vétérinaire diplômé
Technologie	Technologie
Technologue_Produits	Technologue Produits
Technologue_de_l’assurance_qualité	Technologue de l’assurance qualité
Technologue_des_applications	Technologue des applications
Technologue_des_processus	Technologue des processus
Technologue_employé	Technologue employé
Technologue_en_développement	Technologue en développement
Technologue_en_développement_de_produits	Technologue en développement de produits
Technologue_en_médecine_nucléaire	Technologue en médecine nucléaire
Technologue_en_radiologie	Technologue en radiologie
Technologue_en_recherche_&_développement	Technologue en recherche & développement
Technologue_en_échographie	Technologue en échographie
Technologue_vasculaire	Technologue vasculaire
Testeur_d’applications	Testeur d’applications
Textureur	Textureur
Thérapeute	Thérapeute
Thérapeute_clinique	Thérapeute clinique
Thérapeute_conjugal_et_familial	Thérapeute conjugal et familial
Thérapeute_conjugal_et_familial_diplômé	Thérapeute conjugal et familial diplômé
Thérapeute_scolaire	Thérapeute scolaire
Thérapeute_éducateur	Thérapeute éducateur
Title_1_Teacher	Title 1 Teacher
Trader	Trader
Trader_en_actions_pour_compte_propre	Trader en actions pour compte propre
Traducteur_anglais	Traducteur anglais
Traducteur_espagnol	Traducteur espagnol
Traducteur_interne	Traducteur interne
Traducteur_japonaise	Traducteur japonaise
Traducteur_technique	Traducteur technique
Traiteur	Traiteur
Traiteur_/_Directeur_de_banquet	Traiteur / Directeur de banquet
Travailleur_dans_le_domaine_du_soutien_aux_familles	Travailleur dans le domaine du soutien aux familles
Travailleur_des_services_de_restauration	Travailleur des services de restauration
Travailleur_social	Travailleur social
Travailleur_social_clinique	Travailleur social clinique
Travailleur_social_clinique_agréé	Travailleur social clinique agréé
Trieur	Trieur
Tuteur_en_alphabétisation	Tuteur en alphabétisation
Tuteur_en_lecture	Tuteur en lecture
VP	VP
VP_Alimentation_et_boissons	VP Alimentation et boissons
VP_Stratégie	VP Stratégie
VP_adjoint	VP adjoint
VP_adjoint_des_souscriptions	VP adjoint des souscriptions
VP_adjoint_du_développement_commercial	VP adjoint du développement commercial
VP_de_la_gestion_de_talents	VP de la gestion de talents
VP_de_la_gestion_des_actifs	VP de la gestion des actifs
VP_de_l’acquisition_de_talents	VP de l’acquisition de talents
VP_de_l’exploration	VP de l’exploration
VP_des_RH_mondiales	VP des RH mondiales
VP_des_Ventes_de_titres_institutionnels	VP des Ventes de titres institutionnels
VP_des_initiatives_stratégiques	VP des initiatives stratégiques
VP_des_opérations_commerciales	VP des opérations commerciales
VP_des_prêts_hypothécaires	VP des prêts hypothécaires
VP_des_prêts_résidentiels	VP des prêts résidentiels
VP_des_relations_externes	VP des relations externes
VP_des_services_créatifs	VP des services créatifs
VP_des_ventes_institutionnelles	VP des ventes institutionnelles
VP_du_développement_commercial	VP du développement commercial
VP_du_développement_organisationnel	VP du développement organisationnel
VP_du_recrutement	VP du recrutement
VP_exécutif	VP exécutif
VP_exécutif_adjoint_des_comptes	VP exécutif adjoint des comptes
VP_exécutif_du_développement_commercial	VP exécutif du développement commercial
Vendeur	Vendeur
Vendeur_au_détail	Vendeur au détail
Vente_d’actions	Vente d’actions
Ventes_de_produits_dérivés_sur_actions	Ventes de produits dérivés sur actions
Vice-chancelier	Vice-chancelier
Vice-ministre	Vice-ministre
Vice-président_du_comité_de_direction	Vice-président du comité de direction
Vidéaste	Vidéaste
Vidéo-journaliste	Vidéo-journaliste
Vidéographe	Vidéographe
Visiteur_de_santé	Visiteur de santé
Visualiseur	Visualiseur
Web_Designer	Web Designer
Webmaster_d’entreprise	Webmaster d’entreprise
Éditeur	Éditeur
Éditeur_/_Rédacteur_en_chef	Éditeur / Rédacteur en chef
Éditeur_Web	Éditeur Web
Éditeur_du_groupe	Éditeur du groupe
Éditeur_photo	Éditeur photo
Éducateur	Éducateur
Éducateur_des_jeunes_enfants	Éducateur des jeunes enfants
Éducateur_pour_les_jeunes_enfants	Éducateur pour les jeunes enfants
Éleveur	Éleveur
Étudiant_bénévole	Étudiant bénévole
Étudiant_diplômé_d’un_MBA	Étudiant diplômé d’un MBA
Étudiant_diplômé_qui_donne_des_cours	Étudiant diplômé qui donne des cours
Étudiant_en_architecture	Étudiant en architecture
Étudiant_en_graphisme	Étudiant en graphisme
Étudiant_en_infirmerie	Étudiant en infirmerie
Étudiant_en_ingénierie_mécanique	Étudiant en ingénierie mécanique
Étudiant_en_science_informatique	Étudiant en science informatique
Étudiant_journaliste	Étudiant journaliste
Évaluateur_agréé_de_biens_immobiliers	Évaluateur agréé de biens immobiliers
Évaluateur_de_projet	Évaluateur de projet
Évaluateur_immobilier_certifié	Évaluateur immobilier certifié
