3D-Charakter-Animator	3D-Charakter-Animator
3D-Generalist	3D-Generalist
3D-Künstler	3D-Künstler
3D-Modellierer	3D-Modellierer
3D-Umwelt-Künstler	3D-Umwelt-Künstler
Abschluss-Supervisor	Abschluss-Supervisor
Abschlussexperte	Abschlussexperte
Absender_des_Hypothekendarlehens	Absender des Hypothekendarlehens
Abteilung_Import	Abteilung Import
Account_Executive	Account Executive
Account_Recruiting_Manager	Account Recruiting Manager
Administrator_für_Informationssicherheit	Administrator für Informationssicherheit
Administrator_für_lokales_Netzwerk	Administrator für lokales Netzwerk
Advocacy-Beauftragter	Advocacy-Beauftragter
Aerodynamiktechniker	Aerodynamiktechniker
Affiliate-Broker	Affiliate-Broker
Agent_für_Reservierungen	Agent für Reservierungen
Agent_kommerziell	Agent kommerziell
Agentur_Außenstelle_Exekutive	Agentur Außenstelle Exekutive
Agentur-Außendienst-Experte	Agentur-Außendienst-Experte
Agentur-Rekrutierer	Agentur-Rekrutierer
Akademischer_Programm-Koordinator	Akademischer Programm-Koordinator
Akademischer_Spezialist	Akademischer Spezialist
Aktien-Analyst	Aktien-Analyst
Aktien-Gesellschafter	Aktien-Gesellschafter
Aktien-Portfolio-Manager	Aktien-Portfolio-Manager
Aktien-Research-Analyst	Aktien-Research-Analyst
Aktien-Stratege	Aktien-Stratege
Aktienexperte	Aktienexperte
Aktienhändler	Aktienhändler
Aktienoptionen-Händler	Aktienoptionen-Händler
Aktienverkäufe	Aktienverkäufe
Aktionär	Aktionär
Allgemeiner_Außendiensttechniker	Allgemeiner Außendiensttechniker
Allgemeiner_Zahnarzt	Allgemeiner Zahnarzt
Allgemeinmediziner	Allgemeinmediziner
Alphabetisierungs-Coach	Alphabetisierungs-Coach
Alphabetisierungstutor	Alphabetisierungstutor
Alumni_Relations_Manager	Alumni Relations Manager
Alumni-Beauftragter	Alumni-Beauftragter
Analog-Designer	Analog-Designer
Analyst_der_Netzbetriebszentrale	Analyst der Netzbetriebszentrale
Analyst_des_Supportzentrums	Analyst des Supportzentrums
Analyst_für_Anlageperformance	Analyst für Anlageperformance
Analyst_für_Automatisierungstests	Analyst für Automatisierungstests
Analyst_für_Computerunterstützung	Analyst für Computerunterstützung
Analyst_für_Import_und_Export	Analyst für Import und Export
Analyst_für_Informationssicherheit	Analyst für Informationssicherheit
Analyst_für_Investmentfonds	Analyst für Investmentfonds
Analyst_für_Kreditforschung	Analyst für Kreditforschung
Analyst_für_Kundenbetreuung	Analyst für Kundenbetreuung
Analyst_für_Marktinformationen	Analyst für Marktinformationen
Analyst_für_Netzwerkbetrieb	Analyst für Netzwerkbetrieb
Analyst_für_Netzwerksicherheit	Analyst für Netzwerksicherheit
Analyst_für_Portfoliomanagement	Analyst für Portfoliomanagement
Analyst_für_Rekrutierung	Analyst für Rekrutierung
Analyst_für_Software-Entwicklung	Analyst für Software-Entwicklung
Analyst_für_Software-Unterstützung	Analyst für Software-Unterstützung
Analyst_für_Technologie-Unterstützung	Analyst für Technologie-Unterstützung
Analyst_für_Unternehmensentwicklung	Analyst für Unternehmensentwicklung
Analyst_für_Unternehmensfinanzierung	Analyst für Unternehmensfinanzierung
Analyst_für_Unternehmenskredite	Analyst für Unternehmenskredite
Analyst_für_das_Firmenkundengeschäft	Analyst für das Firmenkundengeschäft
Analyst_für_festverzinsliche_Wertpapiere	Analyst für festverzinsliche Wertpapiere
Analyst_für_fremdfinanzierte_Finanzen	Analyst für fremdfinanzierte Finanzen
Analyst_für_strategische_Planung	Analyst für strategische Planung
Analyst_für_strukturierte_Finanzen	Analyst für strukturierte Finanzen
Analyst_für_technische_Unterstützung	Analyst für technische Unterstützung
Analyst_zur_Unterstützung_bei_Rechtsstreitigkeiten	Analyst zur Unterstützung bei Rechtsstreitigkeiten
Analytiker_importieren	Analytiker importieren
Anbieter_von_Kinderbetreuung	Anbieter von Kinderbetreuung
Android-Entwickler	Android-Entwickler
Angestellter_im_Lebensmittelgeschäft	Angestellter im Lebensmittelgeschäft
Anhörungsbeauftragter	Anhörungsbeauftragter
Animation_Führung	Animation Führung
Animation_Intern	Animation Intern
Animations-Betreuer	Animations-Betreuer
Animationskünstler	Animationskünstler
Animator	Animator
Anker	Anker
Anlagen-Verfahrenstechniker	Anlagen-Verfahrenstechniker
Anlagestratege	Anlagestratege
Anproberaum-Mitarbeiter	Anproberaum-Mitarbeiter
Ansager_der_öffentlichen_Ansprache	Ansager der öffentlichen Ansprache
Ansässige_Künstlerin	Ansässige Künstlerin
Antriebsstrangtechniker	Antriebsstrangtechniker
Antriebstechniker	Antriebstechniker
Anwalt_für_Ansprüche	Anwalt für Ansprüche
Anwalt_für_Arbeit_und_Beschäftigung	Anwalt für Arbeit und Beschäftigung
Anwalt_für_Familienrecht	Anwalt für Familienrecht
Anwalt_für_Forschung	Anwalt für Forschung
Anwalt_für_Gesellschaftsrecht	Anwalt für Gesellschaftsrecht
Anwalt_für_Immobilienrecht	Anwalt für Immobilienrecht
Anwalt_für_Rechtsstreitigkeiten	Anwalt für Rechtsstreitigkeiten
Anwalt_für_geistiges_Eigentum	Anwalt für geistiges Eigentum
Anwaltsassistent	Anwaltsassistent
Anwaltsgehilfe	Anwaltsgehilfe
Anwaltsvorstand	Anwaltsvorstand
Anwendungs-Supporttechniker	Anwendungs-Supporttechniker
Anwendungs-Tester	Anwendungs-Tester
Anwendungsentwickler	Anwendungsentwickler
Anwendungstechniker	Anwendungstechniker
Anwendungstechniker_für_Unternehmen	Anwendungstechniker für Unternehmen
Anwendungstechnologe	Anwendungstechnologe
Anwerber_für_Talentakquise	Anwerber für Talentakquise
Anwerber_für_das_Gesundheitswesen	Anwerber für das Gesundheitswesen
Anwesenheits-Sachbearbeiter	Anwesenheits-Sachbearbeiter
Anästhesietechniker	Anästhesietechniker
Anästhesiologie_Assistenzarzt	Anästhesiologie Assistenzarzt
Apothekenaufseher	Apothekenaufseher
Apothekerin_für_regulatorische_Angelegenheiten	Apothekerin für regulatorische Angelegenheiten
Aqua-Aerobic-Ausbilder	Aqua-Aerobic-Ausbilder
Arbeitsgesundheitsschwester	Arbeitsgesundheitsschwester
Architekt	Architekt
Architekt_für_Fortgeschrittene	Architekt für Fortgeschrittene
Architektonische_Mitarbeiterin	Architektonische Mitarbeiterin
Architektonischer_Assistent	Architektonischer Assistent
Architektonischer_Designer	Architektonischer Designer
Architektur-Student	Architektur-Student
Archiv_Intern	Archiv Intern
Archiv-Assistentin	Archiv-Assistentin
Archivierungstechniker	Archivierungstechniker
Aromatiker	Aromatiker
Art_Direction_Intern	Art Direction Intern
Artikelschreiber	Artikelschreiber
Artist_In_Residence	Artist In Residence
Arzt_für_Innere_Medizin	Arzt für Innere Medizin
Arzt_für_Notfallmedizin	Arzt für Notfallmedizin
Arzthelfer	Arzthelfer
Asset-Liability-Manager	Asset-Liability-Manager
Assistant_Brand_Manager	Assistant Brand Manager
Assistant_Manager_Rekrutierung	Assistant Manager Rekrutierung
Assistant_Manager_Unternehmenskommunikation	Assistant Manager Unternehmenskommunikation
Assistant_Revenue_Manager	Assistant Revenue Manager
Assistant_VP_Account_Executive	Assistant VP Account Executive
Assistant_VP_Underwriting	Assistant VP Underwriting
Assistent_Catering_Manager	Assistent Catering Manager
Assistent_Food_&_Beverage_Manager	Assistent Food & Beverage Manager
Assistent_Technischer_Designer	Assistent Technischer Designer
Assistent_VP	Assistent VP
Assistent_des_Archivars	Assistent des Archivars
Assistent_des_Bauleiters	Assistent des Bauleiters
Assistent_des_Frontend-Managers	Assistent des Frontend-Managers
Assistent_des_Konstrukteurs	Assistent des Konstrukteurs
Assistent_des_Küchenleiters	Assistent des Küchenleiters
Assistent_des_Leiters_des_Gästeservices	Assistent des Leiters des Gästeservices
Assistent_des_Privatbankiers	Assistent des Privatbankiers
Assistent_des_Produzenten	Assistent des Produzenten
Assistent_des_Reservierungsmanagers	Assistent des Reservierungsmanagers
Assistent_des_Unternehmensjuristen	Assistent des Unternehmensjuristen
Assistent_für_Rechtsstreitigkeiten	Assistent für Rechtsstreitigkeiten
Assistent_für_Veranstaltungsplanung	Assistent für Veranstaltungsplanung
Assistent_für_kommerzielle_Kredite	Assistent für kommerzielle Kredite
Assistentin_VP_Business_Development	Assistentin VP Business Development
Assistentin_der_Buchhaltung	Assistentin der Buchhaltung
Assistentin_der_Generalstaatsanwaltschaft	Assistentin der Generalstaatsanwaltschaft
Assistentin_des_Nachrichtendirektors	Assistentin des Nachrichtendirektors
Assistentin_des_Systemanalytikers	Assistentin des Systemanalytikers
Assistentin_des_Vorschullehrers	Assistentin des Vorschullehrers
Assistentin_für_Büroproduktion	Assistentin für Büroproduktion
Assistentin_für_Gemeindebeziehungen	Assistentin für Gemeindebeziehungen
Assistentin_für_Handelsmarketing	Assistentin für Handelsmarketing
Assistentin_für_Produktentwicklung	Assistentin für Produktentwicklung
Assistentin_für_Publikationen	Assistentin für Publikationen
Assistentin_für_Rekrutierung	Assistentin für Rekrutierung
Assistentin_für_Sonderpädagogik	Assistentin für Sonderpädagogik
Assistentin_für_Telekommunikation	Assistentin für Telekommunikation
Assistentin_im_Gesundheitswesen	Assistentin im Gesundheitswesen
Assistenz-Animator	Assistenz-Animator
Assistenz-Architekt	Assistenz-Architekt
Assistenz-Designer	Assistenz-Designer
Assistenz-Fotograf	Assistenz-Fotograf
Assistenz-Fußballtrainer	Assistenz-Fußballtrainer
Assistenz-Koch	Assistenz-Koch
Assistenzarzt	Assistenzarzt
Assistenzarzt_für_Innere_Medizin	Assistenzarzt für Innere Medizin
Assistenzarzt_in_der_Apotheke	Assistenzarzt in der Apotheke
Assistenzprofessor	Assistenzprofessor
Assistenzprofessor_der_Medizin	Assistenzprofessor der Medizin
Assistenzprofessor_für_Bildung	Assistenzprofessor für Bildung
Assistenzprofessor_für_Englisch	Assistenzprofessor für Englisch
Assistenzprofessor_für_Geschichte	Assistenzprofessor für Geschichte
Assistenzprofessor_für_Management	Assistenzprofessor für Management
Assistenzprofessor_für_Philosophie	Assistenzprofessor für Philosophie
Assistenzprofessor_für_Recht	Assistenzprofessor für Recht
Assistenztrainer_für_Stärke_und_Konditionierung	Assistenztrainer für Stärke und Konditionierung
Assistierender_Video-Editor	Assistierender Video-Editor
Assistierender_Wohnbau-Ingenieur	Assistierender Wohnbau-Ingenieur
Assoziierte_Sammlungen	Assoziierte Sammlungen
Assoziierte_produzieren	Assoziierte produzieren
Assoziierter_Hochschulabsolvent	Assoziierter Hochschulabsolvent
Assoziierter_ländlicher_Spediteur	Assoziierter ländlicher Spediteur
Atelier-Künstler	Atelier-Künstler
Audio-Mischpult	Audio-Mischpult
Audio-Produzent	Audio-Produzent
Audiotechniker	Audiotechniker
Audit-Sachbearbeiter	Audit-Sachbearbeiter
Aufnahme-Künstler	Aufnahme-Künstler
Aufnahmetechniker	Aufnahmetechniker
Aufsicht_über_die_Implementierung	Aufsicht über die Implementierung
Aufsichtsführender_Sonderbeauftragter	Aufsichtsführender Sonderbeauftragter
Auftragnehmer	Auftragnehmer
Auktionator	Auktionator
Ausbilder_aus_Messing	Ausbilder aus Messing
Ausbilder_für_Animation	Ausbilder für Animation
Ausbilder_für_Buchhaltung	Ausbilder für Buchhaltung
Ausbilder_für_Grafikdesign	Ausbilder für Grafikdesign
Ausbilder_für_Krankenpflege	Ausbilder für Krankenpflege
Ausbilder_für_Schusswaffen	Ausbilder für Schusswaffen
Ausbilder_für_graduierte_Studenten	Ausbilder für graduierte Studenten
Ausbilder_für_primäre_Schießkunst	Ausbilder für primäre Schießkunst
Ausbildungs-_und_Vermittlungsbeauftragter	Ausbildungs- und Vermittlungsbeauftragter
Ausbildungskapitän	Ausbildungskapitän
Ausführender_Coach	Ausführender Coach
Ausführender_Kreativdirektor	Ausführender Kreativdirektor
Ausführender_Küchenchef	Ausführender Küchenchef
Ausführender_Produzent	Ausführender Produzent
Ausführender_Sous-Chef	Ausführender Sous-Chef
Ausgezeichneter_Softwaretechniker	Ausgezeichneter Softwaretechniker
Ausgezeichnetes_Mitglied_des_technischen_Personals	Ausgezeichnetes Mitglied des technischen Personals
Ausleihe_näher	Ausleihe näher
Ausländische_Mitarbeiterin	Ausländische Mitarbeiterin
Ausländischer_Rechtsberater	Ausländischer Rechtsberater
Austausch-Administrator	Austausch-Administrator
Auszubildender_im_Bereich_Softwaretechnik	Auszubildender im Bereich Softwaretechnik
Automatisierungs-Entwickler	Automatisierungs-Entwickler
Automatisierungstechniker	Automatisierungstechniker
Außendienst-Koordinator	Außendienst-Koordinator
Außendienst-Support-Analyst	Außendienst-Support-Analyst
Außendienst-Supporttechniker	Außendienst-Supporttechniker
Außendiensttechniker	Außendiensttechniker
Außerordentlicher_Professor	Außerordentlicher Professor
Außerordentlicher_Professor_für_Finanzen	Außerordentlicher Professor für Finanzen
Außerordentlicher_Professor_für_Geschichte	Außerordentlicher Professor für Geschichte
Avioniker/in	Avioniker/in
BSctechniker	BSctechniker
Babysitter	Babysitter
Back-End-Entwickler	Back-End-Entwickler
Bagger	Bagger
Band-Direktor	Band-Direktor
Band-Manager	Band-Manager
Band-Operator	Band-Operator
Bandmitglied	Bandmitglied
Bank-Manager	Bank-Manager
Bank-Prüfer	Bank-Prüfer
Bankangestellter	Bankangestellter
Bankett-Kapitän	Bankett-Kapitän
Bankett-Koch	Bankett-Koch
Bankett-Koordinator	Bankett-Koordinator
Bankett-Server	Bankett-Server
Bankett-Supervisor	Bankett-Supervisor
Banktechniker	Banktechniker
Bar_Manager	Bar Manager
Barbier	Barbier
Barmann	Barmann
Barre-Ausbilder	Barre-Ausbilder
Basisleiter	Basisleiter
Bassist	Bassist
Bataillonschef	Bataillonschef
Bauführer	Bauführer
Bauinspektor	Bauinspektor
Baukommissar	Baukommissar
Bauleiter	Bauleiter
Bautechniker_vor_Ort	Bautechniker vor Ort
Beamter	Beamter
Beauftragter_für_Alumni-Beziehungen	Beauftragter für Alumni-Beziehungen
Beauftragter_für_Bestandskontrolle	Beauftragter für Bestandskontrolle
Beauftragter_für_Gastbeziehungen	Beauftragter für Gastbeziehungen
Beauftragter_für_Geberbeziehungen	Beauftragter für Geberbeziehungen
Beauftragter_für_Handelsmarketing	Beauftragter für Handelsmarketing
Beauftragter_für_Informationssicherung	Beauftragter für Informationssicherung
Beauftragter_für_Kreditverwaltung	Beauftragter für Kreditverwaltung
Beauftragter_für_Lebensmittel_und_Getränke	Beauftragter für Lebensmittel und Getränke
Beauftragter_für_Lieferkette	Beauftragter für Lieferkette
Beauftragter_für_Marketing_und_Öffentlichkeitsarbeit	Beauftragter für Marketing und Öffentlichkeitsarbeit
Beauftragter_für_Medienbeziehungen	Beauftragter für Medienbeziehungen
Beauftragter_für_Medienplanung	Beauftragter für Medienplanung
Beauftragter_für_Recht_und_Compliance	Beauftragter für Recht und Compliance
Beauftragter_für_Rekrutierung	Beauftragter für Rekrutierung
Beauftragter_für_Sonderpädagogik	Beauftragter für Sonderpädagogik
Beauftragter_für_Unternehmensentwicklung	Beauftragter für Unternehmensentwicklung
Beauftragter_für_den_Gästeservice	Beauftragter für den Gästeservice
Beauftragter_für_digitale_Medien	Beauftragter für digitale Medien
Beauftragter_für_interne_Kommunikation	Beauftragter für interne Kommunikation
Beauftragter_für_kreative_Dienstleistungen	Beauftragter für kreative Dienstleistungen
Beauftragter_für_Öffentlichkeitsarbeit	Beauftragter für Öffentlichkeitsarbeit
Begleitender_Ausbilder	Begleitender Ausbilder
Begleiter	Begleiter
Begrüßer	Begrüßer
Behandelnder_Arzt	Behandelnder Arzt
Beitrag_näher	Beitrag näher
Beitragender	Beitragender
Beitragender_Schriftsteller	Beitragender Schriftsteller
Bekleidungsdesigner	Bekleidungsdesigner
Beleuchtender_Kameramann	Beleuchtender Kameramann
Benannter_Makler	Benannter Makler
Benefits_Manager	Benefits Manager
Benutzer-Supportexperte	Benutzer-Supportexperte
Benutzer-Supporttechniker	Benutzer-Supporttechniker
Beratender_Geologe	Beratender Geologe
Beratender_Manager	Beratender Manager
Beratender_Psychologe	Beratender Psychologe
Beratender_Redakteur	Beratender Redakteur
Beratender_Systemanalytiker	Beratender Systemanalytiker
Beratender_Techniker	Beratender Techniker
Beratender_Vertriebsexperte	Beratender Vertriebsexperte
Berater	Berater
Berater_für_Auslandsstudien	Berater für Auslandsstudien
Berater_für_Automatisierung	Berater für Automatisierung
Berater_für_Bohrungen	Berater für Bohrungen
Berater_für_Datennetzwerke	Berater für Datennetzwerke
Berater_für_Dekoration	Berater für Dekoration
Berater_für_Executive_Search	Berater für Executive Search
Berater_für_Festanstellung	Berater für Festanstellung
Berater_für_Führungsweiterbildung	Berater für Führungsweiterbildung
Berater_für_Geldbeschaffung	Berater für Geldbeschaffung
Berater_für_Grafikdesign	Berater für Grafikdesign
Berater_für_Hypotheken_zu_Hause	Berater für Hypotheken zu Hause
Berater_für_Marketing_und_Öffentlichkeitsarbeit	Berater für Marketing und Öffentlichkeitsarbeit
Berater_für_Maschinenbau	Berater für Maschinenbau
Berater_für_Mitgliedschaft	Berater für Mitgliedschaft
Berater_für_Netzwerkdesign	Berater für Netzwerkdesign
Berater_für_Netzwerksicherheit	Berater für Netzwerksicherheit
Berater_für_Netzwerktechnik	Berater für Netzwerktechnik
Berater_für_Organisationsentwicklung	Berater für Organisationsentwicklung
Berater_für_Produktdesign	Berater für Produktdesign
Berater_für_Rechtsstreitigkeiten	Berater für Rechtsstreitigkeiten
Berater_für_Social_Media_Marketing	Berater für Social Media Marketing
Berater_für_Tagescamps	Berater für Tagescamps
Berater_für_Talentakquise	Berater für Talentakquise
Berater_für_Talentmanagement	Berater für Talentmanagement
Berater_für_Telekommunikation	Berater für Telekommunikation
Berater_für_Testautomatisierung	Berater für Testautomatisierung
Berater_für_Unternehmensentwicklung	Berater für Unternehmensentwicklung
Berater_für_Veranstaltungen	Berater für Veranstaltungen
Berater_für_Verlagswesen	Berater für Verlagswesen
Berater_für_Wohnungsbaudarlehen	Berater für Wohnungsbaudarlehen
Berater_für_den_Verkauf_neuer_Häuser	Berater für den Verkauf neuer Häuser
Berater_für_die_Grundschule	Berater für die Grundschule
Berater_für_gewerbliche_Immobilien	Berater für gewerbliche Immobilien
Berater_für_internationale_Reisen	Berater für internationale Reisen
Berater_für_internationale_Wirtschaftsentwicklung	Berater für internationale Wirtschaftsentwicklung
Berater_für_psychische_Gesundheit	Berater für psychische Gesundheit
Berater_für_Öffentlichkeitsarbeit	Berater für Öffentlichkeitsarbeit
Berater_für_Öffentlichkeitsarbeit_und_Kommunikation	Berater für Öffentlichkeitsarbeit und Kommunikation
Beraterin_für_Öffentlichkeitsarbeit	Beraterin für Öffentlichkeitsarbeit
Bereichsleiter_Export	Bereichsleiter Export
Bereichssammlungs-Manager	Bereichssammlungs-Manager
Bergbau-Geologe	Bergbau-Geologe
Bergbautechniker	Bergbautechniker
Berufskraftfahrer	Berufskraftfahrer
Berufsmusiker	Berufsmusiker
Beschäftigungsexperte	Beschäftigungsexperte
Bestell-Selektor	Bestell-Selektor
Betreiber_der_Tafel	Betreiber der Tafel
Betreiber_einer_Netzbetriebszentrale	Betreiber einer Netzbetriebszentrale
Betreiber_von_Desktop-Publishing	Betreiber von Desktop-Publishing
Betriebsleiter_der_Apotheke	Betriebsleiter der Apotheke
Betriebssystem-Analytiker	Betriebssystem-Analytiker
Betriebswirtschaftlicher_Berater	Betriebswirtschaftlicher Berater
Betrugsermittler	Betrugsermittler
Bevorzugter_Bankier	Bevorzugter Bankier
Bewertungs-Analyst	Bewertungs-Analyst
Beziehungsbeauftragter	Beziehungsbeauftragter
Bezirksrichter	Bezirksrichter
Bezirksschwester	Bezirksschwester
Bezirkstechniker	Bezirkstechniker
Bezirksverwalter_für_Vermögensschutz	Bezirksverwalter für Vermögensschutz
Bibliothekar	Bibliothekar
Bibliothekar_für_öffentliche_Dienste	Bibliothekar für öffentliche Dienste
Bildende_Künstlerin	Bildende Künstlerin
Bildgebender_Supervisor	Bildgebender Supervisor
Bildhauer	Bildhauer
Bildungsberaterin	Bildungsberaterin
Biologie-Lehrerin	Biologie-Lehrerin
Blogger	Blogger
Blumen-Manager	Blumen-Manager
Bodenleitung	Bodenleitung
Bohrbeauftragter	Bohrbeauftragter
Bohrer	Bohrer
Bohrinspektor	Bohrinspektor
Bohrungs-Manager	Bohrungs-Manager
Bootcamp-Ausbilder	Bootcamp-Ausbilder
Branch_Operations_Supervisor	Branch Operations Supervisor
Briefzusteller_Stadt	Briefzusteller Stadt
Broadcast-Associate	Broadcast-Associate
Broadcast-Designer	Broadcast-Designer
Broadcast-Koordinator	Broadcast-Koordinator
Broadcast-Unterhändler	Broadcast-Unterhändler
Broadcasteinkäufer	Broadcasteinkäufer
Brunnentechniker	Brunnentechniker
Bräunungsberater	Bräunungsberater
Brückentechniker	Brückentechniker
Buchhalter	Buchhalter
Buchhalterin	Buchhalterin
Buchhaltungspersonal	Buchhaltungspersonal
Bundesagent	Bundesagent
Business_Center-Manager	Business Center-Manager
Business_Development_Leitung	Business Development Leitung
Business_Development_Manager	Business Development Manager
Business-Analyst	Business-Analyst
Bäcker	Bäcker
Bäckerei-Angestellter	Bäckerei-Angestellter
Bäckerei-Manager	Bäckerei-Manager
Börsenmakler	Börsenmakler
Cafe-Manager	Cafe-Manager
Casting-Assistent	Casting-Assistent
Casting-Direktor	Casting-Direktor
Casting-Produzent	Casting-Produzent
Caterer	Caterer
Catering-Aufseher	Catering-Aufseher
Catering-Koch	Catering-Koch
Catering-Koordinator	Catering-Koordinator
Catering-Veranstaltungsleiter	Catering-Veranstaltungsleiter
Certified_Residential_Appraiser	Certified Residential Appraiser
Charakter_Technischer_Direktor	Charakter Technischer Direktor
Charakter-Animator	Charakter-Animator
Charakter-Künstler	Charakter-Künstler
Cheerleading-Ausbilder	Cheerleading-Ausbilder
Chef_de_Partie	Chef de Partie
Chef_der_Konzernleitung	Chef der Konzernleitung
Chef-Barkeeper	Chef-Barkeeper
Chef-Depotperson	Chef-Depotperson
Chef-Designer	Chef-Designer
Chef-Ermittler	Chef-Ermittler
Chef-Fluglehrer	Chef-Fluglehrer
Chef-Fußballtrainer	Chef-Fußballtrainer
Chef-Geologe	Chef-Geologe
Chef-Händler	Chef-Händler
Chef-Kurator	Chef-Kurator
Chef-Pilot	Chef-Pilot
Chef-Psychologe	Chef-Psychologe
Chef-Rechtsberater	Chef-Rechtsberater
Chef-Resident	Chef-Resident
Chef-Steward	Chef-Steward
Chef-Underwriting_Officer	Chef-Underwriting Officer
Chefkoch	Chefkoch
Chefredakteur	Chefredakteur
Cheftrainer	Cheftrainer
Chemietechniker	Chemietechniker
Chief_Business_Development_Officer	Chief Business Development Officer
Chief_Credit_Officer	Chief Credit Officer
Chief_Investment_Officer	Chief Investment Officer
Chief_Risk_Officer	Chief Risk Officer
Chirurg	Chirurg
Chirurgische_Krankenschwester	Chirurgische Krankenschwester
Choreograf	Choreograf
Cisco-Netzwerktechniker	Cisco-Netzwerktechniker
Claims_Associate	Claims Associate
Clown	Clown
Cluster-Führung	Cluster-Führung
Co-Pilot	Co-Pilot
Cocktail-Kellnerin	Cocktail-Kellnerin
Cocktail-Server	Cocktail-Server
Community_Sales_Manager	Community Sales Manager
Computer-Hardwaretechniker	Computer-Hardwaretechniker
Computer-Laborant	Computer-Laborant
Computer-Netzwerkexperte	Computer-Netzwerkexperte
Computer-Netzwerktechniker	Computer-Netzwerktechniker
Computer-Servicetechniker	Computer-Servicetechniker
Computer-Supporttechniker	Computer-Supporttechniker
Computer-Vertriebsmitarbeiter	Computer-Vertriebsmitarbeiter
Computeranimator	Computeranimator
Computergrafiker	Computergrafiker
Computersystemtechniker	Computersystemtechniker
Computertechniker	Computertechniker
Country_Business_Manager	Country Business Manager
Crossfit-Ausbilder	Crossfit-Ausbilder
Darlehens-Koordinator	Darlehens-Koordinator
Darlehens-Prozessor	Darlehens-Prozessor
Darlehensexperte	Darlehensexperte
Darlehenssachbearbeiter_für_Wohnraum	Darlehenssachbearbeiter für Wohnraum
Darlehensvertreter	Darlehensvertreter
Darstellender_Künstler	Darstellender Künstler
Datenbank-Entwickler	Datenbank-Entwickler
Datennetzwerkexperte	Datennetzwerkexperte
Datennetzwerktechniker	Datennetzwerktechniker
Datensicherheitsadministrator	Datensicherheitsadministrator
Dekan	Dekan
Dekan_für_Zulassungen	Dekan für Zulassungen
Dekorateur_einstellen	Dekorateur einstellen
Derivate-Broker	Derivate-Broker
Derivate-Händler	Derivate-Händler
Design_Studio_Manager	Design Studio Manager
Design-Assistent	Design-Assistent
Design-Ausbilder	Design-Ausbilder
Design-Editor	Design-Editor
Design-Koordinator	Design-Koordinator
Design-Praktikant	Design-Praktikant
Designer	Designer
Designer_für_Bekleidung	Designer für Bekleidung
Designer_für_Damenoberbekleidung	Designer für Damenoberbekleidung
Designer_für_Herrenbekleidung	Designer für Herrenbekleidung
Designer_für_Strickwaren	Designer für Strickwaren
Designer_für_Veröffentlichungen	Designer für Veröffentlichungen
Designer_für_Werbung	Designer für Werbung
Designer_für_digitale_Medien	Designer für digitale Medien
Designer_für_gedruckte_Schaltungen	Designer für gedruckte Schaltungen
Desktop-Administrator	Desktop-Administrator
Desktop-Support-Analyst	Desktop-Support-Analyst
Desktop-Supporttechniker	Desktop-Supporttechniker
Desktop-Unterstützung	Desktop-Unterstützung
Desktop-Unterstützung_Intern	Desktop-Unterstützung Intern
Desktop-Verleger	Desktop-Verleger
Desktoptechniker	Desktoptechniker
Devisen-Manager	Devisen-Manager
Diagnosetechniker	Diagnosetechniker
Dienst-Designer	Dienst-Designer
Diensthabender_Manager	Diensthabender Manager
Dienstleistungen_für_Privatkunden	Dienstleistungen für Privatkunden
Digitaler_Aufseher	Digitaler Aufseher
Digitaler_Designer	Digitaler Designer
Digitaler_Konstrukteur	Digitaler Konstrukteur
Digitaler_Kundenbetreuer	Digitaler Kundenbetreuer
Digitaler_Medienplaner	Digitaler Medienplaner
Digitaler_Planer	Digitaler Planer
Digitaler_Produzent	Digitaler Produzent
Digitaler_Verkaufsleiter	Digitaler Verkaufsleiter
Diplom-Apothekentechniker	Diplom-Apothekentechniker
Diplom-Architekt	Diplom-Architekt
Diplom-Bautechniker	Diplom-Bautechniker
Diplom-Maschinenbautechniker	Diplom-Maschinenbautechniker
Direktor	Direktor
Direktor_Nachrichten	Direktor Nachrichten
Direktor_Organisatorische_Effektivität	Direktor Organisatorische Effektivität
Direktor_der_Bildgebungsdienste	Direktor der Bildgebungsdienste
Direktor_der_Essensdienste	Direktor der Essensdienste
Direktor_der_Gruppe_Medien	Direktor der Gruppe Medien
Direktor_der_Kundendienste	Direktor der Kundendienste
Direktor_der_Mediendienste	Direktor der Mediendienste
Direktor_der_Postproduktion	Direktor der Postproduktion
Direktor_der_Radiologie	Direktor der Radiologie
Direktor_der_Videoproduktion	Direktor der Videoproduktion
Direktor_des_Food_Service	Direktor des Food Service
Direktor_des_Network_Operations_Center	Direktor des Network Operations Center
Direktor_für_Aktienforschung	Direktor für Aktienforschung
Direktor_für_Animation	Direktor für Animation
Direktor_für_Bildung	Direktor für Bildung
Direktor_für_Catering-Vertrieb	Direktor für Catering-Vertrieb
Direktor_für_Design_&_Entwicklung	Direktor für Design & Entwicklung
Direktor_für_Elektrotechnik	Direktor für Elektrotechnik
Direktor_für_Entwicklung_und_Öffentlichkeitsarbeit	Direktor für Entwicklung und Öffentlichkeitsarbeit
Direktor_für_Ermittlungen	Direktor für Ermittlungen
Direktor_für_Executive_Search	Direktor für Executive Search
Direktor_für_Familiendienste	Direktor für Familiendienste
Direktor_für_Firmenkundengeschäft	Direktor für Firmenkundengeschäft
Direktor_für_Fitness	Direktor für Fitness
Direktor_für_Flugbetrieb	Direktor für Flugbetrieb
Direktor_für_Fondsentwicklung	Direktor für Fondsentwicklung
Direktor_für_Fotografie	Direktor für Fotografie
Direktor_für_Freizeitvertrieb	Direktor für Freizeitvertrieb
Direktor_für_Geschäftsbetrieb	Direktor für Geschäftsbetrieb
Direktor_für_Gruppenplanung	Direktor für Gruppenplanung
Direktor_für_Hardware-Entwicklung	Direktor für Hardware-Entwicklung
Direktor_für_Humankapital	Direktor für Humankapital
Direktor_für_Immatrikulation	Direktor für Immatrikulation
Direktor_für_Immatrikulationsmanagement	Direktor für Immatrikulationsmanagement
Direktor_für_Kreditwesen	Direktor für Kreditwesen
Direktor_für_Lebensmittel_&_Getränke	Direktor für Lebensmittel & Getränke
Direktor_für_Logistik	Direktor für Logistik
Direktor_für_Marktintelligenz	Direktor für Marktintelligenz
Direktor_für_Medien	Direktor für Medien
Direktor_für_Mitgliederbetreuung	Direktor für Mitgliederbetreuung
Direktor_für_Netzwerkbetrieb	Direktor für Netzwerkbetrieb
Direktor_für_Personalwesen	Direktor für Personalwesen
Direktor_für_Physikalische_Therapie	Direktor für Physikalische Therapie
Direktor_für_Produktionsbetrieb	Direktor für Produktionsbetrieb
Direktor_für_Rechtsangelegenheiten	Direktor für Rechtsangelegenheiten
Direktor_für_Rechtsstreitigkeiten	Direktor für Rechtsstreitigkeiten
Direktor_für_Rundfunkbetrieb	Direktor für Rundfunkbetrieb
Direktor_für_Rundfunkproduktion	Direktor für Rundfunkproduktion
Direktor_für_Sammlungen	Direktor für Sammlungen
Direktor_für_Sonderdienste	Direktor für Sonderdienste
Direktor_für_Sonderveranstaltungen	Direktor für Sonderveranstaltungen
Direktor_für_Steuern	Direktor für Steuern
Direktor_für_Strategie_und_Betrieb	Direktor für Strategie und Betrieb
Direktor_für_Talent	Direktor für Talent
Direktor_für_Talentakquise	Direktor für Talentakquise
Direktor_für_Talentförderung	Direktor für Talentförderung
Direktor_für_Unternehmens-_und_Stiftungsbeziehungen	Direktor für Unternehmens- und Stiftungsbeziehungen
Direktor_für_Unternehmensentwicklung	Direktor für Unternehmensentwicklung
Direktor_für_Unternehmenspartnerschaften	Direktor für Unternehmenspartnerschaften
Direktor_für_Veranstaltungsmanagement	Direktor für Veranstaltungsmanagement
Direktor_für_Verkauf_und_Marketing	Direktor für Verkauf und Marketing
Direktor_für_Vorkonstruktion	Direktor für Vorkonstruktion
Direktor_für_den_institutionellen_Vertrieb	Direktor für den institutionellen Vertrieb
Direktor_für_digitale_Konten	Direktor für digitale Konten
Direktor_für_festverzinsliche_Wertpapiere	Direktor für festverzinsliche Wertpapiere
Direktor_für_geplante_Spenden	Direktor für geplante Spenden
Direktor_für_interaktive_Kunst	Direktor für interaktive Kunst
Direktor_für_medizinische_Ausbildung	Direktor für medizinische Ausbildung
Direktor_für_persönliches_Training	Direktor für persönliches Training
Direktor_für_private_Veranstaltungen	Direktor für private Veranstaltungen
Direktor_für_soziale_Medien	Direktor für soziale Medien
Direktor_für_strategische_Entwicklung	Direktor für strategische Entwicklung
Direktor_für_strukturierte_Finanzen	Direktor für strukturierte Finanzen
Direktor_für_Öffentlichkeitsarbeit	Direktor für Öffentlichkeitsarbeit
Direktorin_einer_Vorschule	Direktorin einer Vorschule
Direktorin_für_Geldbeschaffung	Direktorin für Geldbeschaffung
Direktorin_für_Medienbeziehungen	Direktorin für Medienbeziehungen
Direktorin_für_Underwriting	Direktorin für Underwriting
Direktorin_für_Zulassungen	Direktorin für Zulassungen
Direktorin_für_Zuschauerentwicklung	Direktorin für Zuschauerentwicklung
Dispatch_Supervisor	Dispatch Supervisor
Dispatcher	Dispatcher
Distrikt-Trainer	Distrikt-Trainer
Diät-Manager	Diät-Manager
Dokumentarfilmer	Dokumentarfilmer
Dozent	Dozent
Drahtgebundener_Außendiensttechniker	Drahtgebundener Außendiensttechniker
Drahtloser_Berater	Drahtloser Berater
Drahtloser_Techniker	Drahtloser Techniker
Drahtlosexperte	Drahtlosexperte
Drehbuchautor	Drehbuchautor
Druck-Designer	Druck-Designer
Druck-Produzent	Druck-Produzent
Edisontechniker	Edisontechniker
Editor_für_Postproduktion	Editor für Postproduktion
Ehe-_und_Familientherapeut	Ehe- und Familientherapeut
Eifriger_Redakteur	Eifriger Redakteur
Eigenkapital-Partner	Eigenkapital-Partner
Eigentümer_der_Agentur	Eigentümer der Agentur
Eingetragener_Dentalhygieniker	Eingetragener Dentalhygieniker
Einnahme-Agent	Einnahme-Agent
Einsatzexperte	Einsatzexperte
Einsatztechniker	Einsatztechniker
Einstellungs-Supervisor	Einstellungs-Supervisor
Einwohner	Einwohner
Einzelhandels-Verkaufsassistent	Einzelhandels-Verkaufsassistent
Einzelhandelskaufmann	Einzelhandelskaufmann
Einzelhandelsmarkt-Manager	Einzelhandelsmarkt-Manager
Elektrischer_Projekttechniker	Elektrischer Projekttechniker
Elektro-_und_Elektroniktechniker	Elektro- und Elektroniktechniker
Elektromechaniktechniker	Elektromechaniktechniker
Elektronik-Designer	Elektronik-Designer
Elektronik-Designtechniker	Elektronik-Designtechniker
Elektronik-Entwicklungstechniker	Elektronik-Entwicklungstechniker
Elektronikexperte	Elektronikexperte
Elektronischer_Vertriebsmitarbeiter	Elektronischer Vertriebsmitarbeiter
Elektrotechnik	Elektrotechnik
Elektrotechniker	Elektrotechniker
Elementare_Schulleiterin	Elementare Schulleiterin
Empfangender_Supervisor	Empfangender Supervisor
Empfehlungs-Agent	Empfehlungs-Agent
Endodontologe	Endodontologe
Englisch-Übersetzer	Englisch-Übersetzer
Englischlehrer	Englischlehrer
Englischlehrer_für_die_Sekundarstufe	Englischlehrer für die Sekundarstufe
Englischsprachiger_Kunstlehrer	Englischsprachiger Kunstlehrer
Entwickler	Entwickler
Entwickler_mobiler_Anwendungen	Entwickler mobiler Anwendungen
Entwicklung_Produzent	Entwicklung Produzent
Entwicklungs-Technologe	Entwicklungs-Technologe
Entwicklungsprogramm_für_Edison-Engineering	Entwicklungsprogramm für Edison-Engineering
Entwurf_Architekt	Entwurf Architekt
Equity_Research_Associate	Equity Research Associate
Erbauer	Erbauer
Ereignis-Designer	Ereignis-Designer
Ereignis-Manager	Ereignis-Manager
Erfahrener_Systemtechniker	Erfahrener Systemtechniker
Ermittler	Ermittler
Ermittler_für_Unternehmen	Ermittler für Unternehmen
Ermittler_vor_Ort	Ermittler vor Ort
Ermittlungsbeamter	Ermittlungsbeamter
Erste_Kamera-Assistentin	Erste Kamera-Assistentin
Erster_Anwalt	Erster Anwalt
Erster_Offizier	Erster Offizier
Erster_Redaktionsassistent	Erster Redaktionsassistent
Erster_Techniker	Erster Techniker
Erster_stellvertretender_Direktor	Erster stellvertretender Direktor
Ertrags-Manager	Ertrags-Manager
Etagenleiter	Etagenleiter
Executive_In_Residence	Executive In Residence
Executive_VP_Business_Development	Executive VP Business Development
Exekutiv-Kunstdirektor	Exekutiv-Kunstdirektor
Exekutiv-Rechtssekretär	Exekutiv-Rechtssekretär
Exekutive_Haushälterin	Exekutive Haushälterin
Exekutive_für_Beziehungen	Exekutive für Beziehungen
Exekutive_für_Rekrutierung	Exekutive für Rekrutierung
Exekutive_für_Unternehmensfinanzen	Exekutive für Unternehmensfinanzen
Exekutivteam-Leiter_Gast-Erfahrung	Exekutivteam-Leiter Gast-Erfahrung
Exklusiver_Vertreter	Exklusiver Vertreter
Experte_für_technische_Unterstützung	Experte für technische Unterstützung
Export_Sales_Executive	Export Sales Executive
Export-Vertriebsbeauftragter	Export-Vertriebsbeauftragter
Exportbeauftragter	Exportbeauftragter
Exportexperte	Exportexperte
Exportmanager	Exportmanager
Externer_Anwalt	Externer Anwalt
Externer_Prüfer	Externer Prüfer
Fachmann_für_Gesundheit_&_Fitness	Fachmann für Gesundheit & Fitness
Fahrer	Fahrer
Fahrer_des_Unternehmens	Fahrer des Unternehmens
Fahrversuchtechniker	Fahrversuchtechniker
Fakultäts-Berater	Fakultäts-Berater
Familienberaterin	Familienberaterin
Familienunterstützende_Arbeitnehmerin	Familienunterstützende Arbeitnehmerin
Farbexperte	Farbexperte
Federal_Tax_Manager	Federal Tax Manager
Feldgeologe	Feldgeologe
Fern-Unterstützungstechniker	Fern-Unterstützungstechniker
Fernsehjournalist	Fernsehjournalist
Fernsehmoderator	Fernsehmoderator
Fernsehnachrichten-Reporter	Fernsehnachrichten-Reporter
Fernsehproduzent	Fernsehproduzent
Fernsehregisseur	Fernsehregisseur
Fertigungstechniker	Fertigungstechniker
Feuerwehr-Hauptmann	Feuerwehr-Hauptmann
Feuerwehr-Leutnant	Feuerwehr-Leutnant
Feuerwehr-Marschall	Feuerwehr-Marschall
Feuerwehrchef	Feuerwehrchef
Feuerwehrmann	Feuerwehrmann
Feuerwehroffizier	Feuerwehroffizier
Film_&_Video_Editor	Film & Video Editor
Film-Editor	Film-Editor
Filmemacher	Filmemacher
Filmkomponist	Filmkomponist
Filmproduzent	Filmproduzent
Filmregisseur	Filmregisseur
Finanz-Rekrutierer	Finanz-Rekrutierer
Finanzamt-Agent	Finanzamt-Agent
Finanzanalytiker	Finanzanalytiker
Finanzieller_Schriftsteller	Finanzieller Schriftsteller
Finanzieller_Vertreter	Finanzieller Vertreter
Finanzierungs-Analyst	Finanzierungs-Analyst
Finanzjournalist	Finanzjournalist
Finanzmakler	Finanzmakler
Finanzmarktanalyst	Finanzmarktanalyst
Firewalltechniker	Firewalltechniker
Firmen-Flugbegleiter	Firmen-Flugbegleiter
Firmen-Pilot	Firmen-Pilot
Firmen-Reisebüro	Firmen-Reisebüro
Firmen-Webmaster	Firmen-Webmaster
Firmenchef	Firmenchef
Firmware-Entwicklungstechniker	Firmware-Entwicklungstechniker
First_Line_Unterstützung	First Line Unterstützung
Fitness-Berater	Fitness-Berater
Fitness-Fachmarkt	Fitness-Fachmarkt
Fitness-Koordinator	Fitness-Koordinator
Fitness-Manager	Fitness-Manager
Fitness-Trainer	Fitness-Trainer
Fitnesstrainer	Fitnesstrainer
Flammen-Künstler	Flammen-Künstler
Flash-Animator	Flash-Animator
Flieger	Flieger
Floral_Designer	Floral Designer
Flugbetriebsleiter	Flugbetriebsleiter
Fluglehrer	Fluglehrer
Fluglinien-Kapitän	Fluglinien-Kapitän
Flugversuchstechniker	Flugversuchstechniker
Fonds-Analyst	Fonds-Analyst
Fondsmanager	Fondsmanager
Forensischer_Psychologe	Forensischer Psychologe
Fortgeschrittene_Übungsschwester	Fortgeschrittene Übungsschwester
Foto-Editor	Foto-Editor
Foto-Stylist	Foto-Stylist
Fotoexperte	Fotoexperte
Fotograf_der_Veranstaltung	Fotograf der Veranstaltung
Fotografen-Assistent	Fotografen-Assistent
Fotolabortechniker	Fotolabortechniker
Fototechniker	Fototechniker
Frachtmakler	Frachtmakler
Freiberufler	Freiberufler
Fremdenführer	Fremdenführer
Friedensbeauftragter	Friedensbeauftragter
Friseur	Friseur
Front_Desk-Vertreter	Front Desk-Vertreter
Front_Office_Exekutive	Front Office Exekutive
Front_Office_Supervisor	Front Office Supervisor
Front_of_House_Manager	Front of House Manager
Front-Desk-Manager	Front-Desk-Manager
Front-Office-Manager	Front-Office-Manager
Frontend-Supervisor	Frontend-Supervisor
Frontoffice-Agent	Frontoffice-Agent
Frontschalter-Associate	Frontschalter-Associate
Frühkindliche_Erzieherin	Frühkindliche Erzieherin
Frühkindliche_Lehrerin	Frühkindliche Lehrerin
Full_Stacktechniker	Full Stacktechniker
Fundraising-Beauftragter	Fundraising-Beauftragter
Futures-Händler	Futures-Händler
Fußballspieler	Fußballspieler
Fußballtrainer	Fußballtrainer
Fußbodentechniker	Fußbodentechniker
Förderer	Förderer
Führung_verschieben	Führung verschieben
Führungskraft_für_Talentakquise	Führungskraft für Talentakquise
Führungskraft-Rekrutierer	Führungskraft-Rekrutierer
Fürsprecher	Fürsprecher
Galerie-Assistent	Galerie-Assistent
Galerie-Manager	Galerie-Manager
Galerie-Mitarbeiter	Galerie-Mitarbeiter
Gast-Assistenzprofessor	Gast-Assistenzprofessor
Gastdozent	Gastdozent
Gastgeber	Gastgeber
Gastkünstler	Gastkünstler
Gastlehrer	Gastlehrer
Gastwirt	Gastwirt
Gebiets-Trainer	Gebiets-Trainer
Gebietsansässige_Apotheke	Gebietsansässige Apotheke
Gebietsgeschäftsführer	Gebietsgeschäftsführer
Gebietsverkaufstechniker	Gebietsverkaufstechniker
Gelenkiger_Assistent	Gelenkiger Assistent
Gemälde-Künstler	Gemälde-Künstler
General_Superintendent	General Superintendent
Generaldirektor	Generaldirektor
Generaldirektor_des_Restaurants	Generaldirektor des Restaurants
Generalunternehmer	Generalunternehmer
Geologe	Geologe
Geologischer_Techniker	Geologischer Techniker
Geowissenschaftler	Geowissenschaftler
Geprüfter_Finanzanalyst	Geprüfter Finanzanalyst
Gesangslehrer	Gesangslehrer
Geschichtslehrer	Geschichtslehrer
Geschäftsentwickler	Geschäftsentwickler
Geschäftsführender_Aktionär	Geschäftsführender Aktionär
Geschäftsführender_Anwalt	Geschäftsführender Anwalt
Geschäftsführender_Direktor	Geschäftsführender Direktor
Geschäftsführender_Herausgeber	Geschäftsführender Herausgeber
Geschäftsführender_Makler	Geschäftsführender Makler
Geschäftsführender_Partner	Geschäftsführender Partner
Geschäftsführender_Supervisor	Geschäftsführender Supervisor
Geschäftsführer_Logistik	Geschäftsführer Logistik
Geschäftsführer_VP	Geschäftsführer VP
Geschäftsstelle_Geschäftsführender_Partner	Geschäftsstelle Geschäftsführender Partner
Gesundheitsbesucher	Gesundheitsbesucher
Getriebe-Controller	Getriebe-Controller
Getriebetechniker	Getriebetechniker
Gewerblicher_Immobilienmakler	Gewerblicher Immobilienmakler
Gitarrenlehrer	Gitarrenlehrer
Gitarrenspieler	Gitarrenspieler
Gitarrist	Gitarrist
Global_Business_Development_Manager	Global Business Development Manager
Global_Travel_Manager	Global Travel Manager
Globaler_Logistik-Manager	Globaler Logistik-Manager
Grafik-Design_Intern	Grafik-Design Intern
Grafik-Design-Assistent	Grafik-Design-Assistent
Grafik-Design-Betreuer	Grafik-Design-Betreuer
Grafik-Design-Künstler	Grafik-Design-Künstler
Grafik-Design-Lehrer	Grafik-Design-Lehrer
Grafik-Design-Manager	Grafik-Design-Manager
Grafik-Design-Student	Grafik-Design-Student
Grafikexperte	Grafikexperte
Grafischer_Künstler	Grafischer Künstler
Graphiktechniker	Graphiktechniker
Großkundenbetreuer	Großkundenbetreuer
Grundschuldirektorin	Grundschuldirektorin
Grundschullehrer	Grundschullehrer
Gruppen-Fitness-Ausbilder	Gruppen-Fitness-Ausbilder
Gruppenkopie-Betreuer	Gruppenkopie-Betreuer
Gruppenleiter_HR	Gruppenleiter HR
Gruppenleiter_Logistik	Gruppenleiter Logistik
Gruppenleiter_Technik	Gruppenleiter Technik
Gründungspartner	Gründungspartner
Gymnasiallehrer	Gymnasiallehrer
HR-Analyst	HR-Analyst
HR-Berater	HR-Berater
HR-Generalist	HR-Generalist
HR-Geschäftspartner	HR-Geschäftspartner
HR-Informationssystem-Analystin	HR-Informationssystem-Analystin
HR-Koordinator	HR-Koordinator
HR-Manager	HR-Manager
HR-Manager_der_Gruppe	HR-Manager der Gruppe
HR-Mitarbeiter	HR-Mitarbeiter
HR-Rekrutierer	HR-Rekrutierer
HR-Rekrutierungs-Assistentin	HR-Rekrutierungs-Assistentin
HR-Rekrutierungs-Koordinator	HR-Rekrutierungs-Koordinator
HR-Rekrutierungsexperte	HR-Rekrutierungsexperte
Haar-_und_Make-up-Künstler	Haar- und Make-up-Künstler
Haar-Designer	Haar-Designer
Hafentechniker	Hafentechniker
Handelsassistent	Handelsassistent
Handelsbanker	Handelsbanker
Handelsdirektor	Handelsdirektor
Handelsexperte	Handelsexperte
Handelspartner	Handelspartner
Hardware-Designer	Hardware-Designer
Hardware-Entwickler	Hardware-Entwickler
Hardware-Entwicklungstechniker	Hardware-Entwicklungstechniker
Hardware-Experte	Hardware-Experte
Hardware-Konstrukteur	Hardware-Konstrukteur
Hardware-Systemtechniker	Hardware-Systemtechniker
Hardware-Unterstützungstechniker	Hardware-Unterstützungstechniker
Hardwaretechniker	Hardwaretechniker
Haupt-Hydrogeologe	Haupt-Hydrogeologe
Haupt-Portfoliomanager	Haupt-Portfoliomanager
Haupt-Server	Haupt-Server
Hauptbankier	Hauptbankier
Hauptberichterstatter	Hauptberichterstatter
Hauptbuch-Supervisor	Hauptbuch-Supervisor
Hauptbuchhalter	Hauptbuchhalter
Hauptforscher	Hauptforscher
Hauptgeschäftsführer	Hauptgeschäftsführer
Hauptgrafik-Designer	Hauptgrafik-Designer
Hauptkassiererin	Hauptkassiererin
Hauptkorrespondentin	Hauptkorrespondentin
Hauptmann	Hauptmann
Hauptrechtsanwalt	Hauptrechtsanwalt
Hauptrekrutierer	Hauptrekrutierer
Haupttänzerin	Haupttänzerin
Hauptverantwortlicher	Hauptverantwortlicher
Hauptverantwortlicher_für_Politik	Hauptverantwortlicher für Politik
Hausarzt	Hausarzt
Hausaufseher	Hausaufseher
Hauskrankenschwester	Hauskrankenschwester
Hausmeister	Hausmeister
Haustier-Sitter	Haustier-Sitter
Hauswirtschaftsleiter	Hauswirtschaftsleiter
Head_of_Recruitment	Head of Recruitment
Hedge-Fonds-Analyst	Hedge-Fonds-Analyst
Heimkinoexperte	Heimkinoexperte
Heizungs-_und_Klimaanlagentechniker	Heizungs- und Klimaanlagentechniker
Helpdesk-Administrator	Helpdesk-Administrator
Helpdesk-Analyst	Helpdesk-Analyst
Helpdesk-Betreuer	Helpdesk-Betreuer
Helpdesk-Koordinator	Helpdesk-Koordinator
Helpdesk-Support-Analyst	Helpdesk-Support-Analyst
Helpdesk-Unterstützungstechniker	Helpdesk-Unterstützungstechniker
Helpdesktechniker	Helpdesktechniker
Herausgeber	Herausgeber
Herausgeber_Lebensstil	Herausgeber Lebensstil
Herausgeber_der_Gruppe	Herausgeber der Gruppe
Herausgeber_der_Stadt	Herausgeber der Stadt
Hersteller_von_Mustern	Hersteller von Mustern
Hilfskellner	Hilfskellner
Hintergrund-Ermittler	Hintergrund-Ermittler
Hochschullehrer	Hochschullehrer
Hochschulprofessor	Hochschulprofessor
Hochzeits-_und_Veranstaltungsplaner	Hochzeits- und Veranstaltungsplaner
Hochzeitsberater	Hochzeitsberater
Home_Stager	Home Stager
Housekeeping_Supervisor	Housekeeping Supervisor
Html5-Entwickler	Html5-Entwickler
Hundeausführer	Hundeausführer
Hundefrisör	Hundefrisör
Hundetrainer	Hundetrainer
Hydrologe	Hydrologe
Hypothekar-Associate	Hypothekar-Associate
Hypothekenbankier	Hypothekenbankier
Hypothekengeber	Hypothekengeber
Hypothekenmakler	Hypothekenmakler
Hypothekenversicherer	Hypothekenversicherer
Händler	Händler
Händler_für_Aktienderivate	Händler für Aktienderivate
Händler_für_Aktienverkäufe	Händler für Aktienverkäufe
Händler_für_festverzinsliche_Wertpapiere	Händler für festverzinsliche Wertpapiere
Händler_für_institutionelle_Verkäufe	Händler für institutionelle Verkäufe
Höflichkeits-Sekretär	Höflichkeits-Sekretär
Höherer_Exekutivbeamter	Höherer Exekutivbeamter
IT-Außendiensttechniker	IT-Außendiensttechniker
IT-Berater	IT-Berater
IT-Experte	IT-Experte
IT-Generalist	IT-Generalist
IT-Rekrutierer	IT-Rekrutierer
IT-Rekrutierungs-Berater	IT-Rekrutierungs-Berater
IT-Sicherheits-Administrator	IT-Sicherheits-Administrator
IT-Sicherheitsanalytiker	IT-Sicherheitsanalytiker
IT-Sicherheitstechniker	IT-Sicherheitstechniker
IT-Supportexperte	IT-Supportexperte
IT-Systemtechniker	IT-Systemtechniker
IT-Unterstützungstechniker	IT-Unterstützungstechniker
ITtechniker	ITtechniker
Illustrator	Illustrator
Immobilien-Analyst	Immobilien-Analyst
Immobilien-Assistent	Immobilien-Assistent
Immobilien-Berater	Immobilien-Berater
Immobilien-Kreditsachbearbeiter	Immobilien-Kreditsachbearbeiter
Immobilien-Manager	Immobilien-Manager
Immobilien-Portfolio-Manager	Immobilien-Portfolio-Manager
Immobilienexperte	Immobilienexperte
Immobiliengutachter	Immobiliengutachter
Immobilienmakler	Immobilienmakler
Implementierungstechniker	Implementierungstechniker
Import-Exekutive	Import-Exekutive
Import-Export_Exekutive	Import-Export Exekutive
Import-Export-Assistent	Import-Export-Assistent
Import-Export-Koordinator	Import-Export-Koordinator
Import-Export-Manager	Import-Export-Manager
Import-Koordinator	Import-Koordinator
Importmanager	Importmanager
Importsachbearbeiter	Importsachbearbeiter
Inbetriebnahme-Editor	Inbetriebnahme-Editor
Inbetriebnahme-Manager	Inbetriebnahme-Manager
Indoor_Cycling-Ausbilder	Indoor Cycling-Ausbilder
Informatik-Student	Informatik-Student
Informationssystem-Analytiker	Informationssystem-Analytiker
Infrastruktur-Aufseher	Infrastruktur-Aufseher
Inhalts-Manager	Inhalts-Manager
Inhalts-Supervisor	Inhalts-Supervisor
Inhaltsanalytiker	Inhaltsanalytiker
Inhaltsentwickler	Inhaltsentwickler
Inhaltsstratege	Inhaltsstratege
Innen-Großhändler	Innen-Großhändler
Innenarchitektin	Innenarchitektin
Innovationstechniker	Innovationstechniker
Integrierter_Marketing-Manager	Integrierter Marketing-Manager
Intensivist	Intensivist
Intensivpflege-Schwester	Intensivpflege-Schwester
Interaktiver_Entwickler	Interaktiver Entwickler
Interaktiver_Medien-Manager	Interaktiver Medien-Manager
Interaktiver_Produzent	Interaktiver Produzent
Interaktiver_Vertriebsleiter	Interaktiver Vertriebsleiter
Intern_für_Webentwicklung	Intern für Webentwicklung
Internationale_Logistik-Koordinatorin	Internationale Logistik-Koordinatorin
Internationaler_Einkaufsleiter	Internationaler Einkaufsleiter
Internationaler_Rechtsanwalt	Internationaler Rechtsanwalt
Internationaler_Rekrutierer	Internationaler Rekrutierer
Interner_Rekrutierer	Interner Rekrutierer
Interner_Übersetzer	Interner Übersetzer
Internes_Risikomanagement	Internes Risikomanagement
Internet-Marketing-Koordinator	Internet-Marketing-Koordinator
Internet-Verwalter	Internet-Verwalter
Inventar-Manager	Inventar-Manager
Investment_Banking_Sommer-Analyst	Investment Banking Sommer-Analyst
Investment_Research-Analyst	Investment Research-Analyst
Investment-Analyst	Investment-Analyst
Investment-Banking-Analyst	Investment-Banking-Analyst
Investment-Banking-Assistent	Investment-Banking-Assistent
Investment-Banking-Praktikant	Investment-Banking-Praktikant
Investmentexperte	Investmentexperte
Italienisch-Lehrer	Italienisch-Lehrer
J2EE-Entwickler	J2EE-Entwickler
Japanisch-Übersetzer	Japanisch-Übersetzer
Java-Anwendungsentwickler	Java-Anwendungsentwickler
Java-Architekt	Java-Architekt
Java-Berater	Java-Berater
Java-Entwickler	Java-Entwickler
Java-Softwaretechniker	Java-Softwaretechniker
Java-Teamleitung	Java-Teamleitung
Java-Web-Entwickler	Java-Web-Entwickler
Java/J2EE-Entwickler	Java/J2EE-Entwickler
Juristischer_Angestellter	Juristischer Angestellter
Juristischer_Assistent	Juristischer Assistent
Juristischer_Berater_für_Rekrutierung	Juristischer Berater für Rekrutierung
Juristischer_Geschäftsführer	Juristischer Geschäftsführer
Juristischer_Koordinator	Juristischer Koordinator
Juristischer_Mitarbeiter	Juristischer Mitarbeiter
Juristischer_Redakteur	Juristischer Redakteur
Juristischer_Sekretär	Juristischer Sekretär
Justizvollzugsbeamter	Justizvollzugsbeamter
Jährlicher_Fondsmanager	Jährlicher Fondsmanager
Kabinenbegleiter	Kabinenbegleiter
Kalibrierungstechniker	Kalibrierungstechniker
Kamera-Assistent	Kamera-Assistent
Kameramann	Kameramann
Kampfkunst-Ausbilder	Kampfkunst-Ausbilder
Kanzler_der_Universität	Kanzler der Universität
Kapitalmarkt-Analyst	Kapitalmarkt-Analyst
Kardiologe	Kardiologe
Kardiologie-Stipendiat	Kardiologie-Stipendiat
Kardiotechniker	Kardiotechniker
Kassenbeamter	Kassenbeamter
Kassierer	Kassierer
Kassiererin	Kassiererin
Katalogisierer	Katalogisierer
Kellner	Kellner
Kernnetzwerk-Manager	Kernnetzwerk-Manager
Kernnetzwerktechniker	Kernnetzwerktechniker
Kerntechniker	Kerntechniker
Keyboardist	Keyboardist
Kieferorthopäde	Kieferorthopäde
Kinderarzt	Kinderarzt
Kinderbetreuerin	Kinderbetreuerin
Kinderbetreuungs-Assistentin	Kinderbetreuungs-Assistentin
Kindergarten-Assistentin	Kindergarten-Assistentin
Kindergärtnerin	Kindergärtnerin
Kinesiologie-Ausbilder	Kinesiologie-Ausbilder
Klassenzimmer-Assistent	Klassenzimmer-Assistent
Klassenzimmer-Lehrerin	Klassenzimmer-Lehrerin
Klaviertechniker	Klaviertechniker
Kleiderschrank-Stylist	Kleiderschrank-Stylist
Klempner-Konstrukteur	Klempner-Konstrukteur
Klempnermeister	Klempnermeister
Klinik-Supervisor	Klinik-Supervisor
Klinische_Liaison	Klinische Liaison
Klinische_Sozialarbeiterin	Klinische Sozialarbeiterin
Klinischer_Apotheker	Klinischer Apotheker
Klinischer_Ausbilder	Klinischer Ausbilder
Klinischer_Berater	Klinischer Berater
Klinischer_Betreuer	Klinischer Betreuer
Klinischer_Psychologe	Klinischer Psychologe
Klinischer_Techniker	Klinischer Techniker
Klinischer_Therapeut	Klinischer Therapeut
Klinischer_außerordentlicher_Professor	Klinischer außerordentlicher Professor
Klinisches_Personal_Apotheker	Klinisches Personal Apotheker
Koch	Koch
Koch_der_Linie	Koch der Linie
Kochlehrer	Kochlehrer
Kolumnist	Kolumnist
Kommanditist	Kommanditist
Kommerzieller_Analyst	Kommerzieller Analyst
Kommerzieller_Aufseher	Kommerzieller Aufseher
Kommerzieller_Immobilienmakler	Kommerzieller Immobilienmakler
Kommerzieller_Koordinator	Kommerzieller Koordinator
Kommerzieller_Linienproduzent	Kommerzieller Linienproduzent
Kommerzieller_Pilot	Kommerzieller Pilot
Kommerzieller_Produzent	Kommerzieller Produzent
Kommerzieller_Versicherungsagent	Kommerzieller Versicherungsagent
Kommerzieller_Versicherungsmakler	Kommerzieller Versicherungsmakler
Kommunaltechniker	Kommunaltechniker
Kommunikations-Koordinator	Kommunikations-Koordinator
Kommunikationsberater	Kommunikationsberater
Kommunikationsdesigner	Kommunikationsdesigner
Kommunikationsexperte	Kommunikationsexperte
Kommunikationstechniker	Kommunikationstechniker
Komponist	Komponist
Konditor	Konditor
Konditorei-Assistent	Konditorei-Assistent
Konditormeister	Konditormeister
Konferenz-Assistentin	Konferenz-Assistentin
Konferenz-Manager	Konferenz-Manager
Konferenz-Planer	Konferenz-Planer
Konfigurationstechniker	Konfigurationstechniker
Konstrukteur	Konstrukteur
Konstrukteur_Fertigung	Konstrukteur Fertigung
Konstruktions-Freigabetechniker	Konstruktions-Freigabetechniker
Konto-Direktor	Konto-Direktor
Konto-Planer	Konto-Planer
Konto-Stratege	Konto-Stratege
Konto-Supervisor	Konto-Supervisor
Konzept-Designer	Konzept-Designer
Konzept-Entwickler	Konzept-Entwickler
Konzept-Künstler	Konzept-Künstler
Koordinator_der_Galerie	Koordinator der Galerie
Koordinator_der_Gästeservices	Koordinator der Gästeservices
Koordinator_der_Konferenzdienste	Koordinator der Konferenzdienste
Koordinator_der_Veranstaltung	Koordinator der Veranstaltung
Koordinator_des_Graduiertenprogramms	Koordinator des Graduiertenprogramms
Koordinator_des_Kongresses	Koordinator des Kongresses
Koordinator_für_Automatisierung	Koordinator für Automatisierung
Koordinator_für_Druckproduktion	Koordinator für Druckproduktion
Koordinator_für_Druckvorstufe	Koordinator für Druckvorstufe
Koordinator_für_Fondsentwicklung	Koordinator für Fondsentwicklung
Koordinator_für_Forschungsstudien	Koordinator für Forschungsstudien
Koordinator_für_Gastbeziehungen	Koordinator für Gastbeziehungen
Koordinator_für_Geberbeziehungen	Koordinator für Geberbeziehungen
Koordinator_für_Gehaltsabrechnung_und_Sozialleistungen	Koordinator für Gehaltsabrechnung und Sozialleistungen
Koordinator_für_Geldbeschaffung	Koordinator für Geldbeschaffung
Koordinator_für_Grafikdesign	Koordinator für Grafikdesign
Koordinator_für_Gruppenreservierungen	Koordinator für Gruppenreservierungen
Koordinator_für_Handelsmarketing	Koordinator für Handelsmarketing
Koordinator_für_Hochzeiten	Koordinator für Hochzeiten
Koordinator_für_Hypothekenkredite	Koordinator für Hypothekenkredite
Koordinator_für_Klinische_Forschung	Koordinator für Klinische Forschung
Koordinator_für_Konferenzen_und_Veranstaltungen	Koordinator für Konferenzen und Veranstaltungen
Koordinator_für_Leistungsverbesserung	Koordinator für Leistungsverbesserung
Koordinator_für_Marketing_und_Kommunikation	Koordinator für Marketing und Kommunikation
Koordinator_für_Marketing-Dienstleistungen	Koordinator für Marketing-Dienstleistungen
Koordinator_für_Notfallmanagement	Koordinator für Notfallmanagement
Koordinator_für_Partnerschaften	Koordinator für Partnerschaften
Koordinator_für_Postproduktion	Koordinator für Postproduktion
Koordinator_für_Preisgestaltung	Koordinator für Preisgestaltung
Koordinator_für_Reservierungen	Koordinator für Reservierungen
Koordinator_für_Studentenpraktika	Koordinator für Studentenpraktika
Koordinator_für_Telekommunikation	Koordinator für Telekommunikation
Koordinator_für_Vergütungen_und_Leistungen	Koordinator für Vergütungen und Leistungen
Koordinator_für_Versand_und_Empfang	Koordinator für Versand und Empfang
Koordinator_für_Veröffentlichungen	Koordinator für Veröffentlichungen
Koordinator_für_Werbeproduktion	Koordinator für Werbeproduktion
Koordinator_für_Werbung	Koordinator für Werbung
Koordinator_für_das_Gastgewerbe	Koordinator für das Gastgewerbe
Koordinator_für_den_Übergang	Koordinator für den Übergang
Koordinator_für_interne_Kommunikation	Koordinator für interne Kommunikation
Koordinator_für_technische_Unterstützung	Koordinator für technische Unterstützung
Koordinator_für_Öffentlichkeitsarbeit	Koordinator für Öffentlichkeitsarbeit
Koordinator_für_Übersetzung	Koordinator für Übersetzung
Koordinatorin_der_Kunstabteilung	Koordinatorin der Kunstabteilung
Koordinatorin_für_Mode	Koordinatorin für Mode
Koordinatorin_für_Unternehmenskommunikation	Koordinatorin für Unternehmenskommunikation
Koordinatorin_für_Öffentlichkeitsarbeit_und_Kommunikation	Koordinatorin für Öffentlichkeitsarbeit und Kommunikation
Kopie_Direktor	Kopie Direktor
Kopie-Supervisor	Kopie-Supervisor
Kopier-Manager	Kopier-Manager
Korps-Mitglied	Korps-Mitglied
Korrekturleser	Korrekturleser
Kosmetologe	Kosmetologe
Kosten-Manager	Kosten-Manager
Kraft-_und_Konditionstrainer	Kraft- und Konditionstrainer
Krankenhaus-Direktor	Krankenhaus-Direktor
Krankenschwester	Krankenschwester
Krankenschwester_Practitioner	Krankenschwester Practitioner
Krankenschwester_für_Erwachsene	Krankenschwester für Erwachsene
Krankenschwester_für_öffentliche_Gesundheit	Krankenschwester für öffentliche Gesundheit
Kreativ-Manager	Kreativ-Manager
Kreative_Dienstleistungen_Intern	Kreative Dienstleistungen Intern
Kreative_Führung	Kreative Führung
Kreative_Kunstschaffende	Kreative Kunstschaffende
Kreativer_Entwickler	Kreativer Entwickler
Kreativer_Grafiker	Kreativer Grafiker
Kreativer_Praktikant	Kreativer Praktikant
Kreativer_Produzent	Kreativer Produzent
Kreativer_Projektleiter	Kreativer Projektleiter
Kreativer_Schriftsteller	Kreativer Schriftsteller
Kreativer_Werbetexter	Kreativer Werbetexter
Kredit-Analyst	Kredit-Analyst
Kreditbeauftragter	Kreditbeauftragter
Kreditexperte	Kreditexperte
Kreditorenbuchhaltung_Administrator	Kreditorenbuchhaltung Administrator
Kreditsachbearbeiter	Kreditsachbearbeiter
Kreditüberwacher	Kreditüberwacher
Kriminalpolizeilicher_Ermittler	Kriminalpolizeilicher Ermittler
Kräuterkunde	Kräuterkunde
Kulinarischer_Ausbilder	Kulinarischer Ausbilder
Kulinarischer_Leiter	Kulinarischer Leiter
Kunden-Buchhalter	Kunden-Buchhalter
Kundenbetreuer	Kundenbetreuer
Kundenbetreuer_für_Personalbeschaffung	Kundenbetreuer für Personalbeschaffung
Kundenbetreuer_für_Werbung	Kundenbetreuer für Werbung
Kundenbetreuer_für_den_Mittelstand	Kundenbetreuer für den Mittelstand
Kundendienst_an_der_Kasse	Kundendienst an der Kasse
Kundendienstexperte	Kundendienstexperte
Kundendiensttechniker	Kundendiensttechniker
Kundenseitiger_Entwickler	Kundenseitiger Entwickler
Kundenservice-Vertreter	Kundenservice-Vertreter
Kunst-Berater	Kunst-Berater
Kunstexperte	Kunstexperte
Kunstfotograf	Kunstfotograf
Kunsthandwerker	Kunsthandwerker
Kunsthändler	Kunsthändler
Kunstkritiker	Kunstkritiker
Kunstschaffende	Kunstschaffende
Kunsttherapeut	Kunsttherapeut
Kurator	Kurator
Kuratorin_der_Ausstellung	Kuratorin der Ausstellung
Körperschaftsteuerberater	Körperschaftsteuerberater
Küchenassistent	Küchenassistent
Küchenaufseher	Küchenaufseher
Küchenleiter	Küchenleiter
Küchenpersonal	Küchenpersonal
Künstler_für_grafische_Produktion	Künstler für grafische Produktion
Künstler_für_visuelle_Effekte	Künstler für visuelle Effekte
Künstlerin	Künstlerin
Künstlerin_für_visuelle_Entwicklung	Künstlerin für visuelle Entwicklung
Künstlerischer_Leiter	Künstlerischer Leiter
Lader	Lader
Lager_Operativ	Lager Operativ
Lager-_und_Logistikmanager	Lager- und Logistikmanager
Lager-_und_Vertriebsleiter	Lager- und Vertriebsleiter
Lager-Betriebsleiter	Lager-Betriebsleiter
Lager-Teamleiter	Lager-Teamleiter
Lagerbetreiber	Lagerbetreiber
Lagerexperte	Lagerexperte
Lagerhaus-Assistent	Lagerhaus-Assistent
Lagerist	Lagerist
Lagerstättengeologe	Lagerstättengeologe
Lagerverwalter	Lagerverwalter
Landesvertreter	Landesvertreter
Landschaftsarchitektin	Landschaftsarchitektin
Landschaftsgestalter	Landschaftsgestalter
Landwirtschaftstechniker	Landwirtschaftstechniker
Layout-Designer	Layout-Designer
Layout-Konstrukteur	Layout-Konstrukteur
Layout-Künstler	Layout-Künstler
Layouttechniker	Layouttechniker
Lebensmittel_&_Getränke_Intern	Lebensmittel & Getränke Intern
Lebensmittel-Sachbearbeiter	Lebensmittel-Sachbearbeiter
Lebensmittel-Server	Lebensmittel-Server
Lebensmittel-Wissenschaftler	Lebensmittel-Wissenschaftler
Lebensmitteltechniker	Lebensmitteltechniker
Lehramtsstudent	Lehramtsstudent
Lehrassistent	Lehrassistent
Lehrassistentin_für_Sonderpädagogik	Lehrassistentin für Sonderpädagogik
Lehrer	Lehrer
Lehrer_bereitstellen	Lehrer bereitstellen
Lehrer_der_Mittelstufe	Lehrer der Mittelstufe
Lehrer_der_Sommerschule	Lehrer der Sommerschule
Lehrer_einer_öffentlichen_Schule	Lehrer einer öffentlichen Schule
Lehrer_für_Grundschulbildung	Lehrer für Grundschulbildung
Lehrer_für_Sonderpädagogik	Lehrer für Sonderpädagogik
Lehrer_für_Wirtschaftspädagogik	Lehrer für Wirtschaftspädagogik
Lehrer-Begleitung	Lehrer-Begleitung
Lehrerin_Englisch_Fremdsprache	Lehrerin Englisch Fremdsprache
Lehrerin_für_Kinderbetreuung	Lehrerin für Kinderbetreuung
Lehrkraft_für_Lernunterstützung	Lehrkraft für Lernunterstützung
Lehrtrainer	Lehrtrainer
Leistungstrainer	Leistungstrainer
Leitender_Ausbilder	Leitender Ausbilder
Leitender_Bautechniker	Leitender Bautechniker
Leitender_Bibliothekar	Leitender Bibliothekar
Leitender_Elektrotechniker	Leitender Elektrotechniker
Leitender_Geologe	Leitender Geologe
Leitender_Geschäftsführer	Leitender Geschäftsführer
Leitender_Hardwaretechniker	Leitender Hardwaretechniker
Leitender_Konditormeister	Leitender Konditormeister
Leitender_Konstrukteur	Leitender Konstrukteur
Leitender_Kreativdirektor	Leitender Kreativdirektor
Leitender_Kreditreferent	Leitender Kreditreferent
Leitender_Landschaftsarchitekt	Leitender Landschaftsarchitekt
Leitender_Maschinenbautechniker	Leitender Maschinenbautechniker
Leitender_Operationsbeamter	Leitender Operationsbeamter
Leitender_Rechtsberater	Leitender Rechtsberater
Leitender_Redakteur	Leitender Redakteur
Leitender_Redaktionsleiter	Leitender Redaktionsleiter
Leitender_Sicherheitstechniker	Leitender Sicherheitstechniker
Leitender_Softwaretechniker	Leitender Softwaretechniker
Leitender_Zahnarzthelfer	Leitender Zahnarzthelfer
Leitender_künstlerischer_Leiter	Leitender künstlerischer Leiter
Leitender_medizinischer_Offizier	Leitender medizinischer Offizier
Leitender_Ärztlicher_Direktor	Leitender Ärztlicher Direktor
Leiter_Business_Development	Leiter Business Development
Leiter_Digitales_Marketing	Leiter Digitales Marketing
Leiter_Elektrotechnik	Leiter Elektrotechnik
Leiter_Externe_Kommunikation	Leiter Externe Kommunikation
Leiter_Food_Service	Leiter Food Service
Leiter_Fotografie	Leiter Fotografie
Leiter_Hypothekenverkauf	Leiter Hypothekenverkauf
Leiter_Internationale_Logistik	Leiter Internationale Logistik
Leiter_Klinische_Apotheke	Leiter Klinische Apotheke
Leiter_Legal_&_Company_Secretary	Leiter Legal & Company Secretary
Leiter_Logistik	Leiter Logistik
Leiter_Physikalischer_Entwurf	Leiter Physikalischer Entwurf
Leiter_Private_Banking	Leiter Private Banking
Leiter_Strategische_Planung	Leiter Strategische Planung
Leiter_Unternehmenssteuer	Leiter Unternehmenssteuer
Leiter_Vertrieb_&_Handel	Leiter Vertrieb & Handel
Leiter_Werbung	Leiter Werbung
Leiter_der_Abteilung_Digitale_Medien	Leiter der Abteilung Digitale Medien
Leiter_der_Abteilung_Immobilien	Leiter der Abteilung Immobilien
Leiter_der_Abteilung_Investitionen	Leiter der Abteilung Investitionen
Leiter_der_Abteilung_Logistik	Leiter der Abteilung Logistik
Leiter_der_Abteilung_Politik	Leiter der Abteilung Politik
Leiter_der_Abteilung_Resourcing	Leiter der Abteilung Resourcing
Leiter_der_Abteilung_Strategische_Entwicklung	Leiter der Abteilung Strategische Entwicklung
Leiter_der_Abteilung_Strukturierte_Finanzierung	Leiter der Abteilung Strukturierte Finanzierung
Leiter_der_Abteilung_Telekommunikation	Leiter der Abteilung Telekommunikation
Leiter_der_Abteilung_Unternehmensfinanzen	Leiter der Abteilung Unternehmensfinanzen
Leiter_der_Abteilung_Vermögensverwaltung	Leiter der Abteilung Vermögensverwaltung
Leiter_der_Abteilung_für_Öffentlichkeitsarbeit	Leiter der Abteilung für Öffentlichkeitsarbeit
Leiter_der_Agentur	Leiter der Agentur
Leiter_der_Aktienforschung	Leiter der Aktienforschung
Leiter_der_Designabteilung	Leiter der Designabteilung
Leiter_der_Distribution	Leiter der Distribution
Leiter_der_Dokumentation	Leiter der Dokumentation
Leiter_der_Druckproduktion	Leiter der Druckproduktion
Leiter_der_Elektroabteilung	Leiter der Elektroabteilung
Leiter_der_Finanzinstitutionen	Leiter der Finanzinstitutionen
Leiter_der_Gehaltsabrechnung	Leiter der Gehaltsabrechnung
Leiter_der_Gästebetreuung	Leiter der Gästebetreuung
Leiter_der_Handelsabteilung	Leiter der Handelsabteilung
Leiter_der_Katastrophenhilfe	Leiter der Katastrophenhilfe
Leiter_der_Kopie	Leiter der Kopie
Leiter_der_Kunstabteilung	Leiter der Kunstabteilung
Leiter_der_Logistik	Leiter der Logistik
Leiter_der_Logistikabteilung	Leiter der Logistikabteilung
Leiter_der_Mediengruppe	Leiter der Mediengruppe
Leiter_der_Netzwerkoperationen	Leiter der Netzwerkoperationen
Leiter_der_Personalbeschaffung	Leiter der Personalbeschaffung
Leiter_der_Postproduktion	Leiter der Postproduktion
Leiter_der_Produktionseinheit	Leiter der Produktionseinheit
Leiter_der_Projektfinanzierung	Leiter der Projektfinanzierung
Leiter_der_Projektkoordination	Leiter der Projektkoordination
Leiter_der_Rechtsabteilung	Leiter der Rechtsabteilung
Leiter_der_Redaktion	Leiter der Redaktion
Leiter_der_Rezeption	Leiter der Rezeption
Leiter_der_Standortakquisition	Leiter der Standortakquisition
Leiter_der_Stiftung	Leiter der Stiftung
Leiter_der_Streckenentwicklung	Leiter der Streckenentwicklung
Leiter_der_Unternehmenslogistik	Leiter der Unternehmenslogistik
Leiter_der_Vermögensverwaltung	Leiter der Vermögensverwaltung
Leiter_der_Versicherungsabteilung	Leiter der Versicherungsabteilung
Leiter_der_Videoproduktion	Leiter der Videoproduktion
Leiter_der_Web-Entwicklung	Leiter der Web-Entwicklung
Leiter_der_redaktionellen_Produktion	Leiter der redaktionellen Produktion
Leiter_des_Anwendungsentwicklungsteams	Leiter des Anwendungsentwicklungsteams
Leiter_des_Automatisierungsteams	Leiter des Automatisierungsteams
Leiter_des_Bodenbetriebs	Leiter des Bodenbetriebs
Leiter_des_Desktop-Unterstützungsteams	Leiter des Desktop-Unterstützungsteams
Leiter_des_Einsatzteams	Leiter des Einsatzteams
Leiter_des_Firmenkundengeschäfts	Leiter des Firmenkundengeschäfts
Leiter_des_HR	Leiter des HR
Leiter_des_Hardware-Teams	Leiter des Hardware-Teams
Leiter_des_Inhalts	Leiter des Inhalts
Leiter_des_Konstruktionszentrums	Leiter des Konstruktionszentrums
Leiter_des_Kundenmanagements	Leiter des Kundenmanagements
Leiter_des_Logistik-Teams	Leiter des Logistik-Teams
Leiter_des_Logistikzentrums	Leiter des Logistikzentrums
Leiter_des_Maklerteams	Leiter des Maklerteams
Leiter_des_Middle_Office	Leiter des Middle Office
Leiter_des_Rekrutierungsteams	Leiter des Rekrutierungsteams
Leiter_des_Service-Desk-Teams	Leiter des Service-Desk-Teams
Leiter_des_Servicezentrums	Leiter des Servicezentrums
Leiter_des_Talentmanagements	Leiter des Talentmanagements
Leiter_des_Telekommunikationsteams	Leiter des Telekommunikationsteams
Leiter_des_Verlagswesens	Leiter des Verlagswesens
Leiter_des_Web-Entwicklungsteams	Leiter des Web-Entwicklungsteams
Leiter_des_technischen_Unterstützungsteams	Leiter des technischen Unterstützungsteams
Leiter_Öffentlichkeitsarbeit	Leiter Öffentlichkeitsarbeit
Leiterin_Globale_Kommunikation	Leiterin Globale Kommunikation
Leiterin_Kommunikation	Leiterin Kommunikation
Leiterin_Marketing_&_Kommunikation	Leiterin Marketing & Kommunikation
Leiterin_Medien_&_Kommunikation	Leiterin Medien & Kommunikation
Leiterin_Werbung	Leiterin Werbung
Leiterin_der_Agentur	Leiterin der Agentur
Leiterin_der_Geldbeschaffung	Leiterin der Geldbeschaffung
Leiterin_der_Öffentlichkeitsarbeit	Leiterin der Öffentlichkeitsarbeit
Leitung_Kommunikation	Leitung Kommunikation
Leitung_der_Talentakquise	Leitung der Talentakquise
Leitung_des_Konstruktionsteams	Leitung des Konstruktionsteams
Lese-Coach	Lese-Coach
Lese-Tutor	Lese-Tutor
Leseexperte	Leseexperte
Lesender_Lehrer	Lesender Lehrer
Leutnant	Leutnant
Linguist	Linguist
Linien-Pilot	Linien-Pilot
Linien-Produzent	Linien-Produzent
Linienchef	Linienchef
Lizenzierte_praktische_Krankenschwester	Lizenzierte praktische Krankenschwester
Lizenzierter_Akupunkteur	Lizenzierter Akupunkteur
Lizenzierter_Berater_für_psychische_Gesundheit	Lizenzierter Berater für psychische Gesundheit
Lizenzierter_Berufsberater	Lizenzierter Berufsberater
Lizenzierter_Ehe-_und_Familientherapeut	Lizenzierter Ehe- und Familientherapeut
Lizenzierter_Hypothekenmakler	Lizenzierter Hypothekenmakler
Lizenzierter_Immobilien-Fachmann	Lizenzierter Immobilien-Fachmann
Lizenzierter_Immobilienmakler	Lizenzierter Immobilienmakler
Lizenzierter_Klinischer_Psychologe	Lizenzierter Klinischer Psychologe
Lizenzierter_Psychologe	Lizenzierter Psychologe
Lizenzierter_Verkaufsagent	Lizenzierter Verkaufsagent
Lizenzierter_Versicherungsagent	Lizenzierter Versicherungsagent
Lizenzierter_assoziierter_Immobilienmakler	Lizenzierter assoziierter Immobilienmakler
Lizenzierter_klinischer_Fachberater	Lizenzierter klinischer Fachberater
Lizenzierter_klinischer_Sozialarbeiter	Lizenzierter klinischer Sozialarbeiter
Lobpreis-Direktor	Lobpreis-Direktor
Logistik	Logistik
Logistik-Administrator	Logistik-Administrator
Logistik-Agent	Logistik-Agent
Logistik-Analytiker	Logistik-Analytiker
Logistik-Assistentin	Logistik-Assistentin
Logistik-Berater	Logistik-Berater
Logistik-Controller	Logistik-Controller
Logistik-Experte	Logistik-Experte
Logistik-Koordinator	Logistik-Koordinator
Logistik-Kundenbetreuer	Logistik-Kundenbetreuer
Logistik-Mitarbeiter	Logistik-Mitarbeiter
Logistik-Planer	Logistik-Planer
Logistik-Supervisor	Logistik-Supervisor
Logistiker	Logistiker
Logistiktechniker	Logistiktechniker
Lohnbuchhalter	Lohnbuchhalter
Lohnsteuer-Buchhalter	Lohnsteuer-Buchhalter
Lokaler_Verkaufsassistent	Lokaler Verkaufsassistent
Lokaler_Verkaufsleiter	Lokaler Verkaufsleiter
Lokalisierungsexperte	Lokalisierungsexperte
Luftfahrttechniker	Luftfahrttechniker
Ländliches_Transportunternehmen	Ländliches Transportunternehmen
Lösungsentwickler	Lösungsentwickler
MBA-Absolvent	MBA-Absolvent
MBA-Kandidat	MBA-Kandidat
MBA-Teilnehmer	MBA-Teilnehmer
Mail-Prozessor	Mail-Prozessor
Major_im_Ruhestand	Major im Ruhestand
Makler	Makler
Makler_für_Aktienderivate	Makler für Aktienderivate
Makler_für_Wohnimmobilien	Makler für Wohnimmobilien
Makler-Assistent	Makler-Assistent
Makler-Vertriebsmitarbeiter	Makler-Vertriebsmitarbeiter
Malerin	Malerin
Manager_Erweiterte_Dienstleistungen	Manager Erweiterte Dienstleistungen
Manager_Netzwerkbetrieb	Manager Netzwerkbetrieb
Manager_Netzwerktechnik	Manager Netzwerktechnik
Manager_Talentakquise	Manager Talentakquise
Manager_anzeigen	Manager anzeigen
Manager_des_Konferenzzentrums	Manager des Konferenzzentrums
Manager_des_Lokalisierungsprogramms	Manager des Lokalisierungsprogramms
Manager_für_Akquisitionsmarketing	Manager für Akquisitionsmarketing
Manager_für_Betrieb_und_Logistik	Manager für Betrieb und Logistik
Manager_für_Einzelspenden	Manager für Einzelspenden
Manager_für_Geberbeziehungen	Manager für Geberbeziehungen
Manager_für_Geldbeschaffung	Manager für Geldbeschaffung
Manager_für_Geschäftsreisen	Manager für Geschäftsreisen
Manager_für_Großgeschenke	Manager für Großgeschenke
Manager_für_Inhaltsmarketing	Manager für Inhaltsmarketing
Manager_für_Investitionsoperationen	Manager für Investitionsoperationen
Manager_für_Konferenzdienste	Manager für Konferenzdienste
Manager_für_Lebensmittelsicherheit	Manager für Lebensmittelsicherheit
Manager_für_Markendesign	Manager für Markendesign
Manager_für_Online-Werbung	Manager für Online-Werbung
Manager_für_Personalbeschaffung	Manager für Personalbeschaffung
Manager_für_Presse-_und_Öffentlichkeitsarbeit	Manager für Presse- und Öffentlichkeitsarbeit
Manager_für_Rechtsstreitigkeiten	Manager für Rechtsstreitigkeiten
Manager_für_Rekrutierung_&_Auswahl	Manager für Rekrutierung & Auswahl
Manager_für_Rekrutierung_und_Ausbildung	Manager für Rekrutierung und Ausbildung
Manager_für_Ressourcenbeschaffung	Manager für Ressourcenbeschaffung
Manager_für_Steuerkonformität	Manager für Steuerkonformität
Manager_für_Talentakquise	Manager für Talentakquise
Manager_für_Versand_und_Empfang	Manager für Versand und Empfang
Manager_für_Veröffentlichungen	Manager für Veröffentlichungen
Manager_für_das_Gastgewerbe	Manager für das Gastgewerbe
Manager_für_die_Bauvorbereitung	Manager für die Bauvorbereitung
Manager_für_die_Einstellung_von_Hochschulabsolventen	Manager für die Einstellung von Hochschulabsolventen
Manager_für_drahtlose_Produkte	Manager für drahtlose Produkte
Manager_für_globale_Öffentlichkeitsarbeit	Manager für globale Öffentlichkeitsarbeit
Manager_für_grafische_Dienste	Manager für grafische Dienste
Manager_für_jährliche_Spenden	Manager für jährliche Spenden
Manager_für_klassifizierte_Werbung	Manager für klassifizierte Werbung
Manager_für_kreative_Dienstleistungen	Manager für kreative Dienstleistungen
Manager_für_kreatives_Gestalten	Manager für kreatives Gestalten
Manager_für_mechanische_Konstruktion	Manager für mechanische Konstruktion
Manager_für_medizinische_Informationen	Manager für medizinische Informationen
Manager_für_soziale_Medien	Manager für soziale Medien
Manager_für_strategische_Planung	Manager für strategische Planung
Manager_für_Öffentlichkeitsarbeit	Manager für Öffentlichkeitsarbeit
Manager_für_öffentliche_Politik	Manager für öffentliche Politik
Managerin_für_internationale_Öffentlichkeitsarbeit	Managerin für internationale Öffentlichkeitsarbeit
Mandant_Anwalt	Mandant Anwalt
Manikürist	Manikürist
Marine-Berater	Marine-Berater
Marine-Betriebsleiter	Marine-Betriebsleiter
Marine-Superintendent	Marine-Superintendent
Marineoffizier	Marineoffizier
Maritimer_Offizier	Maritimer Offizier
Marken-Analyst	Marken-Analyst
Marken-Planer	Marken-Planer
Markendesigner	Markendesigner
Marketing-Analyst	Marketing-Analyst
Marketing-Beauftragter	Marketing-Beauftragter
Marketing-Berater	Marketing-Berater
Marketing-Stratege	Marketing-Stratege
Marketing-Texter	Marketing-Texter
Markt-Reporter	Markt-Reporter
Marktdaten-Analyst	Marktdaten-Analyst
Marktforschungsanalyst	Marktforschungsanalyst
Marktrisiko-Manager	Marktrisiko-Manager
Maschinenbautechniker	Maschinenbautechniker
Maschinenkonstrukteur	Maschinenkonstrukteur
Master_Control_Bediener	Master Control Bediener
Master-Steuerberater	Master-Steuerberater
Material-Handhaber	Material-Handhaber
Mathematiklehrer_der_Mittelstufe	Mathematiklehrer der Mittelstufe
Mathematiklehrer_für_die_Oberschule	Mathematiklehrer für die Oberschule
Mechanik-Experte	Mechanik-Experte
Mechanischer_Konstrukteur	Mechanischer Konstrukteur
Mechanischer_Projekttechniker	Mechanischer Projekttechniker
Mechanischer_Zeichner	Mechanischer Zeichner
Medien-Exekutive	Medien-Exekutive
Medien-Manager	Medien-Manager
Medien-Supervisor	Medien-Supervisor
Medienbibliothekar	Medienbibliothekar
Medienexperte_der_Bibliothek	Medienexperte der Bibliothek
Medienexperte_der_Schulbibliothek	Medienexperte der Schulbibliothek
Medienmitarbeiter	Medienmitarbeiter
Medienplaner	Medienplaner
Medienstratege	Medienstratege
Medientechniker	Medientechniker
Medienwissenschaftlerin	Medienwissenschaftlerin
Medizinischer_Illustrator	Medizinischer Illustrator
Medizinischer_Notfalltechniker	Medizinischer Notfalltechniker
Medizinischer_Praktikant	Medizinischer Praktikant
Medizinischer_Rekrutierer	Medizinischer Rekrutierer
Medizinischer_Techniker	Medizinischer Techniker
Meister-Stylist	Meister-Stylist
Metallurgietechniker	Metallurgietechniker
Metro-Redakteur	Metro-Redakteur
Microsoft-Systemadministrator	Microsoft-Systemadministrator
Microsoft-Systemtechniker	Microsoft-Systemtechniker
Mineralöltechniker	Mineralöltechniker
Mitarbeiter	Mitarbeiter
Mitarbeiter_Anwalt	Mitarbeiter Anwalt
Mitarbeiter_Forschungstechniker	Mitarbeiter Forschungstechniker
Mitarbeiter_Steuerberater	Mitarbeiter Steuerberater
Mitarbeiter_Technischer_Programm-Manager	Mitarbeiter Technischer Programm-Manager
Mitarbeiter_Technischer_Support_Techniker	Mitarbeiter Technischer Support Techniker
Mitarbeiter_Technologe	Mitarbeiter Technologe
Mitarbeiter_für_Bewertung	Mitarbeiter für Bewertung
Mitarbeiter_für_Kundenbeziehungen	Mitarbeiter für Kundenbeziehungen
Mitarbeiter_für_technische_Unterstützung	Mitarbeiter für technische Unterstützung
Mitarbeiter_im_Einzelhandel	Mitarbeiter im Einzelhandel
Mitarbeiter_im_Finanzministerium	Mitarbeiter im Finanzministerium
Mitarbeiter_im_Gästeservice	Mitarbeiter im Gästeservice
Mitarbeiter_in_der_Gastronomie	Mitarbeiter in der Gastronomie
Mitarbeiter_in_der_Produktentwicklung	Mitarbeiter in der Produktentwicklung
Mitarbeiter-Informationssystem-Analyst	Mitarbeiter-Informationssystem-Analyst
Mitarbeiterin_Buchhaltung	Mitarbeiterin Buchhaltung
Mitarbeiterin_für_Finanzdienstleistungen	Mitarbeiterin für Finanzdienstleistungen
Mitarbeiterin_für_Geschäftsentwicklung	Mitarbeiterin für Geschäftsentwicklung
Mitarbeiterin_für_Investor_Relations	Mitarbeiterin für Investor Relations
Mitarbeiterin_für_Marketing_&_Kommunikation	Mitarbeiterin für Marketing & Kommunikation
Mitarbeiterin_für_Medienarbeit	Mitarbeiterin für Medienarbeit
Mitarbeiterin_für_Mitgliederdienste	Mitarbeiterin für Mitgliederdienste
Mitarbeiterin_für_Rekrutierung	Mitarbeiterin für Rekrutierung
Mitarbeiterin_für_Risikomanagement	Mitarbeiterin für Risikomanagement
Mitarbeiterin_für_Unternehmensentwicklung	Mitarbeiterin für Unternehmensentwicklung
Mitarbeiterin_für_Unternehmenskommunikation	Mitarbeiterin für Unternehmenskommunikation
Mitarbeiterin_für_Öffentlichkeitsarbeit	Mitarbeiterin für Öffentlichkeitsarbeit
Mitarbeiterin_im_Front_Office	Mitarbeiterin im Front Office
Mitglied_des_Beratergremiums	Mitglied des Beratergremiums
Mitglied_des_Verkaufsteams	Mitglied des Verkaufsteams
Mitglied_des_technischen_Personals	Mitglied des technischen Personals
Mittlerer_Offizier	Mittlerer Offizier
Mixed-Signal-Designtechniker	Mixed-Signal-Designtechniker
Mixologe	Mixologe
Mobiler_Techniker	Mobiler Techniker
Mode-Assistentin	Mode-Assistentin
Mode-Berater	Mode-Berater
Mode-Stylist	Mode-Stylist
Modedesignerin	Modedesignerin
Modefotograf	Modefotograf
Modellierer	Modellierer
Moderator_der_Gruppe	Moderator der Gruppe
Moderator_der_Morgenshow	Moderator der Morgenshow
Modul-Leitung	Modul-Leitung
Morgensendung_Co-Moderator	Morgensendung Co-Moderator
Multimedia-Designer	Multimedia-Designer
Multimedia-Journalist	Multimedia-Journalist
Multimedia-Praktikant	Multimedia-Praktikant
Multimedia-Produzent	Multimedia-Produzent
Multimedia-Programmierer	Multimedia-Programmierer
Mund-,_Kiefer-_und_Gesichtschirurg	Mund-, Kiefer- und Gesichtschirurg
Muralist	Muralist
Musik-Berater	Musik-Berater
Musik-Komponist	Musik-Komponist
Musik-Praktikant	Musik-Praktikant
Musikalischer_Leiter	Musikalischer Leiter
Musiker	Musiker
Musikfachmann	Musikfachmann
Musiklehrer	Musiklehrer
Musikproduzent	Musikproduzent
Nachrichten_Operations_Manager	Nachrichten Operations Manager
Nachrichten-Produzent	Nachrichten-Produzent
Nachrichten-Reporter	Nachrichten-Reporter
Nacht-Auditor	Nacht-Auditor
Nacht-Manager	Nacht-Manager
Nationaler_Experte	Nationaler Experte
Nationaler_HR-Manager	Nationaler HR-Manager
Nationaler_Korrespondent	Nationaler Korrespondent
Nationaler_Logistik-Manager	Nationaler Logistik-Manager
Nationaler_Rekrutierer	Nationaler Rekrutierer
Neonatologe	Neonatologe
Netzwerk-Analytiker	Netzwerk-Analytiker
Netzwerk-Architekt	Netzwerk-Architekt
Netzwerk-Beauftragter	Netzwerk-Beauftragter
Netzwerk-Berater	Netzwerk-Berater
Netzwerk-Bereitsteller	Netzwerk-Bereitsteller
Netzwerk-Design-Manager	Netzwerk-Design-Manager
Netzwerk-Designer	Netzwerk-Designer
Netzwerk-Designtechniker	Netzwerk-Designtechniker
Netzwerk-Implementierungs-Manager	Netzwerk-Implementierungs-Manager
Netzwerk-Infrastruktur-Manager	Netzwerk-Infrastruktur-Manager
Netzwerk-Infrastrukturtechniker	Netzwerk-Infrastrukturtechniker
Netzwerk-Integrator	Netzwerk-Integrator
Netzwerk-Performancetechniker	Netzwerk-Performancetechniker
Netzwerk-Planungstechniker	Netzwerk-Planungstechniker
Netzwerk-Support-Analyst	Netzwerk-Support-Analyst
Netzwerk-Supporttechniker	Netzwerk-Supporttechniker
Netzwerkadministrator	Netzwerkadministrator
Netzwerkexperte	Netzwerkexperte
Netzwerksicherheits-Administrator	Netzwerksicherheits-Administrator
Netzwerksteuerungstechniker	Netzwerksteuerungstechniker
Netzwerksystemtechniker	Netzwerksystemtechniker
Netzwerktechniker	Netzwerktechniker
Neue_Heimberaterin	Neue Heimberaterin
Neuer_Hausverkaufsberater	Neuer Hausverkaufsberater
Niederlassungsleiter	Niederlassungsleiter
Notfall-Dispatcher	Notfall-Dispatcher
Notfallärztin	Notfallärztin
Nählehrer	Nählehrer
Oberkellner	Oberkellner
On_Air-Ansagerin	On Air-Ansagerin
On-Air-Persönlichkeit	On-Air-Persönlichkeit
Online-Vermarkter	Online-Vermarkter
Open-Source-Entwickler	Open-Source-Entwickler
Operations-Offizier	Operations-Offizier
Operator_für_Qualitätskontrolle	Operator für Qualitätskontrolle
Opernsänger	Opernsänger
Optionen-Händler	Optionen-Händler
Organist	Organist
Outsourcing-Manager	Outsourcing-Manager
PHP-Programmierer	PHP-Programmierer
PHP-Web-Entwickler	PHP-Web-Entwickler
Pakettechniker	Pakettechniker
Paraedukator	Paraedukator
Partner	Partner
Partner_im_Geschenkeladen	Partner im Geschenkeladen
Personal_Computer-Reparaturtechniker	Personal Computer-Reparaturtechniker
Personal-Computertechniker	Personal-Computertechniker
Personalberater	Personalberater
Personalbeschaffer	Personalbeschaffer
Personalentwickler	Personalentwickler
Personalexperte	Personalexperte
Personalleiter	Personalleiter
Personalverwalter	Personalverwalter
Personelle_Führung	Personelle Führung
Persönlicher_Assistent_des_Generaldirektors	Persönlicher Assistent des Generaldirektors
Persönlicher_Bankberater	Persönlicher Bankberater
Persönlicher_Bankenvertreter	Persönlicher Bankenvertreter
Persönlicher_Bankmanager	Persönlicher Bankmanager
Persönlicher_Chefkoch	Persönlicher Chefkoch
Persönlicher_Linienmanager	Persönlicher Linienmanager
Persönlicher_Schulungsleiter	Persönlicher Schulungsleiter
Persönlicher_Trainer	Persönlicher Trainer
Persönlicher_juristischer_Assistent	Persönlicher juristischer Assistent
Pflanzen-Metallurge	Pflanzen-Metallurge
Pflegestudent	Pflegestudent
Physikalischer_Designer	Physikalischer Designer
Physikalischer_Konstrukteur	Physikalischer Konstrukteur
Picker_bestellen	Picker bestellen
Pitching-Instruktor	Pitching-Instruktor
Planer	Planer
Planer_für_Firmenveranstaltungen	Planer für Firmenveranstaltungen
Planer_für_besondere_Ereignisse	Planer für besondere Ereignisse
Planer-Assistent	Planer-Assistent
Politikanalytiker	Politikanalytiker
Politikexperte	Politikexperte
Politischer_Koordinator	Politischer Koordinator
Politischer_Referent	Politischer Referent
Polizei-Detektiv	Polizei-Detektiv
Polizei-Inspektor	Polizei-Inspektor
Polizeibeamter	Polizeibeamter
Polizeichef	Polizeichef
Polizeihauptmann	Polizeihauptmann
Polizeileutnant	Polizeileutnant
Polizist	Polizist
Pool-Manager	Pool-Manager
Portfolio-Assistent	Portfolio-Assistent
Portfolio-Direktor	Portfolio-Direktor
Portfoliomanager	Portfoliomanager
Portfoliomanager_für_festverzinsliche_Wertpapiere	Portfoliomanager für festverzinsliche Wertpapiere
Post_Production_Supervisor	Post Production Supervisor
Post-Inspektor	Post-Inspektor
Post-Produzent	Post-Produzent
Postgraduierter_Forscher	Postgraduierter Forscher
Postmeister	Postmeister
Postproduktions-Assistent	Postproduktions-Assistent
Praktikant	Praktikant
Praktikant_Landschaftsarchitektur	Praktikant Landschaftsarchitektur
Praktikant_Maschinenbau	Praktikant Maschinenbau
Praktikant_des_Programms_Finanzmanagement	Praktikant des Programms Finanzmanagement
Praktikant_für_Aktienforschung	Praktikant für Aktienforschung
Praktikant_für_Konstruktionstechnik	Praktikant für Konstruktionstechnik
Praktikant_für_Postproduktion	Praktikant für Postproduktion
Praktikant_für_Softwaretechnik	Praktikant für Softwaretechnik
Praktikant_für_Systemtechnik	Praktikant für Systemtechnik
Praktikant_für_Unternehmensfinanzierung	Praktikant für Unternehmensfinanzierung
Praktikant_im_Bauingenieurwesen	Praktikant im Bauingenieurwesen
Praktikant_im_Bauwesen	Praktikant im Bauwesen
Praktikant_im_Front_Office	Praktikant im Front Office
Praktikant_im_Hochschulprogramm	Praktikant im Hochschulprogramm
Praktikantin_für_Design_&_Produktion	Praktikantin für Design & Produktion
Praktikantin_für_Modedesign	Praktikantin für Modedesign
Praktikantin_für_Talentakquise	Praktikantin für Talentakquise
Praktikantin_für_visuelles_Merchandising	Praktikantin für visuelles Merchandising
Praktikumsberater	Praktikumsberater
Preisüberwacher	Preisüberwacher
Pressesprecherin	Pressesprecherin
Privat-Chefkoch	Privat-Chefkoch
Privatbank-Analyst	Privatbank-Analyst
Private_Equity_Intern	Private Equity Intern
Private_Praxis	Private Praxis
Private-Banking-Analyst	Private-Banking-Analyst
Private-Banking-Assistent	Private-Banking-Assistent
Private-Banking-Beauftragter	Private-Banking-Beauftragter
Private-Banking-Kundenbetreuer	Private-Banking-Kundenbetreuer
Private-Banking-Manager	Private-Banking-Manager
Private-Equity-Analyst	Private-Equity-Analyst
Private-Equity-Gesellschafter	Private-Equity-Gesellschafter
Privater_Ermittler	Privater Ermittler
Privater_Hypothekenbankier	Privater Hypothekenbankier
Privatkunden-Manager	Privatkunden-Manager
Produkt-Controller	Produkt-Controller
Produkt-Designer	Produkt-Designer
Produkt-Marketing-Analyst	Produkt-Marketing-Analyst
Produkt-Meister	Produkt-Meister
Produkt-Portfolio-Manager	Produkt-Portfolio-Manager
Produkt-Stratege	Produkt-Stratege
Produkt-Supporttechniker	Produkt-Supporttechniker
Produkt-Technologe	Produkt-Technologe
Produktentwickler	Produktentwickler
Produktion_Apotheker	Produktion Apotheker
Produktion_Künstler	Produktion Künstler
Produktions-Koordinator	Produktions-Koordinator
Produktionsleiter	Produktionsleiter
Produktionssekretär	Produktionssekretär
Produkttechniker	Produkttechniker
Produzent	Produzent
Produzent_der_Morgensendung	Produzent der Morgensendung
Produzent_digitaler_Medien	Produzent digitaler Medien
Produzent_kreativer_Dienstleistungen	Produzent kreativer Dienstleistungen
Produzent_neuer_Medien	Produzent neuer Medien
Produzent_von_Fernsehnachrichten	Produzent von Fernsehnachrichten
Produzent_von_Inhalten	Produzent von Inhalten
Professionelle_Tänzerin	Professionelle Tänzerin
Professioneller_Buchhalter	Professioneller Buchhalter
Professioneller_Fotograf	Professioneller Fotograf
Professioneller_Immobilienmakler	Professioneller Immobilienmakler
Professioneller_Künstler	Professioneller Künstler
Professioneller_Make-up-Künstler	Professioneller Make-up-Künstler
Professioneller_Mitarbeiter	Professioneller Mitarbeiter
Professioneller_Schauspieler	Professioneller Schauspieler
Professioneller_Sänger	Professioneller Sänger
Professioneller_Techniker	Professioneller Techniker
Professor	Professor
Professor_Emeritus	Professor Emeritus
Professor_der_Chirurgie	Professor der Chirurgie
Professor_für_Anthropologie	Professor für Anthropologie
Professor_für_Architektur	Professor für Architektur
Professor_für_Englisch	Professor für Englisch
Professor_für_Kunst	Professor für Kunst
Professor_für_Mathematik	Professor für Mathematik
Professor_für_Philosophie	Professor für Philosophie
Professor_für_Politikwissenschaft	Professor für Politikwissenschaft
Professor_für_Pädagogik	Professor für Pädagogik
Professor_für_Soziologie	Professor für Soziologie
Profi-Fußballspieler	Profi-Fußballspieler
Profi-Sportler	Profi-Sportler
Programmier-Analytiker	Programmier-Analytiker
Programmproduzent	Programmproduzent
Projekt_Hydrogeologe	Projekt Hydrogeologe
Projekt-Archivar	Projekt-Archivar
Projekt-Assistentin	Projekt-Assistentin
Projekt-Designer	Projekt-Designer
Projekt-Editor	Projekt-Editor
Projekt-Geologe	Projekt-Geologe
Projekt-Schätzer	Projekt-Schätzer
Projekt-Superintendent	Projekt-Superintendent
Projektleiter	Projektleiter
Projektleiter_für_Rekrutierung	Projektleiter für Rekrutierung
Projekttechniker	Projekttechniker
Projekttechniker_für_Telekommunikation	Projekttechniker für Telekommunikation
Projektverantwortlicher	Projektverantwortlicher
Proprietärer_Aktienhändler	Proprietärer Aktienhändler
Proprietärer_Händler	Proprietärer Händler
Provost	Provost
Prozess-Anwalt	Prozess-Anwalt
Prozess-Designtechniker	Prozess-Designtechniker
Prozess-Manager	Prozess-Manager
Prozess-Steuerungstechniker	Prozess-Steuerungstechniker
Prozessberater	Prozessberater
Prozessexperte	Prozessexperte
Prozessführung_Partner	Prozessführung Partner
Prozesstechniker	Prozesstechniker
Prüftechniker	Prüftechniker
Psychiatrische_Geisteskrankenschwester_Praktiker	Psychiatrische Geisteskrankenschwester Praktiker
Psychoanalytiker	Psychoanalytiker
Psychologe	Psychologe
Psychologischer_Assistent	Psychologischer Assistent
Psychotherapeut_in_privater_Praxis	Psychotherapeut in privater Praxis
Publizist	Publizist
Pädagogischer_Diagnostiker	Pädagogischer Diagnostiker
Pädagogischer_Therapeut	Pädagogischer Therapeut
Pädiatrische_Krankenschwester_Practitioner	Pädiatrische Krankenschwester Practitioner
Qualitätssicherungs-Automatisierungstechniker	Qualitätssicherungs-Automatisierungstechniker
Radio-Planungstechniker	Radio-Planungstechniker
Radio-Produzent	Radio-Produzent
Radio-Talkshow-Moderator	Radio-Talkshow-Moderator
Radiologie-Manager	Radiologie-Manager
Radiologie-Supervisor	Radiologie-Supervisor
Radiologie-Technologe	Radiologie-Technologe
Radiologietechniker	Radiologietechniker
Radiosender	Radiosender
Radiotechniker	Radiotechniker
Ratgeber	Ratgeber
Rating-Analyst	Rating-Analyst
Raum-Abteilungsleiter	Raum-Abteilungsleiter
Raumfahrzeugtechniker	Raumfahrzeugtechniker
Rechenzentrums-Administrator	Rechenzentrums-Administrator
Rechenzentrums-Analyst	Rechenzentrums-Analyst
Rechenzentrums-Überwacher	Rechenzentrums-Überwacher
Rechenzentrumsbetreiber	Rechenzentrumsbetreiber
Rechnungsprüfer	Rechnungsprüfer
Rechtsabteilung_Intern	Rechtsabteilung Intern
Rechtsanwalt	Rechtsanwalt
Rechtsanwaltsfachangestellte/r	Rechtsanwaltsfachangestellte/r
Rechtsanwaltsgehilfe	Rechtsanwaltsgehilfe
Rechtsbeistand	Rechtsbeistand
Rechtsbeistand_der_Gruppe	Rechtsbeistand der Gruppe
Rechtsberater	Rechtsberater
Rechtsberater_für_Unternehmen	Rechtsberater für Unternehmen
Rechtsberaterin	Rechtsberaterin
Rechtsexperte	Rechtsexperte
Rechtspraktiker	Rechtspraktiker
Rechtsreferent	Rechtsreferent
Rechtsreferent_im_Sommer	Rechtsreferent im Sommer
Rechtsstreitigkeiten_Associate	Rechtsstreitigkeiten Associate
Rechtswissenschaftlerin	Rechtswissenschaftlerin
Redaktionelle_Assistentin	Redaktionelle Assistentin
Redaktioneller_Berater	Redaktioneller Berater
Redaktioneller_Direktor	Redaktioneller Direktor
Redaktioneller_Koordinator	Redaktioneller Koordinator
Redaktioneller_Projektleiter	Redaktioneller Projektleiter
Redaktionsassistent	Redaktionsassistent
Referent_für_wirtschaftliche_Entwicklung	Referent für wirtschaftliche Entwicklung
Regionaler_Bauleiter	Regionaler Bauleiter
Regionaler_Berater	Regionaler Berater
Regionaler_Direktor_für_Schadenverhütung	Regionaler Direktor für Schadenverhütung
Regionaler_Ermittler	Regionaler Ermittler
Regionaler_Exportleiter	Regionaler Exportleiter
Regionaler_Finanzleiter	Regionaler Finanzleiter
Regionaler_Immobilien-Manager	Regionaler Immobilien-Manager
Regionaler_Logistik-Manager	Regionaler Logistik-Manager
Regionaler_Produktionsleiter	Regionaler Produktionsleiter
Regionaler_Rekrutierungsleiter	Regionaler Rekrutierungsleiter
Regionaler_Systemtechniker	Regionaler Systemtechniker
Regionaler_Transportmanager	Regionaler Transportmanager
Regionaler_technischer_Spezialist	Regionaler technischer Spezialist
Registrierte_Zahnarzthelferin	Registrierte Zahnarzthelferin
Registrierter_Veterinärtechniker	Registrierter Veterinärtechniker
Regulatory_Counsel	Regulatory Counsel
Reise-Exekutive	Reise-Exekutive
Reise-Manager	Reise-Manager
Reise-Redakteur	Reise-Redakteur
Reiseberater	Reiseberater
Reisebüro-Manager	Reisebüro-Manager
Reiseexperte	Reiseexperte
Reisekrankenschwester	Reisekrankenschwester
Reiseschriftsteller	Reiseschriftsteller
Rekrutierungs-Beauftragter	Rekrutierungs-Beauftragter
Rekrutierungs-Berater	Rekrutierungs-Berater
Relationship_Manager	Relationship Manager
Relationship_Manager_für_Geschäftsbanken	Relationship Manager für Geschäftsbanken
Relationship-Banker	Relationship-Banker
Reparaturtechniker	Reparaturtechniker
Reserve-Polizist	Reserve-Polizist
Ressourcen_für_Führungskräfte	Ressourcen für Führungskräfte
Restaurant_&_Bar_Manager	Restaurant & Bar Manager
Restaurant-Aufseher	Restaurant-Aufseher
Restaurant-Koch	Restaurant-Koch
Restaurant-Server	Restaurant-Server
Restaurantbesitzer	Restaurantbesitzer
Restaurantleiter	Restaurantleiter
Rettungsschwimmer	Rettungsschwimmer
Retuscheur	Retuscheur
Richter_für_Verwaltungsrecht	Richter für Verwaltungsrecht
Richterin	Richterin
Risiko-Controller	Risiko-Controller
Risikokapital-Analyst	Risikokapital-Analyst
Rohstoff-Analyst	Rohstoff-Analyst
Rollouttechniker	Rollouttechniker
Ruder-Ausbilder	Ruder-Ausbilder
Rundfunk-_und_Fernsehtechniker	Rundfunk- und Fernsehtechniker
Rundfunk-Assistent	Rundfunk-Assistent
Rundfunkaufseher	Rundfunkaufseher
Rundfunkjournalist	Rundfunkjournalist
Rundfunkveranstalter	Rundfunkveranstalter
Russisch-Linguist	Russisch-Linguist
Röntgentechniker	Röntgentechniker
Rückversicherungsmakler	Rückversicherungsmakler
SCADAtechniker	SCADAtechniker
Sachbearbeiter	Sachbearbeiter
Sachbearbeiter_Produzieren	Sachbearbeiter Produzieren
Sachbearbeiter_Versand_&_Empfang	Sachbearbeiter Versand & Empfang
Sachbearbeiter_für_Hypothekenkredite	Sachbearbeiter für Hypothekenkredite
Sachbearbeiter_für_Meeresfrüchte	Sachbearbeiter für Meeresfrüchte
Sachbearbeiter_für_Sammlungen	Sachbearbeiter für Sammlungen
Sachbearbeiter_in_der_Poststelle	Sachbearbeiter in der Poststelle
Saisonaler_Vertriebsmitarbeiter	Saisonaler Vertriebsmitarbeiter
Salon-Besitzer	Salon-Besitzer
Salon-Koordinator	Salon-Koordinator
Salon-Manager	Salon-Manager
Sammlungen_Intern	Sammlungen Intern
Schadenregulierer_für_Unfallopfer	Schadenregulierer für Unfallopfer
Schadenregulierungsbeauftragter	Schadenregulierungsbeauftragter
Schadensregulierer_für_Eigentumsansprüche	Schadensregulierer für Eigentumsansprüche
Schalterbeamter	Schalterbeamter
Schaltertechniker	Schaltertechniker
Schaltungsentwickler	Schaltungsentwickler
Schaltungsentwurftechniker	Schaltungsentwurftechniker
Schauspiellehrer	Schauspiellehrer
Schiffsmakler	Schiffsmakler
Schlagzeuger	Schlagzeuger
Schlichter	Schlichter
Schreibtisch-Supporttechniker	Schreibtisch-Supporttechniker
Schriftsteller	Schriftsteller
Schuhdesigner	Schuhdesigner
Schulbasierter_Therapeut	Schulbasierter Therapeut
Schulkrankenschwester	Schulkrankenschwester
Schulleiter	Schulleiter
Schwimmtrainer	Schwimmtrainer
Schönheitsberaterin	Schönheitsberaterin
Second_Line_Support-Analyst	Second Line Support-Analyst
Seemeister	Seemeister
Sektion_Techniker	Sektion Techniker
Sekundarschullehrer	Sekundarschullehrer
Sekundarschullehrer_für_Naturwissenschaften	Sekundarschullehrer für Naturwissenschaften
Sekundärer_Marketing-Manager	Sekundärer Marketing-Manager
Sendeleiter	Sendeleiter
Server	Server
Server-Administrator	Server-Administrator
Service_Now_Entwickler	Service Now Entwickler
Service-Center-Analyst	Service-Center-Analyst
Service-Desk-Administrator	Service-Desk-Administrator
Service-Desk-Agent	Service-Desk-Agent
Service-Desktechniker	Service-Desktechniker
Set_Kommode	Set Kommode
Set-Produktions-Assistent	Set-Produktions-Assistent
Sheriff	Sheriff
Sicherheits-Administrator	Sicherheits-Administrator
Sicherheitsexperte	Sicherheitsexperte
Sicherheitstechniker	Sicherheitstechniker
Siedlungsexperte	Siedlungsexperte
Simulationstechniker	Simulationstechniker
Skript-Supervisor	Skript-Supervisor
Social_Media_Marketing_Manager	Social Media Marketing Manager
Social-Media-Stratege	Social-Media-Stratege
Software-Analytiker	Software-Analytiker
Software-Anwendungsentwickler	Software-Anwendungsentwickler
Software-Berater	Software-Berater
Software-Entwickler-Praktikum	Software-Entwickler-Praktikum
Software-Entwicklungstechniker	Software-Entwicklungstechniker
Software-Entwicklungstechniker_im_Test	Software-Entwicklungstechniker im Test
Software-Firma	Software-Firma
Software-Projektleiter	Software-Projektleiter
Software-Schüler	Software-Schüler
Software-Unterstützungstechniker	Software-Unterstützungstechniker
Softwareexperte	Softwareexperte
Softwaretechniker	Softwaretechniker
Softwaretechniker_Teamleiter	Softwaretechniker Teamleiter
Soldat	Soldat
Sommercamp-Berater	Sommercamp-Berater
Sonderagent	Sonderagent
Sonderbeauftragter_für_Schadensfälle	Sonderbeauftragter für Schadensfälle
Sonderberaterin	Sonderberaterin
Sonderermittler	Sonderermittler
Sonderpädagoge	Sonderpädagoge
Songwriter	Songwriter
Sortierer	Sortierer
Sourcer	Sourcer
Sous_Chef	Sous Chef
Sozialarbeiterin	Sozialarbeiterin
Soziologie_Ausbilder	Soziologie Ausbilder
Spa-Aufseher	Spa-Aufseher
Spanisch-Tutor	Spanisch-Tutor
Spanisch-Übersetzer	Spanisch-Übersetzer
Spezialist_für_Alphabetisierung	Spezialist für Alphabetisierung
Spezialist_für_Automatisierung	Spezialist für Automatisierung
Spezialist_für_Baufinanzierungen	Spezialist für Baufinanzierungen
Spezialist_für_Derivate	Spezialist für Derivate
Spezialist_für_Desktop-Unterstützung	Spezialist für Desktop-Unterstützung
Spezialist_für_Dienstunterstützung	Spezialist für Dienstunterstützung
Spezialist_für_Endbenutzer-Support	Spezialist für Endbenutzer-Support
Spezialist_für_Ermittlungen	Spezialist für Ermittlungen
Spezialist_für_Geschäftsbanken	Spezialist für Geschäftsbanken
Spezialist_für_Hypothekenkredite	Spezialist für Hypothekenkredite
Spezialist_für_Investmentfonds	Spezialist für Investmentfonds
Spezialist_für_Klinische_Pharmazie	Spezialist für Klinische Pharmazie
Spezialist_für_Konkurs	Spezialist für Konkurs
Spezialist_für_Kundenbetreuung	Spezialist für Kundenbetreuung
Spezialist_für_Marketingkommunikation	Spezialist für Marketingkommunikation
Spezialist_für_Medienproduktion	Spezialist für Medienproduktion
Spezialist_für_Mikrocomputer	Spezialist für Mikrocomputer
Spezialist_für_Netzwerksicherheit	Spezialist für Netzwerksicherheit
Spezialist_für_Personal_Computer	Spezialist für Personal Computer
Spezialist_für_Rechtsstreitigkeiten	Spezialist für Rechtsstreitigkeiten
Spezialist_für_Rekrutierung	Spezialist für Rekrutierung
Spezialist_für_Ressourcen	Spezialist für Ressourcen
Spezialist_für_Talentakquise	Spezialist für Talentakquise
Spezialist_für_Talentmanagement	Spezialist für Talentmanagement
Spezialist_für_Testautomatisierung	Spezialist für Testautomatisierung
Spezialist_für_Unternehmensentwicklung	Spezialist für Unternehmensentwicklung
Spezialist_für_Verfahrenstechnik	Spezialist für Verfahrenstechnik
Spezialist_für_Videoproduktion	Spezialist für Videoproduktion
Spezialist_für_Web-Kommunikation	Spezialist für Web-Kommunikation
Spezialist_für_Webanwendungen	Spezialist für Webanwendungen
Spezialist_für_Werbung	Spezialist für Werbung
Spezialist_für_Zwangsvollstreckung	Spezialist für Zwangsvollstreckung
Spezialist_für_festverzinsliche_Wertpapiere	Spezialist für festverzinsliche Wertpapiere
Spezialist_für_geistiges_Eigentum	Spezialist für geistiges Eigentum
Spezialist_für_gewerbliche_Immobilien	Spezialist für gewerbliche Immobilien
Spezialist_für_internationalen_Handel	Spezialist für internationalen Handel
Spezialist_für_klinische_Anwendungen	Spezialist für klinische Anwendungen
Spezialist_für_neue_Geschäfte	Spezialist für neue Geschäfte
Spezialist_für_regionale_Unterstützung	Spezialist für regionale Unterstützung
Spezialist_für_soziale_Medien	Spezialist für soziale Medien
Spezialist_importieren	Spezialist importieren
Spezialistin_für_Marketing_und_Öffentlichkeitsarbeit	Spezialistin für Marketing und Öffentlichkeitsarbeit
Spezialistin_für_Öffentlichkeitsarbeit	Spezialistin für Öffentlichkeitsarbeit
Spiel-Designer	Spiel-Designer
Spiel-Künstler	Spiel-Künstler
Spieler	Spieler
Spielleiter	Spielleiter
Sport-Anker	Sport-Anker
Sport-Fotograf	Sport-Fotograf
Sport-Manager	Sport-Manager
Sport-Praktikantin	Sport-Praktikantin
Sport-Produzent	Sport-Produzent
Sportdirektor	Sportdirektor
Sportkoordinator	Sportkoordinator
Sportlehrer	Sportlehrer
Sportlicher_Koordinator	Sportlicher Koordinator
Sportredakteur	Sportredakteur
Sportreporter	Sportreporter
Sprachberaterin	Sprachberaterin
Sprachkunstlehrer	Sprachkunstlehrer
Sprachtechniker	Sprachtechniker
Sprecherin	Sprecherin
Staatspolizist	Staatspolizist
Stab_Anwendungstechniker	Stab Anwendungstechniker
Stab_Elektrotechniker	Stab Elektrotechniker
Stab_Geologe	Stab Geologe
Stab_Geophysiker	Stab Geophysiker
Stab_Hardwaretechniker	Stab Hardwaretechniker
Stab_Konstrukteur	Stab Konstrukteur
Stabs-Fotograf	Stabs-Fotograf
Stabsanästhesist	Stabsanästhesist
Stabsarzt	Stabsarzt
Stabsjurist	Stabsjurist
Stadtplaner	Stadtplaner
Standesbeamter	Standesbeamter
Standort-Manager	Standort-Manager
Standort-Scout	Standort-Scout
Standort-Superintendent	Standort-Superintendent
Standorttechniker	Standorttechniker
State_&_Local_Tax_Manager	State & Local Tax Manager
Stationstechniker	Stationstechniker
Stellvertretende_Direktorin_für_Studienzulassungen	Stellvertretende Direktorin für Studienzulassungen
Stellvertretende_Generalberaterin	Stellvertretende Generalberaterin
Stellvertretende_Schulleiterin	Stellvertretende Schulleiterin
Stellvertretender_Bankdirektor	Stellvertretender Bankdirektor
Stellvertretender_Bezirksstaatsanwalt	Stellvertretender Bezirksstaatsanwalt
Stellvertretender_Brandmeister	Stellvertretender Brandmeister
Stellvertretender_Chef-Pilot	Stellvertretender Chef-Pilot
Stellvertretender_Chefsyndikus	Stellvertretender Chefsyndikus
Stellvertretender_Dekan_für_Zulassungen	Stellvertretender Dekan für Zulassungen
Stellvertretender_Direktor_der_Krankenpflege	Stellvertretender Direktor der Krankenpflege
Stellvertretender_Direktor_der_Pharmazie	Stellvertretender Direktor der Pharmazie
Stellvertretender_Direktor_des_Food_Service	Stellvertretender Direktor des Food Service
Stellvertretender_Direktor_des_Jahresfonds	Stellvertretender Direktor des Jahresfonds
Stellvertretender_Direktor_für_Haushaltsführung	Stellvertretender Direktor für Haushaltsführung
Stellvertretender_Direktor_für_Kommunikation	Stellvertretender Direktor für Kommunikation
Stellvertretender_Direktor_für_Sicherheit	Stellvertretender Direktor für Sicherheit
Stellvertretender_Direktor_für_Unternehmensentwicklung	Stellvertretender Direktor für Unternehmensentwicklung
Stellvertretender_Feuerwehrchef	Stellvertretender Feuerwehrchef
Stellvertretender_Fondsmanager	Stellvertretender Fondsmanager
Stellvertretender_Front_Desk_Manager	Stellvertretender Front Desk Manager
Stellvertretender_Front_Office_Manager	Stellvertretender Front Office Manager
Stellvertretender_Generaldirektor	Stellvertretender Generaldirektor
Stellvertretender_Generalstaatsanwalt	Stellvertretender Generalstaatsanwalt
Stellvertretender_Housekeeping-Manager	Stellvertretender Housekeeping-Manager
Stellvertretender_Inhalts-Manager	Stellvertretender Inhalts-Manager
Stellvertretender_Investitionsmanager	Stellvertretender Investitionsmanager
Stellvertretender_Kreativdirektor	Stellvertretender Kreativdirektor
Stellvertretender_Küchenchef	Stellvertretender Küchenchef
Stellvertretender_Manager	Stellvertretender Manager
Stellvertretender_Manager_Recht	Stellvertretender Manager Recht
Stellvertretender_Marktmanager	Stellvertretender Marktmanager
Stellvertretender_Maschinenbautechniker	Stellvertretender Maschinenbautechniker
Stellvertretender_Minister	Stellvertretender Minister
Stellvertretender_Nachtmanager	Stellvertretender Nachtmanager
Stellvertretender_Outlet-Manager	Stellvertretender Outlet-Manager
Stellvertretender_Pflichtverteidiger	Stellvertretender Pflichtverteidiger
Stellvertretender_Polizeichef	Stellvertretender Polizeichef
Stellvertretender_Portfolio-Manager	Stellvertretender Portfolio-Manager
Stellvertretender_Projekttechniker	Stellvertretender Projekttechniker
Stellvertretender_Relationship_Manager	Stellvertretender Relationship Manager
Stellvertretender_Schulleiter	Stellvertretender Schulleiter
Stellvertretender_Sekretär	Stellvertretender Sekretär
Stellvertretender_Sheriff	Stellvertretender Sheriff
Stellvertretender_Stadtanwalt	Stellvertretender Stadtanwalt
Stellvertretender_Stadttechniker	Stellvertretender Stadttechniker
Stellvertretender_Standortmanager	Stellvertretender Standortmanager
Stellvertretender_Terminal-Manager	Stellvertretender Terminal-Manager
Stellvertretender_Unternehmenssekretär	Stellvertretender Unternehmenssekretär
Stellvertretender_geschäftsführender_Herausgeber	Stellvertretender geschäftsführender Herausgeber
Steuer-Hauptverantwortlicher	Steuer-Hauptverantwortlicher
Steuer-Manager	Steuer-Manager
Steuer-Vorbereiter	Steuer-Vorbereiter
Steueranalytiker	Steueranalytiker
Steueranwalt	Steueranwalt
Steueraufseher	Steueraufseher
Steuerberater	Steuerberater
Steuerexperte	Steuerexperte
Steuerlicher_Mitarbeiter	Steuerlicher Mitarbeiter
Steuerprüfer	Steuerprüfer
Steuertechniker	Steuertechniker
Steuerungssystem-Designer	Steuerungssystem-Designer
Steuerungssystemexperte	Steuerungssystemexperte
Steuerungssystemtechniker	Steuerungssystemtechniker
Steuerverwalter	Steuerverwalter
Stil-Berater	Stil-Berater
Stilist	Stilist
Stockwerkspersonal	Stockwerkspersonal
Strafverfolgungsbeamter	Strafverfolgungsbeamter
Strafverteidiger	Strafverteidiger
Strategie-_und_Betriebsleiter	Strategie- und Betriebsleiter
Strategie-Berater	Strategie-Berater
Strategie-Supervisor	Strategie-Supervisor
Strategische_Kommunikation	Strategische Kommunikation
Strategischer_Unternehmensberater	Strategischer Unternehmensberater
Straßenbautechniker	Straßenbautechniker
Straßenfahrer	Straßenfahrer
Stress-Analytiker	Stress-Analytiker
Stresstechniker	Stresstechniker
Student_des_Maschinenbaus	Student des Maschinenbaus
Studentische_Freiwillige	Studentische Freiwillige
Studentischer_Reporter	Studentischer Reporter
Studiendirektor	Studiendirektor
Such-Berater	Such-Berater
Supervisor_des_Verteilungszentrums	Supervisor des Verteilungszentrums
Supervisor_für_Flughafenbetrieb	Supervisor für Flughafenbetrieb
Supervisor_für_Gastbeziehungen	Supervisor für Gastbeziehungen
Supervisor_für_Gruppenkunst	Supervisor für Gruppenkunst
Supervisor_für_Gästeservices	Supervisor für Gästeservices
Supervisor_für_Systemunterstützung	Supervisor für Systemunterstützung
Supervisor_für_Telekommunikation	Supervisor für Telekommunikation
Supervisor_für_Werbung	Supervisor für Werbung
Supervisor_für_technische_Unterstützung	Supervisor für technische Unterstützung
Supporttechniker	Supporttechniker
System-Designtechniker	System-Designtechniker
System-Supporttechniker	System-Supporttechniker
System-Unterstützungstechniker	System-Unterstützungstechniker
Systemadministrator	Systemadministrator
Systemanalytiker	Systemanalytiker
Systemnetzwerk-Administrator	Systemnetzwerk-Administrator
Systemtechniker	Systemtechniker
Sänger	Sänger
Talent-Manager	Talent-Manager
Talentproduzent	Talentproduzent
Talkshow-Moderator	Talkshow-Moderator
Tanzlehrer	Tanzlehrer
Teamleiter_Front_Office	Teamleiter Front Office
Teamleiter_der_Netzbetriebszentrale	Teamleiter der Netzbetriebszentrale
Teamleiter_für_eingebettete_Software	Teamleiter für eingebettete Software
Teamleitung	Teamleitung
Techniker	Techniker
Techniker_der_Notaufnahme	Techniker der Notaufnahme
Techniker_für_Analog-Design	Techniker für Analog-Design
Techniker_für_Automatisierungssysteme	Techniker für Automatisierungssysteme
Techniker_für_Bauingenieurwesen	Techniker für Bauingenieurwesen
Techniker_für_Baukonstruktion	Techniker für Baukonstruktion
Techniker_für_Desktop-Unterstützung	Techniker für Desktop-Unterstützung
Techniker_für_Elektrotechnik_und_Instrumentierung	Techniker für Elektrotechnik und Instrumentierung
Techniker_für_Entwässerung	Techniker für Entwässerung
Techniker_für_Forschung_und_Entwicklung	Techniker für Forschung und Entwicklung
Techniker_für_Gebäudetechnik	Techniker für Gebäudetechnik
Techniker_für_Geschäftsunterstützungssysteme	Techniker für Geschäftsunterstützungssysteme
Techniker_für_Informationssicherheit	Techniker für Informationssicherheit
Techniker_für_Konstruktion_&_Entwicklung	Techniker für Konstruktion & Entwicklung
Techniker_für_Konstruktionsautomatisierung	Techniker für Konstruktionsautomatisierung
Techniker_für_Netzbetrieb	Techniker für Netzbetrieb
Techniker_für_Netzwerkintegration	Techniker für Netzwerkintegration
Techniker_für_Netzwerksicherheit	Techniker für Netzwerksicherheit
Techniker_für_Produktdesign_und_-entwicklung	Techniker für Produktdesign und -entwicklung
Techniker_für_Prozessautomatisierung	Techniker für Prozessautomatisierung
Techniker_für_Rundfunksysteme	Techniker für Rundfunksysteme
Techniker_für_Signalintegrität	Techniker für Signalintegrität
Techniker_für_Software-Qualitätssicherung	Techniker für Software-Qualitätssicherung
Techniker_für_Systemleistung	Techniker für Systemleistung
Techniker_für_Telekommunikation	Techniker für Telekommunikation
Techniker_für_Telekommunikationssysteme	Techniker für Telekommunikationssysteme
Techniker_für_Unternehmensnetzwerke	Techniker für Unternehmensnetzwerke
Techniker_für_Versuchsplanung	Techniker für Versuchsplanung
Techniker_für_biomedizinische_Ausrüstung	Techniker für biomedizinische Ausrüstung
Techniker_für_den_Außendienst	Techniker für den Außendienst
Techniker_für_digitale_Bildverarbeitung	Techniker für digitale Bildverarbeitung
Techniker_für_drahtlose_Netzwerke	Techniker für drahtlose Netzwerke
Techniker_für_eingebettete_Systeme	Techniker für eingebettete Systeme
Techniker_für_elektrische_Tests	Techniker für elektrische Tests
Techniker_für_elektronische_Systeme	Techniker für elektronische Systeme
Techniker_für_geistiges_Eigentum	Techniker für geistiges Eigentum
Techniker_für_mechanische_Entwicklung	Techniker für mechanische Entwicklung
Techniker_für_mechanische_Konstruktion	Techniker für mechanische Konstruktion
Techniker_für_mechanische_Systeme	Techniker für mechanische Systeme
Techniker_für_technische_Unterstützung	Techniker für technische Unterstützung
Techniker_für_technische_Vertriebsunterstützung	Techniker für technische Vertriebsunterstützung
Techniker_genehmigen	Techniker genehmigen
Techniker-Rekrutierer	Techniker-Rekrutierer
Technische_Leitung	Technische Leitung
Technische_Leitung_Java	Technische Leitung Java
Technische_Testleitung	Technische Testleitung
Technische_Unterstützung	Technische Unterstützung
Technischer_Animator	Technischer Animator
Technischer_Architekt	Technischer Architekt
Technischer_Außendienstleiter	Technischer Außendienstleiter
Technischer_Außendiensttechniker	Technischer Außendiensttechniker
Technischer_Betreiber	Technischer Betreiber
Technischer_Büroleiter	Technischer Büroleiter
Technischer_Bürotechniker	Technischer Bürotechniker
Technischer_Designer	Technischer Designer
Technischer_IT-Rekrutierer	Technischer IT-Rekrutierer
Technischer_Inspektor	Technischer Inspektor
Technischer_Kundendiensttechniker	Technischer Kundendiensttechniker
Technischer_Künstler	Technischer Künstler
Technischer_Produzent	Technischer Produzent
Technischer_Rekrutierungsmanager	Technischer Rekrutierungsmanager
Technischer_Supporttechniker	Technischer Supporttechniker
Technischer_Zeichner	Technischer Zeichner
Technischer_künstlerischer_Leiter	Technischer künstlerischer Leiter
Technischer_Übersetzer	Technischer Übersetzer
Technologe_für_Forschung_und_Entwicklung	Technologe für Forschung und Entwicklung
Technologe_für_Nuklearmedizin	Technologe für Nuklearmedizin
Technologe_für_Produktentwicklung	Technologe für Produktentwicklung
Technologe_für_Qualitätssicherung	Technologe für Qualitätssicherung
Technologie	Technologie
Technologie-Analytiker	Technologie-Analytiker
Technologie-Architekt	Technologie-Architekt
Technologie-Rekrutierer	Technologie-Rekrutierer
Technologie-Trainer	Technologie-Trainer
Teilzeit-Vertriebsmitarbeiter	Teilzeit-Vertriebsmitarbeiter
Telefon-Operator	Telefon-Operator
Telefonietechniker	Telefonietechniker
Telekommunikations-Experte	Telekommunikations-Experte
Telekommunikations-Offizier	Telekommunikations-Offizier
Telekommunikationsexperte	Telekommunikationsexperte
Telekommunikationstechniker	Telekommunikationstechniker
Temporärer_Buchhalter	Temporärer Buchhalter
Temporärer_Mitarbeiter	Temporärer Mitarbeiter
Tennistrainer	Tennistrainer
Termin-Broker	Termin-Broker
Terminal-Manager	Terminal-Manager
Testtechniker	Testtechniker
Textil-Designer	Textil-Designer
Textur-Künstler	Textur-Künstler
Theaterregisseur	Theaterregisseur
Therapeut	Therapeut
Ticket-Agent	Ticket-Agent
Tierpflege-Mitarbeiter	Tierpflege-Mitarbeiter
Tierpflegetechniker	Tierpflegetechniker
Tierärztliche_Assistentin	Tierärztliche Assistentin
Tischlermeister	Tischlermeister
Titel_1_Lehrer	Titel 1 Lehrer
Titel_Offizier	Titel Offizier
Titel_Prüfer	Titel Prüfer
Titel-Agent	Titel-Agent
Ton-Mischpult	Ton-Mischpult
Tontechniker	Tontechniker
Tools_Entwickler	Tools Entwickler
Tour-Direktor	Tour-Direktor
Tour-Koordinator	Tour-Koordinator
Transaktions-Analyst	Transaktions-Analyst
Transportbeauftragter	Transportbeauftragter
Tresor-Manager	Tresor-Manager
Treuhand-Assistent	Treuhand-Assistent
Tutor_für_Informatik	Tutor für Informatik
UI-Designer	UI-Designer
UItechniker	UItechniker
Ultraschall-Technologe	Ultraschall-Technologe
Umwelt-Projektleiter	Umwelt-Projektleiter
Umweltgeologe	Umweltgeologe
Umweltgrafik-Designer	Umweltgrafik-Designer
Umweltprogramm-Manager	Umweltprogramm-Manager
Umweltschutzexperte	Umweltschutzexperte
Umwelttechniker	Umwelttechniker
Umweltwissenschaftlerin	Umweltwissenschaftlerin
Umzugs-Direktor	Umzugs-Direktor
Umzugsexperte	Umzugsexperte
Underwriter_Leben	Underwriter Leben
Underwriter_für_Konsumentenkredite	Underwriter für Konsumentenkredite
Underwriter_für_Privatkunden	Underwriter für Privatkunden
Underwriter_für_Produktion	Underwriter für Produktion
Underwriter_vor_Ort	Underwriter vor Ort
Underwriting-Assistent	Underwriting-Assistent
Underwriting-Berater	Underwriting-Berater
Universalbankier	Universalbankier
Universitätsbibliothekar	Universitätsbibliothekar
Unterhalter	Unterhalter
Unterlehrer	Unterlehrer
Unternehmensanwalt	Unternehmensanwalt
Unternehmensberater	Unternehmensberater
Unternehmensbibliothekar	Unternehmensbibliothekar
Unternehmensjurist	Unternehmensjurist
Unternehmenstechniker	Unternehmenstechniker
Unteroffizier	Unteroffizier
Unteroffizier_auf_Streife	Unteroffizier auf Streife
Unteroffizier_der_Polizei	Unteroffizier der Polizei
Unterrichtsexperte	Unterrichtsexperte
Unterstützer	Unterstützer
Urlaubsplaner	Urlaubsplaner
VP	VP
VP_Asset_Management	VP Asset Management
VP_Business_Development	VP Business Development
VP_Business_Operations	VP Business Operations
VP_Creative_Services	VP Creative Services
VP_External_Relations	VP External Relations
VP_Food_&_Beverage	VP Food & Beverage
VP_Global_HR	VP Global HR
VP_Institutional_Equity_Sales	VP Institutional Equity Sales
VP_Institutional_Sales	VP Institutional Sales
VP_Mortgage_Lending	VP Mortgage Lending
VP_Organizational_Development	VP Organizational Development
VP_Recruiting	VP Recruiting
VP_Recruitment	VP Recruitment
VP_Residential_Lending	VP Residential Lending
VP_Strategische_Initiativen	VP Strategische Initiativen
VP_Talent_Acquisition	VP Talent Acquisition
VP_Talent_Management	VP Talent Management
VP-Exploration	VP-Exploration
VP-Strategie	VP-Strategie
Vaskulärer_Technologe	Vaskulärer Technologe
Veranstalter	Veranstalter
Veranstaltungsexperte	Veranstaltungsexperte
Veranstaltungsort-Manager	Veranstaltungsort-Manager
Veranstaltungsplaner	Veranstaltungsplaner
Verantwortlicher_für_Produkt-Engineering	Verantwortlicher für Produkt-Engineering
Verantwortlicher_für_Öffentlichkeitsarbeit	Verantwortlicher für Öffentlichkeitsarbeit
Verarbeitender_Geophysiker	Verarbeitender Geophysiker
Verbindung_zur_Krankenschwester	Verbindung zur Krankenschwester
Verbindung_zur_medizinischen_Wissenschaft	Verbindung zur medizinischen Wissenschaft
Verfahrensmechaniker	Verfahrensmechaniker
Verfahrenstechnologe	Verfahrenstechnologe
Verfasser_von_Inhalten	Verfasser von Inhalten
Verfasser_von_Web-Inhalten	Verfasser von Web-Inhalten
Verhaltensmedizinischer_Techniker	Verhaltensmedizinischer Techniker
Verkaufsagent_für_Reservierungen	Verkaufsagent für Reservierungen
Verkaufshändler	Verkaufshändler
Verkaufsleiter	Verkaufsleiter
Verkaufspersonalvermittler	Verkaufspersonalvermittler
Verkaufsplaner	Verkaufsplaner
Verkehrs-Reporter	Verkehrs-Reporter
Verkehrsleiter	Verkehrsleiter
Verkäufe_von_Aktienderivaten	Verkäufe von Aktienderivaten
Verlagsleiter	Verlagsleiter
Verleiher	Verleiher
Vermittler	Vermittler
Vermögensbuchhalter	Vermögensbuchhalter
Vermögenssteuer-Manager	Vermögenssteuer-Manager
Versand-Blei	Versand-Blei
Versandleiter	Versandleiter
Versandmanager	Versandmanager
Versender	Versender
Versicherungs-Exekutive	Versicherungs-Exekutive
Versicherungsagent	Versicherungsagent
Versicherungsberater	Versicherungsberater
Versicherungsfachmann	Versicherungsfachmann
Versicherungsproduzent	Versicherungsproduzent
Versicherungsversicherer	Versicherungsversicherer
Versicherungsvertreter	Versicherungsvertreter
Vertrag_Java-Entwickler	Vertrag Java-Entwickler
Vertrag_Maschinenbautechniker	Vertrag Maschinenbautechniker
Vertrag_Web-Entwickler	Vertrag Web-Entwickler
Vertrags-Pilot	Vertrags-Pilot
Vertragsanwalt	Vertragsanwalt
Vertragsfotograf	Vertragsfotograf
Vertragsgeologe	Vertragsgeologe
Vertragsrekrutierer	Vertragsrekrutierer
Vertragsschreiber	Vertragsschreiber
Vertragstexter	Vertragstexter
Vertreter_der_Agentur	Vertreter der Agentur
Vertreter_der_technischen_Kundenbetreuung	Vertreter der technischen Kundenbetreuung
Vertreter_des_Einkäufers	Vertreter des Einkäufers
Vertreter_des_Gästeservice	Vertreter des Gästeservice
Vertreter_für_Versicherungskonten	Vertreter für Versicherungskonten
Vertreter_für_technische_Unterstützung	Vertreter für technische Unterstützung
Vertretungslehrer	Vertretungslehrer
Vertriebsmitarbeiter	Vertriebsmitarbeiter
Vervollständigungstechniker	Vervollständigungstechniker
Verwalter	Verwalter
Verwalter_digitaler_Inhalte	Verwalter digitaler Inhalte
Verwalter_von_Wohneigentum	Verwalter von Wohneigentum
Verwaltungsanalytiker	Verwaltungsanalytiker
Veterinärmediziner	Veterinärmediziner
Veterinärtechniker	Veterinärtechniker
Video-Editor	Video-Editor
Video-Journalist	Video-Journalist
Video-Produzent	Video-Produzent
Videofilmer	Videofilmer
Videotechniker	Videotechniker
Visualisierer	Visualisierer
Visueller_Designer	Visueller Designer
Visueller_Spezialist	Visueller Spezialist
Vizekanzler	Vizekanzler
Vizepräsident_des_Verwaltungsrats	Vizepräsident des Verwaltungsrats
Voip-Netzwerktechniker	Voip-Netzwerktechniker
Voiptechniker	Voiptechniker
Vollzeit-Fakultät	Vollzeit-Fakultät
Vor-Orttechniker	Vor-Orttechniker
Vorarbeiter	Vorarbeiter
Vormittagsnachrichten-Anker	Vormittagsnachrichten-Anker
Vorschullehrer	Vorschullehrer
Vortragende	Vortragende
Wachoffizier	Wachoffizier
Wachtmeister	Wachtmeister
Walmart-Mitarbeiter	Walmart-Mitarbeiter
Wartungstechniker_für_Ausrüstung	Wartungstechniker für Ausrüstung
Wasser-Aerobic-Ausbilder	Wasser-Aerobic-Ausbilder
Web-_&_Grafik-Designer	Web- & Grafik-Designer
Web-Anwendungs-Programmierer	Web-Anwendungs-Programmierer
Web-Anwendungsentwickler	Web-Anwendungsentwickler
Web-Designer	Web-Designer
Web-Editor	Web-Editor
Web-Entwicklungs-Manager	Web-Entwicklungs-Manager
Web-Entwicklungstechniker	Web-Entwicklungstechniker
Web-Journalist	Web-Journalist
Web-Produzent	Web-Produzent
Web-Programmierer	Web-Programmierer
Web-UI-Entwickler	Web-UI-Entwickler
Web-Verleger	Web-Verleger
Website-Content-Manager	Website-Content-Manager
Website-Designer	Website-Designer
Website-Manager	Website-Manager
Webtechniker	Webtechniker
Werbe-Kundenbetreuer	Werbe-Kundenbetreuer
Werbeaktionen_Produzent	Werbeaktionen Produzent
Werbetexter	Werbetexter
Wiederaufnahme-Mixer	Wiederaufnahme-Mixer
Wirtschaftsexperte	Wirtschaftsexperte
Wirtschaftsjournalist	Wirtschaftsjournalist
Wirtschaftsjurist	Wirtschaftsjurist
Wissenschaftlerin_für_Forschung_und_Entwicklung	Wissenschaftlerin für Forschung und Entwicklung
Wissenschaftlicher_Assistent	Wissenschaftlicher Assistent
Wissenschaftlicher_Bibliothekar	Wissenschaftlicher Bibliothekar
Wissenschaftlicher_Geologe	Wissenschaftlicher Geologe
Wissenschaftlicher_Mitarbeiter	Wissenschaftlicher Mitarbeiter
Wissenschaftlicher_Rekrutierer	Wissenschaftlicher Rekrutierer
Wohnbau-Ingenieur	Wohnbau-Ingenieur
Wohnungsmakler	Wohnungsmakler
Wählen_Sie	Wählen Sie
Währungshändler	Währungshändler
Zahnarzthelferin	Zahnarzthelferin
Zeichen-Auslöser	Zeichen-Auslöser
Zeichen-Designer	Zeichen-Designer
Zeichen-Modellierer	Zeichen-Modellierer
Zertifizierte_Krankenpflege-Assistentin	Zertifizierte Krankenpflege-Assistentin
Zertifizierter_Hypothekenplaner	Zertifizierter Hypothekenplaner
Zertifizierter_Immobiliengutachter	Zertifizierter Immobiliengutachter
Zertifizierter_Koordinator_für_Klinische_Forschung	Zertifizierter Koordinator für Klinische Forschung
Zertifizierter_Personal_Trainer	Zertifizierter Personal Trainer
Zertifizierter_Spezialist_für_Hypothekenplanung	Zertifizierter Spezialist für Hypothekenplanung
Zertifizierter_juristischer_Praktikant	Zertifizierter juristischer Praktikant
Zertifizierungstechniker	Zertifizierungstechniker
Zivil-Designer	Zivil-Designer
Ziviler_Aufseher	Ziviler Aufseher
Ziviler_Zeichner	Ziviler Zeichner
Zubehör-Designer	Zubehör-Designer
Zulassungen_Botschafter	Zulassungen Botschafter
Zulassungen_Intern	Zulassungen Intern
Zuschuss-Manager	Zuschuss-Manager
Zuweisungs-Editor	Zuweisungs-Editor
Zweisprachige_Lehrkraft	Zweisprachige Lehrkraft
Zweisprachiger_Exekutivsekretär	Zweisprachiger Exekutivsekretär
Zweiter_Assistent	Zweiter Assistent
Zweiter_Offizier	Zweiter Offizier
Zweiter_stellvertretender_Direktor	Zweiter stellvertretender Direktor
Zweiter_stellvertretender_Manager	Zweiter stellvertretender Manager
Zwinger-Assistentin	Zwinger-Assistentin
Zwischengeschalteter_Buchhalter	Zwischengeschalteter Buchhalter
Züchter	Züchter
iOS_App-Entwickler	iOS App-Entwickler
Ärztin	Ärztin
Öffentlich_bestellter_Wirtschaftsprüfer	Öffentlich bestellter Wirtschaftsprüfer
Öffentlichkeitsarbeit	Öffentlichkeitsarbeit
Über_Nacht_Stocker	Über Nacht Stocker
