3D-Animator	3D-Animator
Agronom	Agronom
Aktienhändler	Aktienhändler
Akupunkteur	Akupunkteur
Analyst_für_Netzwerksicherheit	Analyst für Netzwerksicherheit
Anästhesist	Anästhesist
Apotheker	Apotheker
Archivar	Archivar
Automatisierungstechniker	Automatisierungstechniker
Automobiltechniker	Automobiltechniker
Bankier	Bankier
Barkeeper	Barkeeper
Bautechniker	Bautechniker
Berater_für_Unternehmensstrategie	Berater für Unternehmensstrategie
Biomedizinischer_Techniker	Biomedizinischer Techniker
Bohrtechniker	Bohrtechniker
Briefzusteller	Briefzusteller
Bäcker	Bäcker
Caterer	Caterer
Chemischer_Operator	Chemischer Operator
Computer-Reparaturtechniker	Computer-Reparaturtechniker
Desktop-Supporttechniker	Desktop-Supporttechniker
Direktor_der_Galerie	Direktor der Galerie
Drahtloser_Techniker	Drahtloser Techniker
Elektroniktechniker	Elektroniktechniker
Exekutive_für_Öffentlichkeitsarbeit	Exekutive für Öffentlichkeitsarbeit
Explorationsgeologe	Explorationsgeologe
Feuerwehrmann	Feuerwehrmann
Filmregisseur	Filmregisseur
Fotograf	Fotograf
Friseur	Friseur
Front_Desk-Betreuer	Front Desk-Betreuer
Gabelstaplerfahrer	Gabelstaplerfahrer
Grafik-Designer	Grafik-Designer
Grundschullehrer	Grundschullehrer
Handelsmarketing-Analyst	Handelsmarketing-Analyst
Herausgeber	Herausgeber
Hochzeitsplaner	Hochzeitsplaner
Hundefrisör	Hundefrisör
Hundetrainer	Hundetrainer
Hydrogeologe	Hydrogeologe
Immobilienmakler	Immobilienmakler
Import-Exportexperte	Import-Exportexperte
Innenarchitektin	Innenarchitektin
Investment-Banking-Analyst	Investment-Banking-Analyst
Java-Entwickler	Java-Entwickler
Kameramann	Kameramann
Kassiererin	Kassiererin
Kindergärtnerin	Kindergärtnerin
Kindermädchen	Kindermädchen
Klempner	Klempner
Koch	Koch
Komponist	Komponist
Kreditsachbearbeiter	Kreditsachbearbeiter
Lebensmitteltechnologe	Lebensmitteltechnologe
Lkw-Fahrer	Lkw-Fahrer
Logistikexperte	Logistikexperte
Luft-_und_Raumfahrttechniker	Luft- und Raumfahrttechniker
Maschinenbautechniker	Maschinenbautechniker
Maskenbildner	Maskenbildner
Medieneinkäufer	Medieneinkäufer
Metallurge	Metallurge
Modedesignerin	Modedesignerin
Nachrichten-Anker	Nachrichten-Anker
Netzwerktechniker	Netzwerktechniker
Persönlicher_Fitnesstrainer	Persönlicher Fitnesstrainer
Pilot_einer_Fluggesellschaft	Pilot einer Fluggesellschaft
Politikberaterin	Politikberaterin
Polizei-Detektiv	Polizei-Detektiv
Portfolio-Analyst	Portfolio-Analyst
Private-Equity-Analyst	Private-Equity-Analyst
Privater_Ermittler	Privater Ermittler
Professor_für_Geschichte	Professor für Geschichte
Psychotherapeut	Psychotherapeut
Radiologischer_Technologe	Radiologischer Technologe
Rechtsanwalt	Rechtsanwalt
Registrierte_Krankenschwester	Registrierte Krankenschwester
Reisebüro	Reisebüro
Rundfunk-_und_Fernsehtechniker	Rundfunk- und Fernsehtechniker
Seemann	Seemann
Spendenaktion	Spendenaktion
Sport-Trainer	Sport-Trainer
Stadtplaner	Stadtplaner
Steuerberater	Steuerberater
Sänger	Sänger
Talentgewinnung	Talentgewinnung
Techniker_für_Analog-Design	Techniker für Analog-Design
Techniker_für_Telekommunikation	Techniker für Telekommunikation
Technischer_Rekrutierer	Technischer Rekrutierer
Textil-Designer	Textil-Designer
Tierarzt	Tierarzt
Treuhänder	Treuhänder
Tänzerin	Tänzerin
Umwelt_Künstler	Umwelt Künstler
Vermittler	Vermittler
Versicherungsmakler	Versicherungsmakler
Vertreter_für_technische_Unterstützung	Vertreter für technische Unterstützung
Video-Editor	Video-Editor
Webentwickler	Webentwickler
Werbetexter	Werbetexter
Zahnarzt	Zahnarzt
Zimmermann	Zimmermann
iOS-Entwickler	iOS-Entwickler
Übersetzer	Übersetzer
