3D_Animator	3D Animator
Acupuncturist	Acupuncturist
Aerospace_Engineer	Aerospace Engineer
Agronomist	Agronomist
Airline_Pilot	Airline Pilot
Analog_Design_Engineer	Analog Design Engineer
Anesthesiologist	Anesthesiologist
Archivist	Archivist
Attorney	Attorney
Automation_Engineer	Automation Engineer
Automotive_Engineer	Automotive Engineer
Baker	Baker
Banker	Banker
Bartender	Bartender
Biomedical_Engineer	Biomedical Engineer
Broadcast_Engineer	Broadcast Engineer
Business_Strategy_Consultant	Business Strategy Consultant
Cameraman	Cameraman
Carpenter	Carpenter
Cashier	Cashier
Caterer	Caterer
Chemical_Operator	Chemical Operator
Civil_Engineer	Civil Engineer
Composer	Composer
Computer_Repair_Technician	Computer Repair Technician
Cook	Cook
Copywriter	Copywriter
Custodian	Custodian
Dancer	Dancer
Dentist	Dentist
Desktop_Support_Technician	Desktop Support Technician
Dog_Groomer	Dog Groomer
Dog_Trainer	Dog Trainer
Drilling_Engineer	Drilling Engineer
Electronic_Engineer	Electronic Engineer
Elementary_School_Teacher	Elementary School Teacher
Environment_Artist	Environment Artist
Equity_Trader	Equity Trader
Exploration_Geologist	Exploration Geologist
Fashion_Designer	Fashion Designer
Film_Director	Film Director
Firefighter	Firefighter
Food_Technologist	Food Technologist
Forklift_Operator	Forklift Operator
Front_Desk_Supervisor	Front Desk Supervisor
Fundraiser	Fundraiser
Gallery_Director	Gallery Director
Graphic_Designer	Graphic Designer
Hairstylist	Hairstylist
Hydrogeologist	Hydrogeologist
Import_Export_Specialist	Import Export Specialist
Insurance_Broker	Insurance Broker
Interior_Decorator	Interior Decorator
Investment_Banking_Analyst	Investment Banking Analyst
Java_Developer	Java Developer
Kindergarten_Teacher	Kindergarten Teacher
Lawyer	Lawyer
Letter_Carrier	Letter Carrier
Loan_Officer	Loan Officer
Logistics_Specialist	Logistics Specialist
Makeup_Artist	Makeup Artist
Mechanical_Engineer	Mechanical Engineer
Media_Buyer	Media Buyer
Mediator	Mediator
Metallurgist	Metallurgist
Nanny	Nanny
Network_Engineer	Network Engineer
Network_Security_Analyst	Network Security Analyst
News_Anchor	News Anchor
Personal_Fitness_Trainer	Personal Fitness Trainer
Pharmacist	Pharmacist
Photographer	Photographer
Plumber	Plumber
Police_Detective	Police Detective
Policy_Advisor	Policy Advisor
Portfolio_Analyst	Portfolio Analyst
Private_Equity_Analyst	Private Equity Analyst
Private_Investigator	Private Investigator
Professor_of_History	Professor of History
Psychotherapist	Psychotherapist
Public_Relations_Executive	Public Relations Executive
Publisher	Publisher
Radiologic_Technologist	Radiologic Technologist
Realtor	Realtor
Registered_Nurse	Registered Nurse
Seaman	Seaman
Singer	Singer
Sports_Coach	Sports Coach
Talent_Acquisition	Talent Acquisition
Tax_Accountant	Tax Accountant
Technical_Recruiter	Technical Recruiter
Technical_Support_Representative	Technical Support Representative
Telecommunications_Engineer	Telecommunications Engineer
Textile_Designer	Textile Designer
Trade_Marketing_Analyst	Trade Marketing Analyst
Translator	Translator
Travel_Agent	Travel Agent
Truck_Driver	Truck Driver
Urban_Designer	Urban Designer
Veterinarian	Veterinarian
Video_Editor	Video Editor
Web_Developer	Web Developer
Wedding_Planner	Wedding Planner
Wireless_Engineer	Wireless Engineer
iOS_Developer	iOS Developer
