3d_artiest	3d artiest
3d_generalist	3d generalist
3d_modelleur	3d modelleur
3d_omgeving_artiest	3d omgeving artiest
3d_personage-animator	3d personage-animator
aanbidding_directeur	aanbidding directeur
aanbieder_van_kinderopvang	aanbieder van kinderopvang
aandeelhouder	aandeelhouder
aandelen_analist	aandelen analist
aandelen_verkopen	aandelen verkopen
aandelenonderzoek_analist	aandelenonderzoek analist
aandelenpartner	aandelenpartner
aandelenspecialist	aandelenspecialist
aandelenstrateeg	aandelenstrateeg
aandelenverkoper	aandelenverkoper
aandrijflijn_ingenieur	aandrijflijn ingenieur
aangesloten_makelaar	aangesloten makelaar
aangewezen_makelaar	aangewezen makelaar
aannemer	aannemer
aanwervende_operationeel_manager	aanwervende operationeel manager
academische_specialist	academische specialist
accessoires_ontwerper	accessoires ontwerper
account_directeur	account directeur
account_strateeg	account strateeg
account_supervisor	account supervisor
accountant	accountant
accountant_loonheffingen	accountant loonheffingen
accountmanager	accountmanager
accountmanager_advertenties	accountmanager advertenties
accountmanager_midden_markt	accountmanager midden markt
accountmanager_public_relations	accountmanager public relations
accountmanager_recruitment	accountmanager recruitment
accountmanager_werving	accountmanager werving
accountplanner	accountplanner
achtergrond_onderzoeker	achtergrond onderzoeker
acquisitie_marketingmanager	acquisitie marketingmanager
adjunct_directeur_horeca	adjunct directeur horeca
adjunct_hoogleraar	adjunct hoogleraar
adjunct_instructeur	adjunct instructeur
adjunct_secretaris	adjunct secretaris
adjunct-directeur_apotheek	adjunct-directeur apotheek
adjunct-directeur_beveiliging	adjunct-directeur beveiliging
adjunct-directeur_communicatie	adjunct-directeur communicatie
adjunct-directeur_huishouding	adjunct-directeur huishouding
adjunct-directeur_van_het_jaarfonds	adjunct-directeur van het jaarfonds
adjunct-directeur_van_undergraduate_toelatingen	adjunct-directeur van undergraduate toelatingen
adjunct-directeur_verpleegkunde	adjunct-directeur verpleegkunde
adjunct-hoofd_docent	adjunct-hoofd docent
adjunct-hoogleraar_financiën	adjunct-hoogleraar financiën
adjunct-hoogleraar_geschiedenis	adjunct-hoogleraar geschiedenis
administrateur_debiteurenadministratie	administrateur debiteurenadministratie
administratief_analist	administratief analist
advertentie_coördinator	advertentie coördinator
adviserend_redacteur	adviserend redacteur
adviserend_systeem_analist	adviserend systeem analist
adviserende_beheerder	adviserende beheerder
adviserende_verkoopspecialist	adviserende verkoopspecialist
adviseur_bedrijfsbeheer	adviseur bedrijfsbeheer
adviseur_bedrijfsontwikkeling	adviseur bedrijfsontwikkeling
adviseur_commercieel_vastgoed	adviseur commercieel vastgoed
adviseur_datanetwerken	adviseur datanetwerken
adviseur_fondsenwerving	adviseur fondsenwerving
adviseur_geestelijke_gezondheidszorg	adviseur geestelijke gezondheidszorg
adviseur_grafische_vormgeving	adviseur grafische vormgeving
adviseur_internationale_bedrijfsontwikkeling	adviseur internationale bedrijfsontwikkeling
adviseur_leiderschapsontwikkeling	adviseur leiderschapsontwikkeling
adviseur_marketing_en_public_relations	adviseur marketing en public relations
adviseur_netwerk_engineering	adviseur netwerk engineering
adviseur_netwerkbeveiliging	adviseur netwerkbeveiliging
adviseur_netwerkontwerp	adviseur netwerkontwerp
adviseur_organisatieontwikkeling	adviseur organisatieontwikkeling
adviseur_productontwerp	adviseur productontwerp
adviseur_public_relations	adviseur public relations
adviseur_public_relations_en_communicatie	adviseur public relations en communicatie
adviseur_talent_acquisitie	adviseur talent acquisitie
adviseur_talentmanagement	adviseur talentmanagement
adviseur_testautomatisering	adviseur testautomatisering
adviseur_vennootschapsbelasting	adviseur vennootschapsbelasting
adviseur_verzekeringen	adviseur verzekeringen
adviseur_werktuigbouwkunde	adviseur werktuigbouwkunde
adviseur_woninghypotheek	adviseur woninghypotheek
adviseur_woonkrediet	adviseur woonkrediet
advocaat	advocaat
advocaat_familierecht	advocaat familierecht
advocaat_intellectueel_eigendom	advocaat intellectueel eigendom
advocaat_van_het_personeel	advocaat van het personeel
aerodynamica_ingenieur	aerodynamica ingenieur
afdelingschef_elektrotechniek	afdelingschef elektrotechniek
afdelingsmanager_kamers	afdelingsmanager kamers
afdelingsmanager_logistiek	afdelingsmanager logistiek
afgestudeerd_bouwkundig_ingenieur	afgestudeerd bouwkundig ingenieur
afgestudeerd_medewerkster	afgestudeerd medewerkster
afgestudeerd_wervingsmanager	afgestudeerd wervingsmanager
afscherming_specialist	afscherming specialist
afsluitend_begeleider	afsluitend begeleider
afsluitend_specialist	afsluitend specialist
afwikkeling_specialist	afwikkeling specialist
agent	agent
agent_commercieel	agent commercieel
agentschap_eigenaar	agentschap eigenaar
agentschap_manager	agentschap manager
agentschap_vertegenwoordiger	agentschap vertegenwoordiger
alarmcentrale	alarmcentrale
alfabetiseringscoach	alfabetiseringscoach
algemeen_directeur	algemeen directeur
algemeen_opzichter	algemeen opzichter
algemeen_veldingenieur	algemeen veldingenieur
algemene_aannemer	algemene aannemer
algemene_tandarts	algemene tandarts
ambtenaar	ambtenaar
ambtenaar_economische_ontwikkeling	ambtenaar economische ontwikkeling
ambtenaar_fondsenwerving	ambtenaar fondsenwerving
ambtenaar_onroerend_goed_lening	ambtenaar onroerend goed lening
ambtenaar_woonkrediet	ambtenaar woonkrediet
analist_bedrijfsbankieren	analist bedrijfsbankieren
analist_bedrijfsfinanciën	analist bedrijfsfinanciën
analist_bedrijfskrediet	analist bedrijfskrediet
analist_bedrijfsontwikkeling	analist bedrijfsontwikkeling
analist_beleggingsprestaties	analist beleggingsprestaties
analist_financiële_markt	analist financiële markt
analist_importeren	analist importeren
analist_informatiebeveiliging	analist informatiebeveiliging
analist_investeringsbankieren	analist investeringsbankieren
analist_klantenondersteuning	analist klantenondersteuning
analist_klantondersteuning	analist klantondersteuning
analist_kredietonderzoek	analist kredietonderzoek
analist_marktgegevens	analist marktgegevens
analist_marktinformatie	analist marktinformatie
analist_netwerk_operations_center	analist netwerk operations center
analist_netwerkbeveiliging	analist netwerkbeveiliging
analist_netwerkondersteuning	analist netwerkondersteuning
analist_particuliere_bank	analist particuliere bank
analist_personeelsinformatiesysteem	analist personeelsinformatiesysteem
analist_portefeuillebeheer	analist portefeuillebeheer
analist_private_banking	analist private banking
analist_private_equity	analist private equity
analist_procesondersteuning	analist procesondersteuning
analist_software_ontwikkeling	analist software ontwikkeling
analist_strategische_planning	analist strategische planning
analist_technische_ondersteuning	analist technische ondersteuning
analist_technologie_ondersteuning	analist technologie ondersteuning
analist_van_beleggingsfondsen	analist van beleggingsfondsen
analist_van_het_besturingssysteem	analist van het besturingssysteem
analist_van_het_ondersteuningscentrum	analist van het ondersteuningscentrum
analist_van_het_servicecentrum	analist van het servicecentrum
analist_vast_inkomen	analist vast inkomen
analist_veldondersteuning	analist veldondersteuning
analist_voor_desktopondersteuning	analist voor desktopondersteuning
analoge_ontwerper	analoge ontwerper
analoog_ontwerper	analoog ontwerper
android-ontwikkelaar	android-ontwikkelaar
anesthesie_technicus	anesthesie technicus
anesthesist_van_het_personeel	anesthesist van het personeel
animatie_artiest	animatie artiest
animatie_begeleider	animatie begeleider
animatie_instructeur	animatie instructeur
animatie_leiden	animatie leiden
animatie_regisseur	animatie regisseur
animatie_stagiaire	animatie stagiaire
animator	animator
anker	anker
apotheek_bewoner	apotheek bewoner
apotheker_op_het_gebied_van_regelgeving	apotheker op het gebied van regelgeving
apothekersassistente	apothekersassistente
applicatie_ingenieur	applicatie ingenieur
applicatie_ondersteuning_technicus	applicatie ondersteuning technicus
applicatie_ontwikkelaar	applicatie ontwikkelaar
applicatie_technoloog	applicatie technoloog
applicatie_tester	applicatie tester
applicatie-engineer_van_het_personeel	applicatie-engineer van het personeel
arbeidsgeneeskundig_verpleegkundige	arbeidsgeneeskundig verpleegkundige
arbeidsrechtadvocaat	arbeidsrechtadvocaat
arbeidsspecialist	arbeidsspecialist
arbiter	arbiter
archieven_assistent	archieven assistent
archieven_stagiair	archieven stagiair
archieven_technicus	archieven technicus
architect	architect
architectonisch_ontwerper	architectonisch ontwerper
architectuur_student	architectuur student
artiest	artiest
artiest_in_residentie	artiest in residentie
artikel_assistent	artikel assistent
artistiek_leider	artistiek leider
arts	arts
arts_interne_geneeskunde	arts interne geneeskunde
arts_spoedeisende_hulp	arts spoedeisende hulp
assistent_advocaat	assistent advocaat
assistent_algemeen_adviseur	assistent algemeen adviseur
assistent_algemeen_directeur	assistent algemeen directeur
assistent_animator	assistent animator
assistent_architect	assistent architect
assistent_archivaris	assistent archivaris
assistent_bankdirecteur	assistent bankdirecteur
assistent_banketbakker	assistent banketbakker
assistent_barmanager	assistent barmanager
assistent_bedrijfsjurist	assistent bedrijfsjurist
assistent_bedrijfssecretaris	assistent bedrijfssecretaris
assistent_bewoner_ingenieur	assistent bewoner ingenieur
assistent_bouwleider	assistent bouwleider
assistent_brandweercommandant	assistent brandweercommandant
assistent_chef	assistent chef
assistent_contentmanager	assistent contentmanager
assistent_decaan_toelating	assistent decaan toelating
assistent_directeur	assistent directeur
assistent_evenementenplanning	assistent evenementenplanning
assistent_fondsmanager	assistent fondsmanager
assistent_fotograaf	assistent fotograaf
assistent_fotografen	assistent fotografen
assistent_frontendmanager	assistent frontendmanager
assistent_frontofficemanager	assistent frontofficemanager
assistent_gemeenschapsrelaties	assistent gemeenschapsrelaties
assistent_grafisch_ontwerp	assistent grafisch ontwerp
assistent_hoofdadviseur	assistent hoofdadviseur
assistent_hoofdpiloot	assistent hoofdpiloot
assistent_horecamanager	assistent horecamanager
assistent_huishoudster	assistent huishoudster
assistent_inkomensmanager	assistent inkomensmanager
assistent_keukenmanager	assistent keukenmanager
assistent_kinderopvang	assistent kinderopvang
assistent_kleuterleidster	assistent kleuterleidster
assistent_kok	assistent kok
assistent_korpschef	assistent korpschef
assistent_kracht-_en_conditietrainer	assistent kracht- en conditietrainer
assistent_locatiemanager	assistent locatiemanager
assistent_management_accountant	assistent management accountant
assistent_manager	assistent manager
assistent_manager_corporate_communicatie	assistent manager corporate communicatie
assistent_manager_eten_en_drinken	assistent manager eten en drinken
assistent_manager_gastenservice	assistent manager gastenservice
assistent_manager_werving	assistent manager werving
assistent_marktmanager	assistent marktmanager
assistent_merkmanager	assistent merkmanager
assistent_nachtmanager	assistent nachtmanager
assistent_nieuwsregisseur	assistent nieuwsregisseur
assistent_officier_van_justitie	assistent officier van justitie
assistent_ontwerper	assistent ontwerper
assistent_outletmanager	assistent outletmanager
assistent_planner	assistent planner
assistent_portefeuillemanager	assistent portefeuillemanager
assistent_private_banker	assistent private banker
assistent_private_banking	assistent private banking
assistent_procureur-generaal	assistent procureur-generaal
assistent_producent	assistent producent
assistent_productie_kantoor	assistent productie kantoor
assistent_productontwikkeling	assistent productontwikkeling
assistent_professor	assistent professor
assistent_projectingenieur	assistent projectingenieur
assistent_receptiemanager	assistent receptiemanager
assistent_redacteur	assistent redacteur
assistent_relatiebeheerder	assistent relatiebeheerder
assistent_reserveringsmanager	assistent reserveringsmanager
assistent_speciaal_onderwijs	assistent speciaal onderwijs
assistent_stadsingenieur	assistent stadsingenieur
assistent_systeem_analist	assistent systeem analist
assistent_technisch_tekenaar	assistent technisch tekenaar
assistent_tekenaar	assistent tekenaar
assistent_terminalmanager	assistent terminalmanager
assistent_van_de_leerkracht	assistent van de leerkracht
assistent_vermogensbeheerder	assistent vermogensbeheerder
assistent_video-editor	assistent video-editor
assistent_voetbaltrainer	assistent voetbaltrainer
assistent_vp	assistent vp
assistent_vp_business_development	assistent vp business development
assistent_vp_van_acceptatie	assistent vp van acceptatie
assistent_vp_van_accountmanager	assistent vp van accountmanager
assistent_werktuigbouwkundig_ingenieur	assistent werktuigbouwkundig ingenieur
assistent-professor_engels	assistent-professor engels
associëren	associëren
assurantiën_assistent	assurantiën assistent
atletische_coördinator	atletische coördinator
audio_producent	audio producent
audiomixer	audiomixer
audit_bediende	audit bediende
auditeur	auditeur
auteur	auteur
automatisering_adviseur	automatisering adviseur
automatisering_ontwikkelaar	automatisering ontwikkelaar
automatisering_specialist	automatisering specialist
automatisering_systeem_ingenieur	automatisering systeem ingenieur
automatisering_technicus	automatisering technicus
automatisering_test_analist	automatisering test analist
avionica_technicus	avionica technicus
baan_voorman	baan voorman
back-end_ontwikkelaar	back-end ontwikkelaar
badmeester	badmeester
bagger	bagger
bakker	bakker
bakker_klerk	bakker klerk
bakkerij_manager	bakkerij manager
baliemedewerker	baliemedewerker
band_directeur	band directeur
bandlid	bandlid
bandmanager	bandmanager
bandoperator	bandoperator
bank_examinator	bank examinator
bank_technicus	bank technicus
bankbediende	bankbediende
banket_begeleider	banket begeleider
banket_chef-kok	banket chef-kok
banket_kapitein	banket kapitein
banket_server	banket server
banketbakker	banketbakker
bankmanager	bankmanager
bankmedewerker	bankmedewerker
bar_bediende	bar bediende
bar_manager	bar manager
bar_opzichter	bar opzichter
barman	barman
barre_instructeur	barre instructeur
basis_beheerder	basis beheerder
basisschoolleerkracht	basisschoolleerkracht
basisschoolleraar	basisschoolleraar
bassist	bassist
bataljon_chef	bataljon chef
bediende	bediende
bediening	bediening
bedrijfsadviseur	bedrijfsadviseur
bedrijfsadvocaat	bedrijfsadvocaat
bedrijfsanalist	bedrijfsanalist
bedrijfsbibliothecaris	bedrijfsbibliothecaris
bedrijfsjuridisch_medewerker	bedrijfsjuridisch medewerker
bedrijfsjurist	bedrijfsjurist
bedrijfsleider_logistiek	bedrijfsleider logistiek
bedrijfsontwikkeling_leiden	bedrijfsontwikkeling leiden
bedrijfspiloot	bedrijfspiloot
bedrijfsrechercheur	bedrijfsrechercheur
beeldbegeleider	beeldbegeleider
beeldend_kunstenaar	beeldend kunstenaar
beeldend_therapeut	beeldend therapeut
beeldende_kunst_fotograaf	beeldende kunst fotograaf
beeldhouwer	beeldhouwer
begeleider	begeleider
begeleider_dagkamp	begeleider dagkamp
begeleider_eten_en_drinken	begeleider eten en drinken
begeleider_gastenservice	begeleider gastenservice
begeleider_mediaplanning	begeleider mediaplanning
begeleider_speciaal_onderwijs	begeleider speciaal onderwijs
begroeter	begroeter
behandelende_arts	behandelende arts
beheerder_fondsenwerving	beheerder fondsenwerving
beheerder_gegevensbeveiliging	beheerder gegevensbeveiliging
beheerder_grafische_diensten	beheerder grafische diensten
beheerder_van_de_servicedesk	beheerder van de servicedesk
beheerder_van_de_voorkant_van_het_huis	beheerder van de voorkant van het huis
beheerder_van_het_lokale_netwerk	beheerder van het lokale netwerk
beheerder_van_netwerkinfrastructuur	beheerder van netwerkinfrastructuur
beheerder_van_woningen	beheerder van woningen
beheerder_vastgoedbelasting	beheerder vastgoedbelasting
beherend_aandeelhouder	beherend aandeelhouder
beherend_makelaar	beherend makelaar
beherend_vennoot	beherend vennoot
belangenbehartiger	belangenbehartiger
belangenbehartiger_van_de_cliënt	belangenbehartiger van de cliënt
belangrijkste_artdirector	belangrijkste artdirector
belangrijkste_geoloog	belangrijkste geoloog
belangrijkste_hardware-engineer	belangrijkste hardware-engineer
belangrijkste_recruiter	belangrijkste recruiter
belasting_administrateur	belasting administrateur
belasting_voorbereider	belasting voorbereider
belastingadviseur_personeel	belastingadviseur personeel
belastingadviseur_vennootschappen	belastingadviseur vennootschappen
belastingconsultant	belastingconsultant
belastingcontroleur	belastingcontroleur
beleggings_specialist	beleggings specialist
beleggingsanalist	beleggingsanalist
beleggingsonderzoek_analist	beleggingsonderzoek analist
beleggingsstrateeg	beleggingsstrateeg
beleidsanalist	beleidsanalist
beleidscoördinator	beleidscoördinator
beleidsmedewerker	beleidsmedewerker
beleidsspecialist	beleidsspecialist
bemiddelaar	bemiddelaar
bestrating_ingenieur	bestrating ingenieur
besturingssysteem_ingenieur	besturingssysteem ingenieur
bestuurder	bestuurder
bestuursrechter	bestuursrechter
beveiligings_ingenieur	beveiligings ingenieur
beveiligingsbeheerder	beveiligingsbeheerder
beveiligingsexpert	beveiligingsexpert
bewoner_anesthesiologie	bewoner anesthesiologie
bewoner_apotheekpraktijk	bewoner apotheekpraktijk
bewoner_interne_geneeskunde	bewoner interne geneeskunde
bezoekende_instructeur	bezoekende instructeur
bibliothecaris	bibliothecaris
bibliothecaris_openbare_diensten	bibliothecaris openbare diensten
bibliotheek_media_specialist	bibliotheek media specialist
bijdragende_schrijver	bijdragende schrijver
bijdrager	bijdrager
binnen_groothandel	binnen groothandel
binnenhuisarchitect_instellen	binnenhuisarchitect instellen
bloemen_beheerder	bloemen beheerder
bloemen_ontwerper	bloemen ontwerper
blogger	blogger
boekhouder	boekhouder
boekhoudkundig_medewerkster	boekhoudkundig medewerkster
boekhoudkundig_personeel	boekhoudkundig personeel
boor	boor
boor_adviseur	boor adviseur
boor_manager	boor manager
boor_opzichter	boor opzichter
boor_supervisor	boor supervisor
boord_exploitant	boord exploitant
bootcamp_instructeur	bootcamp instructeur
bouw_inspecteur	bouw inspecteur
bouw_stagiair	bouw stagiair
bouw_voorman	bouw voorman
bouwer	bouwer
bouwkundig_assistent	bouwkundig assistent
bouwkundig_medewerkster	bouwkundig medewerkster
bouwopzichter	bouwopzichter
bouwtechnisch_ingenieur	bouwtechnisch ingenieur
brandweer_luitenant	brandweer luitenant
brandweercommandant	brandweercommandant
brandweerman	brandweerman
brigadier_van_politie	brigadier van politie
bron	bron
brug_ingenieur	brug ingenieur
bruiloft_adviseur	bruiloft adviseur
bruiloft_coördinator	bruiloft coördinator
bruiningsconsulent	bruiningsconsulent
bsc_ingenieur	bsc ingenieur
buitenlands_juridisch_adviseur	buitenlands juridisch adviseur
buitenlandse_medewerker	buitenlandse medewerker
bureau_recruiter	bureau recruiter
café_beheerder	café beheerder
camera_assistent	camera assistent
cameraman	cameraman
cardioloog	cardioloog
cargadoor	cargadoor
casting_directeur	casting directeur
casting_medewerker	casting medewerker
casting_producent	casting producent
catalogiseerder	catalogiseerder
cateraar	cateraar
certificering_ingenieur	certificering ingenieur
chauffeur_van_het_bedrijf	chauffeur van het bedrijf
cheerleading_instructeur	cheerleading instructeur
chef	chef
chef_de_partie	chef de partie
chef_foodservice	chef foodservice
chef_geoloog	chef geoloog
chef_keuken	chef keuken
chef_marketing_en_communicatie	chef marketing en communicatie
chef_piloot	chef piloot
chef_psycholoog	chef psycholoog
chef_tandarts	chef tandarts
chef_van_de_onderzoeks_officier	chef van de onderzoeks officier
chef_vlieginstructeur	chef vlieginstructeur
chemisch_ingenieur	chemisch ingenieur
chirurg	chirurg
chirurgisch_verpleegkundige	chirurgisch verpleegkundige
choreograaf	choreograaf
circuit_ontwerper	circuit ontwerper
cisco_netwerk_engineer	cisco netwerk engineer
civiel_ontwerper	civiel ontwerper
civiel_technisch_tekenaar	civiel technisch tekenaar
civiel_tekenaar	civiel tekenaar
civiel_toezichthouder	civiel toezichthouder
claimadvocaat	claimadvocaat
clown	clown
cluster_leiden	cluster leiden
co_piloot	co piloot
cocktail_serveerster	cocktail serveerster
cocktail_server	cocktail server
collecties_medewerker	collecties medewerker
collega_cardiologie	collega cardiologie
columnist	columnist
commanditaire_vennoot	commanditaire vennoot
commercieel_analist	commercieel analist
commercieel_makelaar	commercieel makelaar
commerciële_bankier	commerciële bankier
commerciële_coördinator	commerciële coördinator
commerciële_lening_assistent	commerciële lening assistent
commerciële_lijnproducent	commerciële lijnproducent
commerciële_makelaar	commerciële makelaar
commerciële_piloot	commerciële piloot
commerciële_producent	commerciële producent
commerciële_toezichthouder	commerciële toezichthouder
commerciële_verzekeringsagent	commerciële verzekeringsagent
commerciële_verzekeringsmakelaar	commerciële verzekeringsmakelaar
communicatie_adviseur	communicatie adviseur
communicatie_coördinator	communicatie coördinator
communicatie_leiden	communicatie leiden
communicatie_manager	communicatie manager
communicatie_ontwerper	communicatie ontwerper
communicatie_specialist	communicatie specialist
communicatie_technicus	communicatie technicus
componist	componist
computer_netwerk_ingenieur	computer netwerk ingenieur
computer_netwerk_technicus	computer netwerk technicus
computer_ondersteuning_analist	computer ondersteuning analist
computer_service_technicus	computer service technicus
computer_systeem_technicus	computer systeem technicus
computer_technicus	computer technicus
computer_verkoopster	computer verkoopster
computeranimator	computeranimator
computergrafisch_kunstenaar	computergrafisch kunstenaar
concept_artiest	concept artiest
concept_ontwerper	concept ontwerper
concept_ontwikkelaar	concept ontwikkelaar
conciërge	conciërge
conferentie_assistent	conferentie assistent
conferentie_manager	conferentie manager
conferentie_planner	conferentie planner
configuratie_technicus	configuratie technicus
congiërge	congiërge
consultant	consultant
consulterend_psycholoog	consulterend psycholoog
consulterende_geoloog	consulterende geoloog
content_beheerder	content beheerder
content_strateeg	content strateeg
contentmarketingmanager	contentmarketingmanager
contract_advocaat	contract advocaat
contract_geoloog	contract geoloog
contract_java-ontwikkelaar	contract java-ontwikkelaar
contract_piloot	contract piloot
contract_recruiter	contract recruiter
contract_schrijver	contract schrijver
contract_webdeveloper	contract webdeveloper
contract_werktuigbouwkundig_ingenieur	contract werktuigbouwkundig ingenieur
contractfotograaf	contractfotograaf
conventie_coördinator	conventie coördinator
correctie_officier	correctie officier
corrector	corrector
coördinator_academische_opleidingen	coördinator academische opleidingen
coördinator_afstudeerprogramma	coördinator afstudeerprogramma
coördinator_automatisering	coördinator automatisering
coördinator_banket	coördinator banket
coördinator_buitendienst	coördinator buitendienst
coördinator_calamiteitenbeheer	coördinator calamiteitenbeheer
coördinator_congresdiensten	coördinator congresdiensten
coördinator_congressen_en_evenementen	coördinator congressen en evenementen
coördinator_corporate_communicatie	coördinator corporate communicatie
coördinator_donorrelaties	coördinator donorrelaties
coördinator_fondsenwerving	coördinator fondsenwerving
coördinator_gastenservice	coördinator gastenservice
coördinator_gastrelaties	coördinator gastrelaties
coördinator_grafische_vormgeving	coördinator grafische vormgeving
coördinator_groepsreserveringen	coördinator groepsreserveringen
coördinator_handelsmarketing	coördinator handelsmarketing
coördinator_horeca	coördinator horeca
coördinator_hypotheken	coördinator hypotheken
coördinator_interne_communicatie	coördinator interne communicatie
coördinator_internetmarketing	coördinator internetmarketing
coördinator_kunstafdeling	coördinator kunstafdeling
coördinator_marketing_en_communicatie	coördinator marketing en communicatie
coördinator_marketingdiensten	coördinator marketingdiensten
coördinator_ontwikkelingsfondsen	coördinator ontwikkelingsfondsen
coördinator_partnerschappen	coördinator partnerschappen
coördinator_postproductie	coördinator postproductie
coördinator_prestatieverbetering	coördinator prestatieverbetering
coördinator_printproductie	coördinator printproductie
coördinator_public_relations	coördinator public relations
coördinator_public_relations_en_communicatie	coördinator public relations en communicatie
coördinator_publiceren	coördinator publiceren
coördinator_reclameproductie	coördinator reclameproductie
coördinator_reserveringen	coördinator reserveringen
coördinator_salarisadministratie_en_toeslagen	coördinator salarisadministratie en toeslagen
coördinator_stageplaatsen	coördinator stageplaatsen
coördinator_technische_ondersteuning	coördinator technische ondersteuning
coördinator_uitzending	coördinator uitzending
coördinator_vergoedingen_en_voordelen	coördinator vergoedingen en voordelen
creatief_beheerder	creatief beheerder
creatief_ontwerpmanager	creatief ontwerpmanager
creatieve_grafisch_ontwerper	creatieve grafisch ontwerper
creatieve_leiding	creatieve leiding
creatieve_ontwikkelaar	creatieve ontwikkelaar
creatieve_producent	creatieve producent
creatieve_projectleider	creatieve projectleider
creatieve_schrijver	creatieve schrijver
creatieve_stagiaire	creatieve stagiaire
creatieve_tekenaar	creatieve tekenaar
creatieve_tekstschrijver	creatieve tekstschrijver
crimineel_onderzoeker	crimineel onderzoeker
crossfit_instructeur	crossfit instructeur
crèche_assistent	crèche assistent
culinair_beheerder	culinair beheerder
culinair_instructeur	culinair instructeur
curator	curator
dansleraar	dansleraar
data_netwerk_ingenieur	data netwerk ingenieur
database_ontwikkelaar	database ontwikkelaar
datacenter_analist	datacenter analist
datacenter_beheerder	datacenter beheerder
datacenter_exploitant	datacenter exploitant
datacenter_toezichthouder	datacenter toezichthouder
decaan	decaan
decaan_van_de_basisschool	decaan van de basisschool
decaan_van_toelatingen	decaan van toelatingen
decoratie_adviseur	decoratie adviseur
derivaten_handelaar	derivaten handelaar
derivaten_makelaar	derivaten makelaar
derivaten_specialist	derivaten specialist
deskside_support_technicus	deskside support technicus
desktop_beheerder	desktop beheerder
desktop_ingenieur	desktop ingenieur
desktop_ondersteuning	desktop ondersteuning
desktop_ondersteuningstechnicus	desktop ondersteuningstechnicus
desktop_publisher	desktop publisher
desktop_publishing-operator	desktop publishing-operator
deskundige_technische_ondersteuning	deskundige technische ondersteuning
detailhandelaar	detailhandelaar
deviezenbeheerder	deviezenbeheerder
diagnostisch_ingenieur	diagnostisch ingenieur
dieet_manager	dieet manager
dienstdoende_beheerder	dienstdoende beheerder
diensten_voor_particuliere_klanten	diensten voor particuliere klanten
dieren_oppas	dieren oppas
dierenarts	dierenarts
dierenarts_assistent	dierenarts assistent
digitale_accountmanager	digitale accountmanager
digitale_begeleider	digitale begeleider
digitale_contentbeheerder	digitale contentbeheerder
digitale_marketingmanager	digitale marketingmanager
digitale_mediaplanner	digitale mediaplanner
digitale_ontwerper	digitale ontwerper
digitale_ontwerpingenieur	digitale ontwerpingenieur
digitale_planner	digitale planner
digitale_producent	digitale producent
digitale_verkoopmanager	digitale verkoopmanager
directeur	directeur
directeur_aandelenonderzoek	directeur aandelenonderzoek
directeur_bedrijfsbankieren	directeur bedrijfsbankieren
directeur_bedrijfsontwikkeling	directeur bedrijfsontwikkeling
directeur_bedrijfsvoering	directeur bedrijfsvoering
directeur_beeldvormingsdiensten	directeur beeldvormingsdiensten
directeur_belastingdienst	directeur belastingdienst
directeur_cliëntenservice	directeur cliëntenservice
directeur_collecties	directeur collecties
directeur_corporate_en_foundation_relations	directeur corporate en foundation relations
directeur_elektrotechniek	directeur elektrotechniek
directeur_eten_en_drinken	directeur eten en drinken
directeur_evenementenmanagement	directeur evenementenmanagement
directeur_executive_search	directeur executive search
directeur_familiedienst	directeur familiedienst
directeur_fondsenwerving	directeur fondsenwerving
directeur_fondsontwikkeling	directeur fondsontwikkeling
directeur_fotografie	directeur fotografie
directeur_fysiotherapie	directeur fysiotherapie
directeur_gestructureerde_financiën	directeur gestructureerde financiën
directeur_groepsplanning	directeur groepsplanning
directeur_hardware-ontwikkeling	directeur hardware-ontwikkeling
directeur_horeca	directeur horeca
directeur_horeca_verkoop	directeur horeca verkoop
directeur_inschrijving	directeur inschrijving
directeur_inschrijvingsbeheer	directeur inschrijvingsbeheer
directeur_institutionele_verkoop	directeur institutionele verkoop
directeur_juridische_zaken	directeur juridische zaken
directeur_ledenadministratie	directeur ledenadministratie
directeur_marktonderzoek	directeur marktonderzoek
directeur_mediadiensten	directeur mediadiensten
directeur_mediarelaties	directeur mediarelaties
directeur_medische_opleiding	directeur medische opleiding
directeur_menselijk_kapitaal	directeur menselijk kapitaal
directeur_netwerkbeheer	directeur netwerkbeheer
directeur_onderwijs	directeur onderwijs
directeur_ontwerp_en_ontwikkeling	directeur ontwerp en ontwikkeling
directeur_ontwikkeling_en_public_relations	directeur ontwikkeling en public relations
directeur_organisatorische_effectiviteit	directeur organisatorische effectiviteit
directeur_personal_training	directeur personal training
directeur_personeelszaken	directeur personeelszaken
directeur_postproductie	directeur postproductie
directeur_privé-evenementen	directeur privé-evenementen
directeur_procesvoering	directeur procesvoering
directeur_public_relations	directeur public relations
directeur_publiceren	directeur publiceren
directeur_publieksontwikkeling	directeur publieksontwikkeling
directeur_radiologie	directeur radiologie
directeur_sociale_media	directeur sociale media
directeur_speciale_evenementen	directeur speciale evenementen
directeur_strategie_en_bedrijfsvoering	directeur strategie en bedrijfsvoering
directeur_strategische_ontwikkeling	directeur strategische ontwikkeling
directeur_talentontwikkeling	directeur talentontwikkeling
directeur_talentverwerving	directeur talentverwerving
directeur_toelating	directeur toelating
directeur_uitzending_productie	directeur uitzending productie
directeur_uitzendingen	directeur uitzendingen
directeur_van_de_basisschool	directeur van de basisschool
directeur_van_de_groep_media	directeur van de groep media
directeur_van_de_lening	directeur van de lening
directeur_van_geplande_schenkingen	directeur van geplande schenkingen
directeur_van_het_netwerkoperatiecentrum	directeur van het netwerkoperatiecentrum
directeur_van_onderzoeken	directeur van onderzoeken
directeur_van_productieactiviteiten	directeur van productieactiviteiten
directeur_van_speciale_diensten	directeur van speciale diensten
directeur_vaste_inkomsten	directeur vaste inkomsten
directeur_verhuizing	directeur verhuizing
directeur_verkoop_en_marketing	directeur verkoop en marketing
directeur_verzekeringen	directeur verzekeringen
directeur_videoproductie	directeur videoproductie
directeur_vluchtoperaties	directeur vluchtoperaties
directeur_voorbouw	directeur voorbouw
directeur_voorschoolse_opvang	directeur voorschoolse opvang
directeur_vrijetijdsverkoop	directeur vrijetijdsverkoop
directeur_zakelijke_relaties	directeur zakelijke relaties
district_rechter	district rechter
docent	docent
docent_alfabetisering	docent alfabetisering
docent_bedrijfskunde	docent bedrijfskunde
docent_drama	docent drama
docent_grafisch_ontwerp	docent grafisch ontwerp
docent_grafische_vormgeving	docent grafische vormgeving
docent_informatica	docent informatica
docent_kinesiologie	docent kinesiologie
docent_leerondersteuning	docent leerondersteuning
docent_leveren	docent leveren
docent_lezen	docent lezen
docent_sociologie	docent sociologie
docent_taalkunde	docent taalkunde
docent_wetenschappen_secundair	docent wetenschappen secundair
docent_zomerschool	docent zomerschool
documentairemaker	documentairemaker
documentatie_uitvoerend	documentatie uitvoerend
doktersassistent	doktersassistent
doorverwijzende_agent	doorverwijzende agent
draadloze_adviseur	draadloze adviseur
draadloze_ingenieur	draadloze ingenieur
draadloze_netwerk_ingenieur	draadloze netwerk ingenieur
draadloze_productmanager	draadloze productmanager
draadloze_specialist	draadloze specialist
draadloze_technicus	draadloze technicus
drainage_ingenieur	drainage ingenieur
drive_test_ingenieur	drive test ingenieur
edison_engineering_ontwikkelingsprogramma	edison engineering ontwikkelingsprogramma
edison-ingenieur	edison-ingenieur
editor	editor
editorial_director	editorial director
educatieve_diagnosticus	educatieve diagnosticus
eerste_adjunct-directeur	eerste adjunct-directeur
eerste_assistent-camera	eerste assistent-camera
eerste_hulpredacteur	eerste hulpredacteur
eerste_ingenieur	eerste ingenieur
eerste_officier	eerste officier
eerstegraads_schietinstructeur	eerstegraads schietinstructeur
eerstelijns_ondersteuning	eerstelijns ondersteuning
eigen_handelaar	eigen handelaar
elektromechanisch_ingenieur	elektromechanisch ingenieur
elektronisch_ontwerp_ingenieur	elektronisch ontwerp ingenieur
elektronische_ontwerper	elektronische ontwerper
elektronische_specialist	elektronische specialist
elektronische_systeemingenieur	elektronische systeemingenieur
elektronische_verkoopmedewerker	elektronische verkoopmedewerker
elektrotechniek	elektrotechniek
elektrotechnisch_en_elektronisch_ingenieur	elektrotechnisch en elektronisch ingenieur
elektrotechnisch_ingenieur	elektrotechnisch ingenieur
elementaire_hoofdsom	elementaire hoofdsom
emeritus_hoogleraar	emeritus hoogleraar
endodontist	endodontist
engelse_vertaler	engelse vertaler
engelstalige_tekenleraar	engelstalige tekenleraar
enterprise_ingenieur	enterprise ingenieur
enterprise_netwerk_ingenieur	enterprise netwerk ingenieur
entertainer	entertainer
enthousiaste_redacteur	enthousiaste redacteur
erkend_makelaar	erkend makelaar
erkend_professioneel_adviseur	erkend professioneel adviseur
erkend_verkoopmakelaar	erkend verkoopmakelaar
erkend_verzekeringsagent	erkend verzekeringsagent
erkende_huwelijks-_en_gezinstherapeut	erkende huwelijks- en gezinstherapeut
escrow_assistent	escrow assistent
evenement_fotograaf	evenement fotograaf
evenement_manager	evenement manager
evenement_ontwerper	evenement ontwerper
evenement_specialist	evenement specialist
evenement_uitvoerend	evenement uitvoerend
evenementen_adviseur	evenementen adviseur
evenementen_coördinator	evenementen coördinator
evenementenplanner	evenementenplanner
eventmanager_horeca	eventmanager horeca
exclusieve_agent	exclusieve agent
executive_search_adviseur	executive search adviseur
executive_team_lead_guest_experience	executive team lead guest experience
executive_vp_van_bedrijfsontwikkeling	executive vp van bedrijfsontwikkeling
export_officier	export officier
export_verkoopmedewerker	export verkoopmedewerker
export_vertegenwoordiger	export vertegenwoordiger
exportmanager	exportmanager
exportspecialist	exportspecialist
externe_communicatiemanager	externe communicatiemanager
externe_examinator	externe examinator
externe_raadsman	externe raadsman
facultair_adviseur	facultair adviseur
faillissement_specialist	faillissement specialist
favoriete_bankier	favoriete bankier
federale_agent	federale agent
federale_belastingadviseur	federale belastingadviseur
film_producent	film producent
film_regisseur	film regisseur
film-_en_video-editor	film- en video-editor
film-editor	film-editor
filmcomponist	filmcomponist
filmmaker	filmmaker
financieel_analist	financieel analist
financier	financier
financiering_analist	financiering analist
financiële_journalist	financiële journalist
financiële_makelaar	financiële makelaar
financiële_recruiter	financiële recruiter
financiële_schrijver	financiële schrijver
financiële_vertegenwoordiger	financiële vertegenwoordiger
firewall_ingenieur	firewall ingenieur
fiscaal_advocaat	fiscaal advocaat
fiscaal_analist	fiscaal analist
fiscaal_beheerder	fiscaal beheerder
fiscaal_compliance_manager	fiscaal compliance manager
fiscaal_medewerkster	fiscaal medewerkster
fiscaal_specialist	fiscaal specialist
fiscaal_technicus	fiscaal technicus
fiscaal_toezichthouder	fiscaal toezichthouder
fiscale_hoofdsom	fiscale hoofdsom
fitness_adviseur	fitness adviseur
fitness_coach	fitness coach
fitness_coördinator	fitness coördinator
fitness_directeur	fitness directeur
fitness_manager	fitness manager
fitness_specialist	fitness specialist
fitness_trainer	fitness trainer
flash-animator	flash-animator
fokker	fokker
fonds_analist	fonds analist
fondsbeheerder	fondsbeheerder
forensisch_psycholoog	forensisch psycholoog
foto_specialist	foto specialist
foto_stylist	foto stylist
foto_technicus	foto technicus
fotobewerker	fotobewerker
fotograaf_van_het_personeel	fotograaf van het personeel
fotografie_beheerder	fotografie beheerder
fotolaboratorium_technicus	fotolaboratorium technicus
fraude_onderzoeker	fraude onderzoeker
front_office_manager	front office manager
frontend_supervisor	frontend supervisor
frontoffice_medewerker	frontoffice medewerker
full-stack_ingenieur	full-stack ingenieur
fulltime_faculteit	fulltime faculteit
functionaris_informatiebeveiliging	functionaris informatiebeveiliging
functionaris_private_banking	functionaris private banking
fysiek_ontwerpmanager	fysiek ontwerpmanager
fysieke_ontwerper	fysieke ontwerper
fysisch_ontwerp_ingenieur	fysisch ontwerp ingenieur
galerie_assistent	galerie assistent
galerie_coördinator	galerie coördinator
galerie_medewerkster	galerie medewerkster
galerij_beheerder	galerij beheerder
garderobe_stylist	garderobe stylist
gastartiest	gastartiest
gastdocent	gastdocent
gastheer	gastheer
gastvrijheid_coördinator	gastvrijheid coördinator
gebied_verkoop_ingenieur	gebied verkoop ingenieur
gebieds_algemeen_directeur	gebieds algemeen directeur
gebiedsbeheerder_collecties	gebiedsbeheerder collecties
gebiedscoach	gebiedscoach
gebiedsmanager_export	gebiedsmanager export
gebiedstechnisch_manager	gebiedstechnisch manager
gebreide_ontwerper	gebreide ontwerper
gecertificeerd_klinisch_onderzoekscoördinator	gecertificeerd klinisch onderzoekscoördinator
gecertificeerd_vastgoed_taxateur	gecertificeerd vastgoed taxateur
gecertificeerd_woningtaxateur	gecertificeerd woningtaxateur
gecertificeerde_publieke_accountant	gecertificeerde publieke accountant
gecharterd_financieel_analist	gecharterd financieel analist
geclassificeerde_advertentiemanager	geclassificeerde advertentiemanager
gediplomeerd_acupuncturist	gediplomeerd acupuncturist
gediplomeerd_apothekersassistent	gediplomeerd apothekersassistent
gediplomeerd_architect	gediplomeerd architect
gediplomeerd_burgerlijk_ingenieur	gediplomeerd burgerlijk ingenieur
gediplomeerd_geestelijk_verzorger	gediplomeerd geestelijk verzorger
gediplomeerd_hypotheekadviseur	gediplomeerd hypotheekadviseur
gediplomeerd_klinisch_maatschappelijk_werker	gediplomeerd klinisch maatschappelijk werker
gediplomeerd_klinisch_psycholoog	gediplomeerd klinisch psycholoog
gediplomeerd_makelaar_in_onroerend_goed	gediplomeerd makelaar in onroerend goed
gediplomeerd_personal_trainer	gediplomeerd personal trainer
gediplomeerd_praktijkverpleegkundige	gediplomeerd praktijkverpleegkundige
gediplomeerd_psycholoog	gediplomeerd psycholoog
gediplomeerd_werktuigbouwkundig_ingenieur	gediplomeerd werktuigbouwkundig ingenieur
gediplomeerde_hypotheekplanner	gediplomeerde hypotheekplanner
gediplomeerde_juridische_stagiair	gediplomeerde juridische stagiair
gediplomeerde_klinische_professionele_counselor	gediplomeerde klinische professionele counselor
gediplomeerde_makelaar	gediplomeerde makelaar
gediplomeerde_student_instructeur	gediplomeerde student instructeur
gediplomeerde_vastgoedprofessional	gediplomeerde vastgoedprofessional
gediplomeerde_verpleeghulp	gediplomeerde verpleeghulp
gedragsgezondheidstechnicus	gedragsgezondheidstechnicus
geletterdheid_specialist	geletterdheid specialist
geluids_ingenieur	geluids ingenieur
geluidsmixer	geluidsmixer
geluidstechnicus	geluidstechnicus
gemeentelijke_ingenieur	gemeentelijke ingenieur
geologisch_ingenieur	geologisch ingenieur
geologische_technicus	geologische technicus
geoloog	geoloog
geowetenschapper	geowetenschapper
gerechtelijk_assistent	gerechtelijk assistent
gerechtsadvocaat	gerechtsadvocaat
gerechtsambtenaar	gerechtsambtenaar
gerechtsdeurwaarder	gerechtsdeurwaarder
gereedschap_ontwikkelaar	gereedschap ontwikkelaar
geregistreerd_mondhygiënist	geregistreerd mondhygiënist
geregistreerd_veterinair_technicus	geregistreerd veterinair technicus
geregistreerde_tandartsassistente	geregistreerde tandartsassistente
geschiedenis_leraar	geschiedenis leraar
gestructureerde_financiële_analist	gestructureerde financiële analist
gevorderde_praktijkondersteuner	gevorderde praktijkondersteuner
gevorderde_systeembeheerder	gevorderde systeembeheerder
gezagvoerder	gezagvoerder
gezinsadviseur	gezinsadviseur
gezinsondersteuner	gezinsondersteuner
gezondheids-_en_fitnessspecialist	gezondheids- en fitnessspecialist
gezondheidsassistent	gezondheidsassistent
gezondheidsbezoeker	gezondheidsbezoeker
geïntegreerde_marketingmanager	geïntegreerde marketingmanager
gitaar_leraar	gitaar leraar
gitaarspeler	gitaarspeler
gitarist	gitarist
globale_bedrijfsontwikkelingsmanager	globale bedrijfsontwikkelingsmanager
goed_ingenieur	goed ingenieur
graficus	graficus
grafisch_productiekunstenaar	grafisch productiekunstenaar
grafisch_specialist	grafisch specialist
grafisch_technicus	grafisch technicus
grafisch_vormgever	grafisch vormgever
groep_hr-manager	groep hr-manager
groep_uitgever	groep uitgever
groepsbegeleider	groepsbegeleider
groepsbegeleider_kunst	groepsbegeleider kunst
groepshoofd_van_hr	groepshoofd van hr
groepsjurist	groepsjurist
groepsleider_kopieerwerk	groepsleider kopieerwerk
groepsleider_logistiek	groepsleider logistiek
groepsleider_techniek	groepsleider techniek
grondstoffen_analist	grondstoffen analist
grote_accountmanager	grote accountmanager
grote_geschenken_manager	grote geschenken manager
haar_stylist	haar stylist
haar-_en_visagiste	haar- en visagiste
handelaar	handelaar
handelaar_in_aandelen	handelaar in aandelen
handelaar_in_aandelenderivaten	handelaar in aandelenderivaten
handelaar_in_aandelenopties	handelaar in aandelenopties
handelaar_in_eigen_aandelen	handelaar in eigen aandelen
handelaar_in_futures	handelaar in futures
handelaar_in_vastrentende_waarden	handelaar in vastrentende waarden
handels_assistent	handels assistent
handels_directeur	handels directeur
handelsadvocaat	handelsadvocaat
handelsmarketing_assistent	handelsmarketing assistent
handelspartner	handelspartner
handelsspecialist	handelsspecialist
hardware_engineer	hardware engineer
hardware_ontwerp_ingenieur	hardware ontwerp ingenieur
hardware_ontwerper	hardware ontwerper
hardware_ontwikkelaar	hardware ontwikkelaar
hardware_specialist	hardware specialist
hardware_systeem_ingenieur	hardware systeem ingenieur
hardware_technicus	hardware technicus
hardware-ondersteuningstechnicus	hardware-ondersteuningstechnicus
haven_ingenieur	haven ingenieur
hedge_fund_analist	hedge fund analist
helpdesk_begeleider	helpdesk begeleider
helpdesk_beheerder	helpdesk beheerder
helpdesk_coördinator	helpdesk coördinator
helpdesk_medewerker	helpdesk medewerker
helpdesk_monteur	helpdesk monteur
helpdesk_ondersteuning_analist	helpdesk ondersteuning analist
helpdesk_technicus	helpdesk technicus
helpdesk-analist	helpdesk-analist
herbergier	herbergier
herborist	herborist
heropnamemixer	heropnamemixer
herverzekeringsmakelaar	herverzekeringsmakelaar
het_beveiligingstechnicus	het beveiligingstechnicus
het_generalistisch	het generalistisch
het_ondersteunt_technicus	het ondersteunt technicus
het_recruiter	het recruiter
het_systeem_ingenieur	het systeem ingenieur
het_technicus	het technicus
hoffelijke_bediende	hoffelijke bediende
hoger_bestuurslid	hoger bestuurslid
hondentrainer	hondentrainer
hondenuitlater	hondenuitlater
hoofd_aandelenonderzoek	hoofd aandelenonderzoek
hoofd_acceptant	hoofd acceptant
hoofd_accountant	hoofd accountant
hoofd_afdeling_logistiek	hoofd afdeling logistiek
hoofd_barman	hoofd barman
hoofd_bedrijfsbankieren	hoofd bedrijfsbankieren
hoofd_bedrijfsfinanciën	hoofd bedrijfsfinanciën
hoofd_bedrijfsontwikkeling	hoofd bedrijfsontwikkeling
hoofd_bedrijfsvoering_filiaal	hoofd bedrijfsvoering filiaal
hoofd_belegging	hoofd belegging
hoofd_beleidsmedewerker	hoofd beleidsmedewerker
hoofd_beveiligingstechnicus	hoofd beveiligingstechnicus
hoofd_bevoorrading	hoofd bevoorrading
hoofd_bewaarder	hoofd bewaarder
hoofd_bewoner	hoofd bewoner
hoofd_bibliothecaris	hoofd bibliothecaris
hoofd_cassiere	hoofd cassiere
hoofd_civiel_ingenieur	hoofd civiel ingenieur
hoofd_coach	hoofd coach
hoofd_creatief_directeur	hoofd creatief directeur
hoofd_digitale_media	hoofd digitale media
hoofd_distributie	hoofd distributie
hoofd_elektrotechniek	hoofd elektrotechniek
hoofd_financiële_instellingen	hoofd financiële instellingen
hoofd_fondsenwerving	hoofd fondsenwerving
hoofd_gestructureerde_financiën	hoofd gestructureerde financiën
hoofd_grafisch_vormgever	hoofd grafisch vormgever
hoofd_handel	hoofd handel
hoofd_handelaar	hoofd handelaar
hoofd_huishouding	hoofd huishouding
hoofd_hydrogeoloog	hoofd hydrogeoloog
hoofd_inhoud	hoofd inhoud
hoofd_instructeur	hoofd instructeur
hoofd_juridisch_adviseur	hoofd juridisch adviseur
hoofd_juridische_afdeling	hoofd juridische afdeling
hoofd_juridische_en_bedrijfssecretaris	hoofd juridische en bedrijfssecretaris
hoofd_juridische_zaken	hoofd juridische zaken
hoofd_klantenbeheer	hoofd klantenbeheer
hoofd_kopiëren	hoofd kopiëren
hoofd_kredietfunctionaris	hoofd kredietfunctionaris
hoofd_kredietverstrekker	hoofd kredietverstrekker
hoofd_landschapsarchitect	hoofd landschapsarchitect
hoofd_logistiek	hoofd logistiek
hoofd_medische_dienst	hoofd medische dienst
hoofd_middenstand	hoofd middenstand
hoofd_netwerkoperaties	hoofd netwerkoperaties
hoofd_onderzoeker	hoofd onderzoeker
hoofd_onroerend_goed	hoofd onroerend goed
hoofd_ontwerpafdeling	hoofd ontwerpafdeling
hoofd_ontwerper	hoofd ontwerper
hoofd_ontwerpstudio	hoofd ontwerpstudio
hoofd_operaties	hoofd operaties
hoofd_portefeuillemanager	hoofd portefeuillemanager
hoofd_postproductie	hoofd postproductie
hoofd_private_banking	hoofd private banking
hoofd_projectfinanciering	hoofd projectfinanciering
hoofd_public_relations	hoofd public relations
hoofd_reclame	hoofd reclame
hoofd_redactie_productie	hoofd redactie productie
hoofd_rekrutering	hoofd rekrutering
hoofd_risicofunctionaris	hoofd risicofunctionaris
hoofd_server	hoofd server
hoofd_software-engineer	hoofd software-engineer
hoofd_steward	hoofd steward
hoofd_strategische_ontwikkeling	hoofd strategische ontwikkeling
hoofd_talentmanagement	hoofd talentmanagement
hoofd_telecommunicatie	hoofd telecommunicatie
hoofd_uitgeverij	hoofd uitgeverij
hoofd_van_de_afdeling_public_relations	hoofd van de afdeling public relations
hoofd_van_de_mediagroep	hoofd van de mediagroep
hoofd_van_de_politie	hoofd van de politie
hoofd_van_het_beleid	hoofd van het beleid
hoofd_van_het_bureau	hoofd van het bureau
hoofd_van_hr	hoofd van hr
hoofd_verkoop_en_handel	hoofd verkoop en handel
hoofd_vermogensbeheer	hoofd vermogensbeheer
hoofd_verslaggever	hoofd verslaggever
hoofd_verzekeringen	hoofd verzekeringen
hoofd_voetbaltrainer	hoofd voetbaltrainer
hoofd_webontwikkeling	hoofd webontwikkeling
hoofd_werktuigbouwkundig_ingenieur	hoofd werktuigbouwkundig ingenieur
hoofdadvocaat	hoofdadvocaat
hoofdbankier	hoofdbankier
hoofdconservator	hoofdconservator
hoofdcontroleur	hoofdcontroleur
hoofdcorrespondent	hoofdcorrespondent
hoofddanser	hoofddanser
hoofdingenieur_elektrotechniek	hoofdingenieur elektrotechniek
hoofdkelner	hoofdkelner
hoofdkok	hoofdkok
hoofdonderwijzer	hoofdonderwijzer
hoofdonderzoeker	hoofdonderzoeker
hoofdontwerper	hoofdontwerper
hoofdredacteur	hoofdredacteur
hoofdredactie	hoofdredactie
hoogleraar_antropologie	hoogleraar antropologie
hoogleraar_architectuur	hoogleraar architectuur
hoogleraar_chirurgie	hoogleraar chirurgie
hoogleraar_engels	hoogleraar engels
hoogleraar_filosofie	hoogleraar filosofie
hoogleraar_kunst	hoogleraar kunst
hoogleraar_onderwijs	hoogleraar onderwijs
hoogleraar_politieke_wetenschappen	hoogleraar politieke wetenschappen
hoogleraar_sociologie	hoogleraar sociologie
hoogleraar_wiskunde	hoogleraar wiskunde
horeca_begeleider	horeca begeleider
horeca_kok	horeca kok
horeca_manager	horeca manager
horeca_medewerker	horeca medewerker
hr_adviseur	hr adviseur
hr_analist	hr analist
hr_generalist	hr generalist
hr_informatiesysteem_analist	hr informatiesysteem analist
hr_medewerker	hr medewerker
hr_recruiter	hr recruiter
hr_recruitment_specialist	hr recruitment specialist
hr_wervingsassistent	hr wervingsassistent
hr_wervingscoördinator	hr wervingscoördinator
hr_zaken_partner	hr zaken partner
hr-coördinator	hr-coördinator
hr-manager	hr-manager
html5-ontwikkelaar	html5-ontwikkelaar
huis_opzichter	huis opzichter
huisarts	huisarts
huishoudster	huishoudster
hulp_advocaat	hulp advocaat
hulp_sheriff	hulp sheriff
hulpkelner	hulpkelner
hulpofficier_van_justitie	hulpofficier van justitie
huwelijks-_en_evenementenplanner	huwelijks- en evenementenplanner
huwelijks-_en_gezinstherapeut	huwelijks- en gezinstherapeut
hydroloog	hydroloog
hypotheek_bankier	hypotheek bankier
hypotheek_makelaar	hypotheek makelaar
hypotheek_medewerkster	hypotheek medewerkster
hypotheek_specialist	hypotheek specialist
hypotheek_verzekeraar	hypotheek verzekeraar
hypotheekadviseur	hypotheekadviseur
hypotheekverstrekker	hypotheekverstrekker
illustrator	illustrator
implementatie_ingenieur	implementatie ingenieur
import_afdeling	import afdeling
import_coördinator	import coördinator
import_export_assistent	import export assistent
import_export_coördinator	import export coördinator
import_specialist	import specialist
import-_en_exportanalist	import- en exportanalist
import-exportmanager	import-exportmanager
importeur	importeur
inbedrijfstellingsmanager	inbedrijfstellingsmanager
incasso_medewerker	incasso medewerker
incasso_stagiaire	incasso stagiaire
individuele_schenkingsmanager	individuele schenkingsmanager
indoor_cycling_instructeur	indoor cycling instructeur
informatie_systeem_analist	informatie systeem analist
informatiebeveiligingsbeheerder	informatiebeveiligingsbeheerder
ingebedde_systeemingenieur	ingebedde systeemingenieur
ingenieur_bedrijfsapplicaties	ingenieur bedrijfsapplicaties
ingenieur_circuitontwerp	ingenieur circuitontwerp
ingenieur_computerhardware	ingenieur computerhardware
ingenieur_elektronische_ontwikkeling	ingenieur elektronische ontwikkeling
ingenieur_elektrotechniek_en_instrumentatie	ingenieur elektrotechniek en instrumentatie
ingenieur_firmware-ontwerp	ingenieur firmware-ontwerp
ingenieur_hardware-ontwikkeling	ingenieur hardware-ontwikkeling
ingenieur_informatiebeveiliging	ingenieur informatiebeveiliging
ingenieur_intellectueel_eigendom	ingenieur intellectueel eigendom
ingenieur_machinebouw	ingenieur machinebouw
ingenieur_netwerkinfrastructuur	ingenieur netwerkinfrastructuur
ingenieur_netwerkplanning	ingenieur netwerkplanning
ingenieur_procesautomatisering	ingenieur procesautomatisering
ingenieur_radioplanning	ingenieur radioplanning
ingenieur_signaalintegriteit	ingenieur signaalintegriteit
ingenieur_softwareontwikkeling	ingenieur softwareontwikkeling
ingenieur_veldoperaties	ingenieur veldoperaties
ingenieur_voor_softwarekwaliteitsborging	ingenieur voor softwarekwaliteitsborging
ingenieur_voor_webontwikkeling	ingenieur voor webontwikkeling
inhoud_analist	inhoud analist
inhoud_ontwikkelaar	inhoud ontwikkelaar
inhoud_producent	inhoud producent
inhoud_schrijver	inhoud schrijver
inhoudelijk_begeleider	inhoudelijk begeleider
inkomsten_agent	inkomsten agent
innovatie_ingenieur	innovatie ingenieur
inspecteur_van_de_marine	inspecteur van de marine
institutionele_verkoop_handelaar	institutionele verkoop handelaar
instructeur_aquarobics	instructeur aquarobics
instructeur_boekhouding	instructeur boekhouding
instructeur_groepsfitness	instructeur groepsfitness
instructeur_verpleegkunde	instructeur verpleegkunde
instructie_coach	instructie coach
instructieve_assistent	instructieve assistent
intensive_care_verpleegkundige	intensive care verpleegkundige
intensivist	intensivist
interactieve_artdirector	interactieve artdirector
interactieve_mediabeheerder	interactieve mediabeheerder
interactieve_ontwikkelaar	interactieve ontwikkelaar
interactieve_producent	interactieve producent
interactieve_verkoopmanager	interactieve verkoopmanager
interieur_ontwerper	interieur ontwerper
intermediaire_architect	intermediaire architect
intern	intern
internationaal_logistiek_manager	internationaal logistiek manager
internationale_advocaat	internationale advocaat
internationale_handelsspecialist	internationale handelsspecialist
internationale_inkoopmanager	internationale inkoopmanager
internationale_logistieke_coördinator	internationale logistieke coördinator
internationale_pr-manager	internationale pr-manager
internationale_recruiter	internationale recruiter
internationale_reisadviseur	internationale reisadviseur
interne_inkomsten_agent	interne inkomsten agent
interne_recruiter	interne recruiter
interne_vertaler	interne vertaler
internetbeheerder	internetbeheerder
inval_leraar	inval leraar
inventaris_manager	inventaris manager
invoer_manager	invoer manager
inwonende_geneesheer	inwonende geneesheer
inwoner	inwoner
inzet_technicus	inzet technicus
ios-app-ontwikkelaar	ios-app-ontwikkelaar
it_consultant	it consultant
it_specialist	it specialist
it_technische_recruiter	it technische recruiter
it-beveiligingsanalist	it-beveiligingsanalist
it-beveiligingsbeheerder	it-beveiligingsbeheerder
it-ondersteuningsspecialist	it-ondersteuningsspecialist
it-veldtechnicus	it-veldtechnicus
it-wervingsadviseur	it-wervingsadviseur
italiaanse_leraar	italiaanse leraar
j2ee-ontwikkelaar	j2ee-ontwikkelaar
jaarlijkse_fondsbeheerder	jaarlijkse fondsbeheerder
jaarlijkse_schenkingsmanager	jaarlijkse schenkingsmanager
japanse_vertaler	japanse vertaler
java_/_j2ee-ontwikkelaar	java / j2ee-ontwikkelaar
java_technische_leider	java technische leider
java-adviseur	java-adviseur
java-applicatie_ontwikkelaar	java-applicatie ontwikkelaar
java-architect	java-architect
java-ontwikkelaar	java-ontwikkelaar
java-software-engineer	java-software-engineer
java-teamleider	java-teamleider
java-webontwikkelaar	java-webontwikkelaar
juridisch_adviseur	juridisch adviseur
juridisch_coördinator	juridisch coördinator
juridisch_medewerker_en_compliance_officer	juridisch medewerker en compliance officer
juridisch_onderzoeker	juridisch onderzoeker
juridisch_persoonlijk_assistent	juridisch persoonlijk assistent
juridisch_secretaresse	juridisch secretaresse
juridisch_specialist	juridisch specialist
juridisch_wervingsadviseur	juridisch wervingsadviseur
juridische_medewerker	juridische medewerker
juridische_redacteur	juridische redacteur
juridische_uitvoerende	juridische uitvoerende
jurist	jurist
kaakchirurg_en_maxillofaciale_chirurg	kaakchirurg en maxillofaciale chirurg
kalibratie_ingenieur	kalibratie ingenieur
kantoor_beherend_vennoot	kantoor beherend vennoot
kapitaalmarkt_analist	kapitaalmarkt analist
kapitein_trainen	kapitein trainen
kapitein_van_de_luchtvaartmaatschappij	kapitein van de luchtvaartmaatschappij
kapper	kapper
karakter_artiest	karakter artiest
karakter_modelleur	karakter modelleur
karakter_ontwerper	karakter ontwerper
karakter_rigger	karakter rigger
karakter_technisch_directeur	karakter technisch directeur
kassa	kassa
kassier	kassier
kenmerken_schrijver	kenmerken schrijver
kennel_assistent	kennel assistent
kern_ingenieur	kern ingenieur
kern_netwerk_ingenieur	kern netwerk ingenieur
kernnetwerkbeheerder	kernnetwerkbeheerder
ketenfunctionaris	ketenfunctionaris
keuken_assistent	keuken assistent
keuken_manager	keuken manager
keukenpersoneel	keukenpersoneel
kinderarts	kinderarts
kinderverpleegkundige	kinderverpleegkundige
kinderverzorgster	kinderverzorgster
klant_accountant	klant accountant
klantenservice_klantenservice	klantenservice klantenservice
klantenservice_specialist	klantenservice specialist
klantenservice_technicus	klantenservice technicus
klas_assistent	klas assistent
klas_leraar	klas leraar
kleding_ontwerper	kleding ontwerper
klerk_opleveren	klerk opleveren
kleur_specialist	kleur specialist
kleuterjuf	kleuterjuf
kleuterleidster	kleuterleidster
klinisch_adviseur	klinisch adviseur
klinisch_begeleider	klinisch begeleider
klinisch_hoofddocent	klinisch hoofddocent
klinisch_ingenieur	klinisch ingenieur
klinisch_maatschappelijk_werker	klinisch maatschappelijk werker
klinisch_onderzoekscoördinator	klinisch onderzoekscoördinator
klinisch_personeel_apotheker	klinisch personeel apotheker
klinisch_therapeut	klinisch therapeut
klinische_apotheker	klinische apotheker
klinische_instructeur	klinische instructeur
klinische_psycholoog	klinische psycholoog
klinische_verbinding	klinische verbinding
kluis_beheerder	kluis beheerder
koken	koken
kook_instructeur	kook instructeur
koper_instructeur	koper instructeur
kopers_makelaar	kopers makelaar
kopie_beheerder	kopie beheerder
kopieer_begeleider	kopieer begeleider
kopieer_directeur	kopieer directeur
korporaal	korporaal
kosten_beheerder	kosten beheerder
kracht-_en_conditietrainer	kracht- en conditietrainer
krediet_officier	krediet officier
krediet_specialist	krediet specialist
krediet_toezichthouder	krediet toezichthouder
krediet_vertegenwoordiger	krediet vertegenwoordiger
kredietanalist	kredietanalist
kruidenier_klerk	kruidenier klerk
kunst_adviseur	kunst adviseur
kunst_behandelaar	kunst behandelaar
kunst_handelaar	kunst handelaar
kunst_specialist	kunst specialist
kunstcriticus	kunstcriticus
kunstdirecteur	kunstdirecteur
kunstenaar	kunstenaar
kunstenaar_met_visuele_effecten	kunstenaar met visuele effecten
kwaliteitsborging_automatiseringsingenieur	kwaliteitsborging automatiseringsingenieur
kwaliteitsborgingstechnoloog	kwaliteitsborgingstechnoloog
kwaliteitscontroleur	kwaliteitscontroleur
lader	lader
lagere_school_leraar	lagere school leraar
landbouwingenieur	landbouwingenieur
landelijk_hr-manager	landelijk hr-manager
landelijk_zakelijk_leider	landelijk zakelijk leider
landelijke_logistiek_manager	landelijke logistiek manager
landelijke_recruiter	landelijke recruiter
landelijke_vervoerder	landelijke vervoerder
landelijke_vervoerder_medewerker	landelijke vervoerder medewerker
landschap_ontwerper	landschap ontwerper
landschaps_architect	landschaps architect
lay-out_artiest	lay-out artiest
lay-out_ingenieur	lay-out ingenieur
lay-out_ontwerper	lay-out ontwerper
leerkracht_kinderopvang	leerkracht kinderopvang
lees_specialist	lees specialist
leescoach	leescoach
leiding_geven_aan_personeel	leiding geven aan personeel
leidinggevende_frontoffice	leidinggevende frontoffice
leidinggevende_leidinggevende	leidinggevende leidinggevende
lening_coördinator	lening coördinator
lening_dichterbij	lening dichterbij
lening_klerk	lening klerk
lening_specialist	lening specialist
lening_vertegenwoordiger	lening vertegenwoordiger
lening_verwerker	lening verwerker
leraar_basisonderwijs	leraar basisonderwijs
leraar_biologie	leraar biologie
leraar_engels	leraar engels
leraar_engels_secundair	leraar engels secundair
leraar_engels_vreemde_taal	leraar engels vreemde taal
leraar_in_de_vroege_kinderjaren	leraar in de vroege kinderjaren
leraar_kinderopvang	leraar kinderopvang
leraar_lezen	leraar lezen
leraar_middelbare_school	leraar middelbare school
leraar_openbare_school	leraar openbare school
leraar_secundair	leraar secundair
leraar_wiskunde_middelbare_school	leraar wiskunde middelbare school
leven_verzekeraar	leven verzekeraar
levensstijl_redacteur	levensstijl redacteur
leveraged_financieel_analist	leveraged financieel analist
lid_van_de_raad_van_advies	lid van de raad van advies
lid_van_de_technische_staf	lid van de technische staf
lid_van_het_korps	lid van het korps
lid_van_het_verkoopteam	lid van het verkoopteam
lidmaatschap_adviseur	lidmaatschap adviseur
lijn_chef-kok	lijn chef-kok
lijn_koken	lijn koken
lijn_piloot	lijn piloot
lijn_producent	lijn producent
linguïst	linguïst
locatie_beheerder	locatie beheerder
locatie_manager	locatie manager
logistiek	logistiek
logistiek_accountmanager	logistiek accountmanager
logistiek_adviseur	logistiek adviseur
logistiek_agent	logistiek agent
logistiek_analist	logistiek analist
logistiek_assistent	logistiek assistent
logistiek_begeleider	logistiek begeleider
logistiek_beheerder	logistiek beheerder
logistiek_controleur	logistiek controleur
logistiek_coördinator	logistiek coördinator
logistiek_deskundige	logistiek deskundige
logistiek_directeur	logistiek directeur
logistiek_ingenieur	logistiek ingenieur
logistiek_medewerker	logistiek medewerker
logistiek_medewerkster	logistiek medewerkster
logistiek_planner	logistiek planner
lokale_verkoopmanager	lokale verkoopmanager
lokale_verkoopmedewerker	lokale verkoopmedewerker
lokalisatie_specialist	lokalisatie specialist
luchtvaart_ingenieur	luchtvaart ingenieur
luitenant	luitenant
luitenant_van_politie	luitenant van politie
magazijn_en_logistiek_manager	magazijn en logistiek manager
magazijn_medewerkster	magazijn medewerkster
magazijn_specialist	magazijn specialist
magazijn-_en_distributiemanager	magazijn- en distributiemanager
magazijnarbeider	magazijnarbeider
magazijnbeheerder	magazijnbeheerder
magazijnmedewerker	magazijnmedewerker
mail_verwerker	mail verwerker
majoor_met_pensioen	majoor met pensioen
makelaar	makelaar
makelaar_assistent	makelaar assistent
makelaar_in_aandelenderivaten	makelaar in aandelenderivaten
makelaar_in_futures	makelaar in futures
makelaar_medewerker	makelaar medewerker
makelaar_verkoop_medewerkster	makelaar verkoop medewerkster
makelaardij_specialist	makelaardij specialist
management_adviseur	management adviseur
manager_bedrijfsontwikkeling	manager bedrijfsontwikkeling
manager_conferentiediensten	manager conferentiediensten
manager_congrescentrum	manager congrescentrum
manager_creatieve_dienstverlening	manager creatieve dienstverlening
manager_donorrelaties	manager donorrelaties
manager_gastrelaties	manager gastrelaties
manager_geavanceerde_diensten	manager geavanceerde diensten
manager_grondoperaties	manager grondoperaties
manager_investeringsactiviteiten	manager investeringsactiviteiten
manager_klinische_farmacie	manager klinische farmacie
manager_kunstafdeling	manager kunstafdeling
manager_logistiek	manager logistiek
manager_logistiek_centrum	manager logistiek centrum
manager_maritieme_operaties	manager maritieme operaties
manager_netwerkoperaties	manager netwerkoperaties
manager_netwerktechniek	manager netwerktechniek
manager_ontwerpcentrum	manager ontwerpcentrum
manager_openbaar_beleid	manager openbaar beleid
manager_pers_en_public_relations	manager pers en public relations
manager_privébankieren	manager privébankieren
manager_productie-eenheid	manager productie-eenheid
manager_reisbureau	manager reisbureau
manager_retail_markt	manager retail markt
manager_strategische_planning	manager strategische planning
manager_talent_acquisitie	manager talent acquisitie
manager_talentwerving	manager talentwerving
manager_van_het_servicecentrum	manager van het servicecentrum
manager_videoproductie	manager videoproductie
manager_vluchtoperaties	manager vluchtoperaties
manager_voedselveiligheid	manager voedselveiligheid
manager_webontwikkeling	manager webontwikkeling
manicure	manicure
marechaussee	marechaussee
marine_officier	marine officier
maritiem_adviseur	maritiem adviseur
maritiem_officier	maritiem officier
marketing_analist	marketing analist
marketing_consulent	marketing consulent
marketing_en_public_relations_medewerker	marketing en public relations medewerker
marketing_strateeg	marketing strateeg
marketing_vertegenwoordiger	marketing vertegenwoordiger
marketing-_en_communicatiemedewerker	marketing- en communicatiemedewerker
marketing-_en_public_relations-specialist	marketing- en public relations-specialist
marketing-tekstschrijver	marketing-tekstschrijver
marketingadviseur_sociale_media	marketingadviseur sociale media
marketingcommunicatiespecialist	marketingcommunicatiespecialist
marketingmanager_sociale_media	marketingmanager sociale media
markt_verslaggever	markt verslaggever
marktonderzoek_analist	marktonderzoek analist
marktrisicomanager	marktrisicomanager
materiaal_behandelaar	materiaal behandelaar
mba_afgestudeerde_student	mba afgestudeerde student
mba_deelnemer	mba deelnemer
mba_kandidaat	mba kandidaat
mechanisch_ontwerper	mechanisch ontwerper
mechanisch_ontwerpmanager	mechanisch ontwerpmanager
mechanisch_projectingenieur	mechanisch projectingenieur
mechanisch_systeem_ingenieur	mechanisch systeem ingenieur
mechanische_specialist	mechanische specialist
mechanische_tekenaar	mechanische tekenaar
medewerker_alumnirelaties	medewerker alumnirelaties
medewerker_bedrijfscommunicatie	medewerker bedrijfscommunicatie
medewerker_bedrijfsontwikkeling	medewerker bedrijfsontwikkeling
medewerker_cadeauwinkel	medewerker cadeauwinkel
medewerker_donorrelaties	medewerker donorrelaties
medewerker_financiële_dienstverlening	medewerker financiële dienstverlening
medewerker_gastendienst	medewerker gastendienst
medewerker_gastenservice	medewerker gastenservice
medewerker_gastrelaties	medewerker gastrelaties
medewerker_interne_communicatie	medewerker interne communicatie
medewerker_investeringsbankieren	medewerker investeringsbankieren
medewerker_investor_relations	medewerker investor relations
medewerker_klantenservice	medewerker klantenservice
medewerker_klantrelaties	medewerker klantrelaties
medewerker_kredietadministratie	medewerker kredietadministratie
medewerker_ledenservice	medewerker ledenservice
medewerker_mediarelaties	medewerker mediarelaties
medewerker_private_equity	medewerker private equity
medewerker_produceren	medewerker produceren
medewerker_productontwikkeling	medewerker productontwikkeling
medewerker_public_relations	medewerker public relations
medewerker_risicomanagement	medewerker risicomanagement
medewerker_schatkist	medewerker schatkist
medewerker_technische_ondersteuning	medewerker technische ondersteuning
medewerkster_aandelenonderzoek	medewerkster aandelenonderzoek
medewerkster_balie	medewerkster balie
medewerkster_dierverzorging	medewerkster dierverzorging
medewerkster_frontoffice	medewerkster frontoffice
media_bibliothecaris	media bibliothecaris
media_directeur	media directeur
media_manager	media manager
media_medewerker	media medewerker
media_technicus	media technicus
media-_en_communicatiemanager	media- en communicatiemanager
media-executive	media-executive
media-onderzoeker	media-onderzoeker
mediachef	mediachef
mediaplanner	mediaplanner
mediaspecialist_schoolbibliotheek	mediaspecialist schoolbibliotheek
mediastrateeg	mediastrateeg
medisch_informatiemanager	medisch informatiemanager
medisch_ingenieur	medisch ingenieur
medisch-wetenschappelijke_contactpersoon	medisch-wetenschappelijke contactpersoon
medische_illustrator	medische illustrator
medische_recruiter	medische recruiter
medische_stagiaire	medische stagiaire
meester_belastingadviseur	meester belastingadviseur
meester_loodgieter	meester loodgieter
meester_stylist	meester stylist
meester_timmerman	meester timmerman
meester_zeeman	meester zeeman
merk_analist	merk analist
merk_ontwerper	merk ontwerper
merkontwerpmanager	merkontwerpmanager
merkplanner	merkplanner
metallurgisch_ingenieur	metallurgisch ingenieur
metro-editor	metro-editor
microcomputer_specialist	microcomputer specialist
microsoft_systeem_ingenieur	microsoft systeem ingenieur
microsoft-systeembeheerder	microsoft-systeembeheerder
middelbareschoolleraar	middelbareschoolleraar
middelste_officier	middelste officier
mijn_geoloog	mijn geoloog
mijningenieur	mijningenieur
milieu_grafisch_ontwerper	milieu grafisch ontwerper
milieu_ingenieur	milieu ingenieur
milieu_technicus	milieu technicus
milieu_wetenschapper	milieu wetenschapper
mixoloog	mixoloog
mobiele_ingenieur	mobiele ingenieur
mode_adviseur	mode adviseur
mode_assistent	mode assistent
mode_coördinator	mode coördinator
mode_fotograaf	mode fotograaf
mode_ontwerper	mode ontwerper
modelleur	modelleur
modeontwerper	modeontwerper
module_leiden	module leiden
monteur_verwarming_en_airconditioning	monteur verwarming en airconditioning
multimedia_ontwerper	multimedia ontwerper
multimedia_producent	multimedia producent
multimedia_programmeur	multimedia programmeur
multimedia_stagiaire	multimedia stagiaire
multimediaal_journalist	multimediaal journalist
muralist	muralist
musicus	musicus
muziek_adviseur	muziek adviseur
muziek_instructeur	muziek instructeur
muziek_professioneel	muziek professioneel
muziek_stagiair	muziek stagiair
muziekproducent	muziekproducent
muzikaal_leider	muzikaal leider
naai_instructeur	naai instructeur
nacht_controleur	nacht controleur
nachtelijke_voorraadhouder	nachtelijke voorraadhouder
nachtmanager	nachtmanager
nationale_correspondent	nationale correspondent
nationale_deskundige	nationale deskundige
neonatoloog	neonatoloog
netwerk_adviseur	netwerk adviseur
netwerk_analist	netwerk analist
netwerk_beveiligingstechnicus	netwerk beveiligingstechnicus
netwerk_controle_technicus	netwerk controle technicus
netwerk_implementatiemanager	netwerk implementatiemanager
netwerk_integratie_ingenieur	netwerk integratie ingenieur
netwerk_integrator	netwerk integrator
netwerk_officier	netwerk officier
netwerk_ontwerp_ingenieur	netwerk ontwerp ingenieur
netwerk_ontwerper	netwerk ontwerper
netwerk_ontwerpmanager	netwerk ontwerpmanager
netwerk_operationeel_ingenieur	netwerk operationeel ingenieur
netwerk_operations_analist	netwerk operations analist
netwerk_prestatie-ingenieur	netwerk prestatie-ingenieur
netwerk_specialist	netwerk specialist
netwerk_support_engineer	netwerk support engineer
netwerk_support_technicus	netwerk support technicus
netwerk_systeem_ingenieur	netwerk systeem ingenieur
netwerk_technicus	netwerk technicus
netwerk_voorziening	netwerk voorziening
netwerkadministrator	netwerkadministrator
netwerkarchitect	netwerkarchitect
netwerkbeveiligingsbeheerder	netwerkbeveiligingsbeheerder
netwerktechnicus	netwerktechnicus
nieuwe_adviseur_woningverkoop	nieuwe adviseur woningverkoop
nieuwe_bedrijfsspecialist	nieuwe bedrijfsspecialist
nieuwe_woonadviseur	nieuwe woonadviseur
nieuws_directeur	nieuws directeur
nieuws_operationeel_manager	nieuws operationeel manager
nieuws_producent	nieuws producent
nieuwsverslaggever_op_televisie	nieuwsverslaggever op televisie
nucleair_geneeskundig_technoloog	nucleair geneeskundig technoloog
ochtendnieuws_anker	ochtendnieuws anker
ochtendshow_mede-presentator	ochtendshow mede-presentator
omgevingsgeoloog	omgevingsgeoloog
omroep	omroep
omroep_beheerder	omroep beheerder
omroep_ingenieur	omroep ingenieur
omroep_systeem_ingenieur	omroep systeem ingenieur
omroep_technicus	omroep technicus
omroepbegeleider	omroepbegeleider
on_air_omroeper	on air omroeper
onder_leraar	onder leraar
onderhoudsmonteur_apparatuur	onderhoudsmonteur apparatuur
ondersteunende_technicus	ondersteunende technicus
ondersteuningsspecialist_voor_eindgebruikers	ondersteuningsspecialist voor eindgebruikers
onderwijs_adviseur	onderwijs adviseur
onderwijskundig_specialist	onderwijskundig specialist
onderzoek_advocaat	onderzoek advocaat
onderzoek_bibliothecaris	onderzoek bibliothecaris
onderzoek_geoloog	onderzoek geoloog
onderzoeker	onderzoeker
onderzoeks-_en_ontwikkelingsingenieur	onderzoeks- en ontwikkelingsingenieur
onderzoeks-_en_ontwikkelingstechnoloog	onderzoeks- en ontwikkelingstechnoloog
onderzoeks-_en_ontwikkelingswetenschapper	onderzoeks- en ontwikkelingswetenschapper
onderzoeksassistent	onderzoeksassistent
onderzoekscoördinator	onderzoekscoördinator
onderzoeksspecialist	onderzoeksspecialist
online_advertentiemanager	online advertentiemanager
online_marketeer	online marketeer
ontvangende_begeleider	ontvangende begeleider
ontwerp_architect	ontwerp architect
ontwerp_assistent	ontwerp assistent
ontwerp_automatiseringsingenieur	ontwerp automatiseringsingenieur
ontwerp_coördinator	ontwerp coördinator
ontwerp_ingenieur	ontwerp ingenieur
ontwerp_instructeur	ontwerp instructeur
ontwerp_redacteur	ontwerp redacteur
ontwerp_release-engineer	ontwerp release-engineer
ontwerp_stagiair	ontwerp stagiair
ontwerp-_en_ontwikkelingsingenieur	ontwerp- en ontwikkelingsingenieur
ontwerpend_ingenieur	ontwerpend ingenieur
ontwerper	ontwerper
ontwerper_van_besturingssystemen	ontwerper van besturingssystemen
ontwerper_van_dameskleding	ontwerper van dameskleding
ontwerper_van_digitale_media	ontwerper van digitale media
ontwerper_van_gemengde_signalen	ontwerper van gemengde signalen
ontwerper_van_herenkleding	ontwerper van herenkleding
ontwerper_van_printplaten	ontwerper van printplaten
ontwerper_van_publicaties	ontwerper van publicaties
ontwerpingenieur_van_het_personeel	ontwerpingenieur van het personeel
ontwikkelaar	ontwikkelaar
ontwikkelaar_aan_de_clientzijde	ontwikkelaar aan de clientzijde
ontwikkelaar_van_mobiele_applicaties	ontwikkelaar van mobiele applicaties
ontwikkelaar_van_softwaretoepassingen	ontwikkelaar van softwaretoepassingen
ontwikkelaar_van_webapplicaties	ontwikkelaar van webapplicaties
ontwikkeling_producent	ontwikkeling producent
ontwikkelings_technoloog	ontwikkelings technoloog
op_lucht_persoonlijkheid	op lucht persoonlijkheid
opbrengst_beheerder	opbrengst beheerder
opdracht_redacteur	opdracht redacteur
opdrachtgevende_redacteur	opdrachtgevende redacteur
open_source-ontwikkelaar	open source-ontwikkelaar
operationeel_en_logistiek_manager	operationeel en logistiek manager
operationeel_manager_apotheek	operationeel manager apotheek
operationeel_officier	operationeel officier
operationeel_specialist	operationeel specialist
operationele_opdrachtgever	operationele opdrachtgever
operator_van_het_netwerkbeheercentrum	operator van het netwerkbeheercentrum
operazanger	operazanger
opleidings-_en_plaatsingsfunctionaris	opleidings- en plaatsingsfunctionaris
oplossingen_ontwikkelaar	oplossingen ontwikkelaar
opluchting_beheerder	opluchting beheerder
opname_artiest	opname artiest
opname_stagiair	opname stagiair
opname_technicus	opname technicus
oppas	oppas
oprichtende_partner	oprichtende partner
opsporingsambtenaar	opsporingsambtenaar
optie_handelaar	optie handelaar
opzichter_uitzenden	opzichter uitzenden
opzichter_van_de_huishoudelijke_dienst	opzichter van de huishoudelijke dienst
opzichter_van_het_distributiecentrum	opzichter van het distributiecentrum
orderpicker	orderpicker
organist	organist
orthodontist	orthodontist
oud-functionaris	oud-functionaris
outreachend_adviseur	outreachend adviseur
pakket_ingenieur	pakket ingenieur
para-opvoeder	para-opvoeder
particuliere_hypotheekbankier	particuliere hypotheekbankier
particuliere_klantmanager	particuliere klantmanager
partner	partner
parttime_verkoopmedewerker	parttime verkoopmedewerker
paskamer_medewerkster	paskamer medewerkster
patroon_maker	patroon maker
patrouille_sergeant	patrouille sergeant
pc-specialist	pc-specialist
pedagogisch_medewerker_speciaal_onderwijs	pedagogisch medewerker speciaal onderwijs
pedagogisch_therapeut	pedagogisch therapeut
pedagoog_in_de_vroege_kinderjaren	pedagoog in de vroege kinderjaren
perfusionist	perfusionist
personage-animator	personage-animator
personal_computer_technicus	personal computer technicus
personeel_accountant	personeel accountant
personeel_hardware_ingenieur	personeel hardware ingenieur
personeels_administrateur	personeels administrateur
personeels_adviseur	personeels adviseur
personeels_raad	personeels raad
personeelsmanager	personeelsmanager
personeelsspecialist	personeelsspecialist
persoonlijk_lijnmanager	persoonlijk lijnmanager
persoonlijke_assistent_van_algemeen_directeur	persoonlijke assistent van algemeen directeur
persoonlijke_bankadviseur	persoonlijke bankadviseur
persoonlijke_bankmanager	persoonlijke bankmanager
persoonlijke_bankvertegenwoordiger	persoonlijke bankvertegenwoordiger
persoonlijke_kok	persoonlijke kok
persoonlijke_lijnen_verzekeraar	persoonlijke lijnen verzekeraar
persoonlijke_opleidingsmanager	persoonlijke opleidingsmanager
persoonlijke_trainer	persoonlijke trainer
persvoorlichter	persvoorlichter
petroleum_ingenieur	petroleum ingenieur
php-programmeur	php-programmeur
php-webontwikkelaar	php-webontwikkelaar
piano_technicus	piano technicus
pitching_instructeur	pitching instructeur
plaats_civiel_ingenieur	plaats civiel ingenieur
plaatsing_adviseur	plaatsing adviseur
plaatsverkenner	plaatsverkenner
plaatsvervangend_algemeen_raadsman	plaatsvervangend algemeen raadsman
plaatsvervangend_beheerder	plaatsvervangend beheerder
plaatsvervangend_brandweercommandant	plaatsvervangend brandweercommandant
plaatsvervangend_creatief_directeur	plaatsvervangend creatief directeur
plaatsvervangend_directeur_bedrijfsontwikkeling	plaatsvervangend directeur bedrijfsontwikkeling
plaatsvervangend_hoofd_van_de_politie	plaatsvervangend hoofd van de politie
plaatsvervangend_hoofdredacteur	plaatsvervangend hoofdredacteur
plaatsvervangend_minister	plaatsvervangend minister
plaatsvervangend_officier_van_justitie	plaatsvervangend officier van justitie
plaatsvervangend_procureur-generaal	plaatsvervangend procureur-generaal
plaatsvervangend_stadsadvocaat	plaatsvervangend stadsadvocaat
plaatsvervangend_verdediger	plaatsvervangend verdediger
planner	planner
plant_metallurg	plant metallurg
plant_proces_ingenieur	plant proces ingenieur
pleiten_voor	pleiten voor
plukker	plukker
politie_agent	politie agent
politie_kapitein	politie kapitein
politie-detective	politie-detective
politieagent	politieagent
portefeuille_directeur	portefeuille directeur
portefeuille_medewerkster	portefeuille medewerkster
portefeuillebeheerder_aandelen	portefeuillebeheerder aandelen
portefeuillebeheerder_vastrentende_waarden	portefeuillebeheerder vastrentende waarden
portefeuillemanager_onroerend_goed	portefeuillemanager onroerend goed
portfolio_manager	portfolio manager
post_dichterbij	post dichterbij
post_inspecteur	post inspecteur
postbeambte	postbeambte
postdoctoraal_onderzoeker	postdoctoraal onderzoeker
postkamer_bediende	postkamer bediende
postproducent	postproducent
postproductie_assistent	postproductie assistent
postproductie_supervisor	postproductie supervisor
postproductie-editor	postproductie-editor
postproductiemanager	postproductiemanager
preconstructie_manager	preconstructie manager
prepress_coördinator	prepress coördinator
presentator	presentator
presentator_van_de_ochtendshow	presentator van de ochtendshow
presentator_van_een_radiotalkshow	presentator van een radiotalkshow
presentator_van_talkshows	presentator van talkshows
presentielijst_bediende	presentielijst bediende
prestatie_coach	prestatie coach
prijsbegeleider	prijsbegeleider
prijscoördinator	prijscoördinator
print_ontwerper	print ontwerper
print_producent	print producent
prive_detective	prive detective
prive_praktijk	prive praktijk
privé_kok	privé kok
proces_adviseur	proces adviseur
proces_assistent	proces assistent
proces_specialist	proces specialist
proces_technoloog	proces technoloog
proces_werktuigbouwkundige	proces werktuigbouwkundige
procesadvocaat	procesadvocaat
procescontroleur	procescontroleur
procesingenieur	procesingenieur
procesmanager	procesmanager
procesmedewerker	procesmedewerker
procesontwerper	procesontwerper
procespartner	procespartner
processpecialist	processpecialist
procestechnisch_specialist	procestechnisch specialist
procureur	procureur
producent	producent
producent_van_creatieve_diensten	producent van creatieve diensten
producent_van_de_ochtendshow	producent van de ochtendshow
producent_van_digitale_media	producent van digitale media
producent_van_nieuwe_media	producent van nieuwe media
producent_van_televisienieuws	producent van televisienieuws
product_ingenieur	product ingenieur
product_kampioen	product kampioen
product_ontwerper	product ontwerper
product_technoloog	product technoloog
productcontroleur	productcontroleur
productie_apotheker	productie apotheker
productie_artiest	productie artiest
productie_assistent_instellen	productie assistent instellen
productie_coordinator	productie coordinator
productie_ingenieur	productie ingenieur
productie_manager	productie manager
productie_ontwerp_ingenieur	productie ontwerp ingenieur
productie_secretaris	productie secretaris
productie_verzekeraar	productie verzekeraar
productiemanager_drukwerk	productiemanager drukwerk
productmarketing_analist	productmarketing analist
productontwerp_en_ontwikkelingsingenieur	productontwerp en ontwikkelingsingenieur
productontwikkelaar	productontwikkelaar
productontwikkelingstechnoloog	productontwikkelingstechnoloog
productportfoliomanager	productportfoliomanager
productstrateeg	productstrateeg
prof_voetballer	prof voetballer
professionele_acteur	professionele acteur
professionele_artiest	professionele artiest
professionele_atleet	professionele atleet
professionele_boekhouder	professionele boekhouder
professionele_chauffeur	professionele chauffeur
professionele_danser	professionele danser
professionele_fotograaf	professionele fotograaf
professionele_ingenieur	professionele ingenieur
professionele_makelaar	professionele makelaar
professionele_medewerker	professionele medewerker
professionele_muzikant	professionele muzikant
professionele_visagist	professionele visagist
professionele_zanger	professionele zanger
professor	professor
profvoetballer	profvoetballer
programma_producent	programma producent
programmamanager_lokalisatie	programmamanager lokalisatie
programmamanager_milieu	programmamanager milieu
programmering_analist	programmering analist
project_archivaris	project archivaris
project_assistent	project assistent
project_geoloog	project geoloog
project_hydrogeoloog	project hydrogeoloog
project_ontwerper	project ontwerper
project_redacteur	project redacteur
projectcalculator	projectcalculator
projectcoördinatie_manager	projectcoördinatie manager
projectingenieur	projectingenieur
projectingenieur_elektrotechniek	projectingenieur elektrotechniek
projectingenieur_telecommunicatie	projectingenieur telecommunicatie
projectleider	projectleider
projectleider_milieubeheer	projectleider milieubeheer
projectleider_redactie	projectleider redactie
projectleider_werving	projectleider werving
projectmedewerker	projectmedewerker
promoties_producent	promoties producent
provoost	provoost
psychoanalyticus	psychoanalyticus
psychologische_assistent	psychologische assistent
psycholoog	psycholoog
psychotherapeut_in_eigen_praktijk	psychotherapeut in eigen praktijk
public_address-omroeper	public address-omroeper
public_relations_manager	public relations manager
publicaties_assistent	publicaties assistent
publicaties_manager	publicaties manager
publicist	publicist
publiciteitsmanager	publiciteitsmanager
publieke_relaties	publieke relaties
raad	raad
raad_van_bestuur	raad van bestuur
raadgevend_ingenieur	raadgevend ingenieur
raadgever	raadgever
radio_ingenieur	radio ingenieur
radio_producent	radio producent
radio-omroep	radio-omroep
radiologie_manager	radiologie manager
radiologie_technicus	radiologie technicus
radiologie_technoloog	radiologie technoloog
rating_analist	rating analist
receptie_begeleider	receptie begeleider
receptie_manager	receptie manager
receptie_vertegenwoordiger	receptie vertegenwoordiger
rechercheur	rechercheur
rechter	rechter
rechtsbijstand	rechtsbijstand
reclame_account_vertegenwoordiger	reclame account vertegenwoordiger
reclame_ontwerper	reclame ontwerper
reclame_tekstschrijver	reclame tekstschrijver
reclame_toezichthouder	reclame toezichthouder
reclamemanager	reclamemanager
reclamespecialist	reclamespecialist
recruiter	recruiter
recruiter_voor_talentwerving	recruiter voor talentwerving
redactie_adviseur	redactie adviseur
redactie_assistent	redactie assistent
redactie_coördinator	redactie coördinator
redactionele_schrijver	redactionele schrijver
regelgevende_adviseur	regelgevende adviseur
regiomanager_vastgoed	regiomanager vastgoed
regionaal_directeur_schadepreventie	regionaal directeur schadepreventie
regionaal_logistiek_manager	regionaal logistiek manager
regionaal_ondersteuningsspecialist	regionaal ondersteuningsspecialist
regionaal_technisch_specialist	regionaal technisch specialist
regionaal_vervoersmanager	regionaal vervoersmanager
regionale_bouwmanager	regionale bouwmanager
regionale_exportmanager	regionale exportmanager
regionale_inkomstenmanager	regionale inkomstenmanager
regionale_productiemanager	regionale productiemanager
regionale_raad	regionale raad
regionale_rechercheur	regionale rechercheur
regionale_systeembeheerder	regionale systeembeheerder
regionale_wervingsmanager	regionale wervingsmanager
regisseur	regisseur
regisseur_talent	regisseur talent
registrar	registrar
reis_redacteur	reis redacteur
reis_verpleegster	reis verpleegster
reisadviseur	reisadviseur
reisleider	reisleider
reismanager	reismanager
reisschrijver	reisschrijver
reisspecialist	reisspecialist
rekruteringsbegeleider	rekruteringsbegeleider
rekruteringsfunctionaris	rekruteringsfunctionaris
rekruteringsmanager	rekruteringsmanager
rekruteringsspecialist	rekruteringsspecialist
relatie_ambtenaar	relatie ambtenaar
relatie_bankier	relatie bankier
relatie_manager	relatie manager
relatie_uitvoerend	relatie uitvoerend
relatiebeheerder_alumni	relatiebeheerder alumni
relatiebeheerder_commercieel_bankieren	relatiebeheerder commercieel bankieren
relatiebeheerder_klant	relatiebeheerder klant
relatiebeheerder_private_banking	relatiebeheerder private banking
rentmeester	rentmeester
reparateur	reparateur
reparateur_van_pc's	reparateur van pc's
reparatie_technicus	reparatie technicus
reserve_politieagent	reserve politieagent
reserveringen_agent	reserveringen agent
reserveringen_verkoopagent	reserveringen verkoopagent
reservoir_geoloog	reservoir geoloog
resident_artiest	resident artiest
residentieel_ingenieur	residentieel ingenieur
residentiële_makelaar	residentiële makelaar
resource_manager	resource manager
resource_specialist	resource specialist
restaurant_algemeen_directeur	restaurant algemeen directeur
restaurant_begeleider	restaurant begeleider
restaurant_chef-kok	restaurant chef-kok
restaurant_eigenaar	restaurant eigenaar
restaurant_manager	restaurant manager
restaurant_server	restaurant server
restaurant-_en_barmanager	restaurant- en barmanager
retoucheur	retoucheur
risico_controleur	risico controleur
roei_instructeur	roei instructeur
ruimtevaartuig_ingenieur	ruimtevaartuig ingenieur
russische_taalkundige	russische taalkundige
röntgenoloog	röntgenoloog
salaris_administrateur	salaris administrateur
salarisadministrateur	salarisadministrateur
salon_coördinator	salon coördinator
salon_eigenaar	salon eigenaar
salon_manager	salon manager
samensteller	samensteller
sanitair_ontwerper	sanitair ontwerper
scada-ingenieur	scada-ingenieur
schade_medewerkster	schade medewerkster
schade_vertegenwoordiger	schade vertegenwoordiger
schade-expert	schade-expert
schade-expert_onroerend_goed	schade-expert onroerend goed
schakel_monteur	schakel monteur
schilder	schilder
schoeisel_ontwerper	schoeisel ontwerper
schoolhoofd	schoolhoofd
schoolzuster	schoolzuster
schoonheidsadviseur	schoonheidsadviseur
schoonheidsspecialist	schoonheidsspecialist
schrijver_van_webcontent	schrijver van webcontent
scriptiebegeleider	scriptiebegeleider
scriptschrijver	scriptschrijver
sectie_ingenieur	sectie ingenieur
secundaire_marketingmanager	secundaire marketingmanager
seizoensgebonden_verkoopmedewerker	seizoensgebonden verkoopmedewerker
sergeant	sergeant
serveerder	serveerder
server	server
server_beheerder	server beheerder
service_nu_ontwikkelaar	service nu ontwikkelaar
service_ondersteuning_specialist	service ondersteuning specialist
service_ontwerper	service ontwerper
servicedesk_medewerker	servicedesk medewerker
servicedesk_technicus	servicedesk technicus
set_dressoir	set dressoir
sheriff	sheriff
shift_leiden	shift leiden
showmanager	showmanager
simulatie_ingenieur	simulatie ingenieur
site_acquisitie_manager	site acquisitie manager
site_ingenieur	site ingenieur
sleutelhouder	sleutelhouder
smaakmaker	smaakmaker
sociaal_werker	sociaal werker
social_media_manager	social media manager
social_media_specialist	social media specialist
socialemediastrateeg	socialemediastrateeg
software_adviseur	software adviseur
software_analist	software analist
software_ondersteuning_analist	software ondersteuning analist
software_ondersteuning_technicus	software ondersteuning technicus
software_ontwikkelaar	software ontwikkelaar
software_projectleider	software projectleider
software_stagiaire	software stagiaire
softwarebedrijf	softwarebedrijf
softwareontwikkelingsingenieur_in_test	softwareontwikkelingsingenieur in test
softwarespecialist	softwarespecialist
songwriter	songwriter
sorteerder	sorteerder
sous_chef	sous chef
spaanse_leraar	spaanse leraar
spaanse_vertaler	spaanse vertaler
speciaal_onderwijs_leraar	speciaal onderwijs leraar
speciale_agent	speciale agent
speciale_evenementenplanner	speciale evenementenplanner
speciale_opvoeder	speciale opvoeder
speciale_raad	speciale raad
speciale_rechercheur	speciale rechercheur
speciale_schaderegelaar	speciale schaderegelaar
specialist_cliëntondersteuning	specialist cliëntondersteuning
specialist_commercieel_vastgoed	specialist commercieel vastgoed
specialist_gebruikersondersteuning	specialist gebruikersondersteuning
specialist_in_bedrijfsontwikkeling	specialist in bedrijfsontwikkeling
specialist_in_beleggingsfondsen	specialist in beleggingsfondsen
specialist_in_besturingssystemen	specialist in besturingssystemen
specialist_in_computernetwerken	specialist in computernetwerken
specialist_in_datanetwerken	specialist in datanetwerken
specialist_in_desktopondersteuning	specialist in desktopondersteuning
specialist_in_klinische_toepassingen	specialist in klinische toepassingen
specialist_in_mediaproductie	specialist in mediaproductie
specialist_in_netwerkbeveiliging	specialist in netwerkbeveiliging
specialist_in_talentmanagement	specialist in talentmanagement
specialist_in_testautomatisering	specialist in testautomatisering
specialist_in_thuisbioscopen	specialist in thuisbioscopen
specialist_in_videoproductie	specialist in videoproductie
specialist_in_webapplicaties	specialist in webapplicaties
specialist_in_webcommunicatie	specialist in webcommunicatie
specialist_in_woningkredieten	specialist in woningkredieten
specialist_intellectueel_eigendom	specialist intellectueel eigendom
specialist_klinische_farmacie	specialist klinische farmacie
specialist_milieubescherming	specialist milieubescherming
specialist_public_relations	specialist public relations
specialist_zakelijk_bankieren	specialist zakelijk bankieren
specialisten_op_het_gebied_van_vastrentende_waarden	specialisten op het gebied van vastrentende waarden
spel_artiest	spel artiest
spel_directeur	spel directeur
spel_ontwerper	spel ontwerper
speler	speler
spoedarts	spoedarts
spoedeisende_medische_technicus	spoedeisende medische technicus
sport_anker	sport anker
sport_coördinator	sport coördinator
sport_fotograaf	sport fotograaf
sport_instructeur	sport instructeur
sport_leraar	sport leraar
sport_manager	sport manager
sport_producent	sport producent
sport_redacteur	sport redacteur
sport_stagiaire	sport stagiaire
sport_verslaggever	sport verslaggever
sportief_directeur	sportief directeur
staat_trooper	staat trooper
staats-_en_lokale_belastingmanager	staats- en lokale belastingmanager
stad_brievenbus	stad brievenbus
stad_redacteur	stad redacteur
staf_arts	staf arts
staf_elektrotechnisch_ingenieur	staf elektrotechnisch ingenieur
staf_geofysicus	staf geofysicus
staf_geoloog	staf geoloog
staf_onderzoeker	staf onderzoeker
staf_onderzoeksingenieur	staf onderzoeksingenieur
staf_ontwikkelaar	staf ontwikkelaar
staf_technisch_programmamanager	staf technisch programmamanager
staf_technische_ondersteuning_ingenieur	staf technische ondersteuning ingenieur
staf_technoloog	staf technoloog
stagiair_art_direction	stagiair art direction
stagiair_civiele_techniek	stagiair civiele techniek
stagiair_creatieve_dienstverlening	stagiair creatieve dienstverlening
stagiair_desktop_support	stagiair desktop support
stagiair_financieel_management	stagiair financieel management
stagiair_investeringsbankieren	stagiair investeringsbankieren
stagiair_landschapsarchitectuur	stagiair landschapsarchitectuur
stagiair_ontwerp_en_productie	stagiair ontwerp en productie
stagiair_ontwerp_techniek	stagiair ontwerp techniek
stagiair_postproductie	stagiair postproductie
stagiair_private_equity	stagiair private equity
stagiair_risicomanagement	stagiair risicomanagement
stagiair_software_engineering	stagiair software engineering
stagiair_software_ontwikkelaar	stagiair software ontwikkelaar
stagiair_systeemtechniek	stagiair systeemtechniek
stagiair_talent_acquisitie	stagiair talent acquisitie
stagiair_werktuigbouwkunde	stagiair werktuigbouwkunde
stagiaire_corporate_finance	stagiaire corporate finance
stagiaire_eten_en_drinken	stagiaire eten en drinken
stagiaire_frontoffice	stagiaire frontoffice
stagiaire_grafische_vormgeving	stagiaire grafische vormgeving
stagiaire_juridische_afdeling	stagiaire juridische afdeling
stagiaire_modevormgeving	stagiaire modevormgeving
stagiaire_software_engineering	stagiaire software engineering
stagiaire_van_het_hbo-programma	stagiaire van het hbo-programma
stagiaire_vermogensonderzoek	stagiaire vermogensonderzoek
stagiaire_visual_merchandising	stagiaire visual merchandising
stagiaire_webontwikkeling	stagiaire webontwikkeling
station_ingenieur	station ingenieur
stedenbouwkundige	stedenbouwkundige
stem_ingenieur	stem ingenieur
stewardess	stewardess
stichting_beheerder	stichting beheerder
stijl_adviseur	stijl adviseur
stilist	stilist
strafrechtadvocaat	strafrechtadvocaat
strategie_adviseur	strategie adviseur
strategie_en_operationeel_manager	strategie en operationeel manager
strategisch_bedrijfsadviseur	strategisch bedrijfsadviseur
strategisch_begeleider	strategisch begeleider
strategisch_planningsmanager	strategisch planningsmanager
strategische_communicatie	strategische communicatie
stress_analist	stress analist
stress_ingenieur	stress ingenieur
student_in_de_verpleegkunde	student in de verpleegkunde
student_informatica	student informatica
student_leraar	student leraar
student_verslaggever	student verslaggever
student_vrijwilliger	student vrijwilliger
student_werktuigbouwkunde	student werktuigbouwkunde
studente_grafische_vormgeving	studente grafische vormgeving
studieadviseur_buitenland	studieadviseur buitenland
studiedirecteur	studiedirecteur
studio_artiest	studio artiest
subsidie_​​beheerder	subsidie ​​beheerder
supervisor_creatieve_dienstverlening	supervisor creatieve dienstverlening
supervisor_gastrelaties	supervisor gastrelaties
supervisor_grafische_vormgeving	supervisor grafische vormgeving
supervisor_handelsmarketing	supervisor handelsmarketing
supervisor_producttechniek	supervisor producttechniek
supervisor_radiologie	supervisor radiologie
supervisor_technische_ondersteuning	supervisor technische ondersteuning
supervisor_van_de_kliniek	supervisor van de kliniek
supervisor_van_de_luchthavenoperaties	supervisor van de luchthavenoperaties
supervisor_voorraadbeheer	supervisor voorraadbeheer
supporter	supporter
systeem_administrator	systeem administrator
systeem_analist	systeem analist
systeem_ingenieur	systeem ingenieur
systeem_netwerkbeheerder	systeem netwerkbeheerder
systeem_ondersteuning_ingenieur	systeem ondersteuning ingenieur
systeem_ontwerp_ingenieur	systeem ontwerp ingenieur
systeem_prestatie_ingenieur	systeem prestatie ingenieur
systeembeheerder	systeembeheerder
systeembeheerder_bedrijfsondersteunend	systeembeheerder bedrijfsondersteunend
taal_adviseur	taal adviseur
talent_acquisitie_executive	talent acquisitie executive
talent_acquisitie_leiden	talent acquisitie leiden
talent_acquisitie_specialist	talent acquisitie specialist
talent_producent	talent producent
talentmanager	talentmanager
tandartsassistente	tandartsassistente
taxatie_medewerkster	taxatie medewerkster
teamleider	teamleider
teamleider_aanwerven	teamleider aanwerven
teamleider_applicatieontwikkeling	teamleider applicatieontwikkeling
teamleider_automatisering	teamleider automatisering
teamleider_desktopondersteuning	teamleider desktopondersteuning
teamleider_embedded_software	teamleider embedded software
teamleider_frontoffice	teamleider frontoffice
teamleider_hardware	teamleider hardware
teamleider_implementatie	teamleider implementatie
teamleider_logistiek	teamleider logistiek
teamleider_magazijn	teamleider magazijn
teamleider_makelaar	teamleider makelaar
teamleider_netwerk_operations_center	teamleider netwerk operations center
teamleider_ontwerp	teamleider ontwerp
teamleider_servicedesk	teamleider servicedesk
teamleider_software_engineer	teamleider software engineer
teamleider_technische_ondersteuning	teamleider technische ondersteuning
teamleider_telecommunicatie	teamleider telecommunicatie
teamleider_webontwikkeling	teamleider webontwikkeling
technicus	technicus
technicus_biomedische_apparatuur	technicus biomedische apparatuur
technicus_civiele_techniek	technicus civiele techniek
technicus_computerhardware	technicus computerhardware
technicus_computerondersteuning	technicus computerondersteuning
technicus_dierenverzorging	technicus dierenverzorging
technicus_digitale_beeldvorming	technicus digitale beeldvorming
technicus_in_het_computerlaboratorium	technicus in het computerlaboratorium
technicus_klantondersteuning	technicus klantondersteuning
technicus_productondersteuning	technicus productondersteuning
technicus_spoedeisende_hulp	technicus spoedeisende hulp
technicus_systeemondersteuning	technicus systeemondersteuning
technicus_technische_ondersteuning_van_de_klant	technicus technische ondersteuning van de klant
technicus_ter_plaatse	technicus ter plaatse
technicus_veldoperaties	technicus veldoperaties
technicus_voor_desktopondersteuning	technicus voor desktopondersteuning
technicus_voor_gebruikersondersteuning	technicus voor gebruikersondersteuning
technicus_voor_ondersteuning_op_afstand	technicus voor ondersteuning op afstand
technisch_artdirector	technisch artdirector
technisch_bureau_ingenieur	technisch bureau ingenieur
technisch_officemanager	technisch officemanager
technisch_ondersteunende_ingenieur	technisch ondersteunende ingenieur
technisch_ontwerper	technisch ontwerper
technisch_opzichter	technisch opzichter
technisch_producent	technisch producent
technisch_recruiter	technisch recruiter
technisch_veldwerker	technisch veldwerker
technisch_wervingsmanager	technisch wervingsmanager
technische_animator	technische animator
technische_architect	technische architect
technische_hulp	technische hulp
technische_klantenservice_medewerker	technische klantenservice medewerker
technische_kunstenaar	technische kunstenaar
technische_leiding	technische leiding
technische_ondersteuningstechnicus	technische ondersteuningstechnicus
technische_operator	technische operator
technische_testleiding	technische testleiding
technische_verkoopondersteuner	technische verkoopondersteuner
technische_vertaler	technische vertaler
technologie	technologie
technologie_analist	technologie analist
technologie_architect	technologie architect
technologie_coach	technologie coach
technologie_recruiter	technologie recruiter
tekenaar_technicus	tekenaar technicus
tekstschrijver	tekstschrijver
tekstschrijver_contract	tekstschrijver contract
telecommunicatie_adviseur	telecommunicatie adviseur
telecommunicatie_assistent	telecommunicatie assistent
telecommunicatie_coördinator	telecommunicatie coördinator
telecommunicatie_deskundige	telecommunicatie deskundige
telecommunicatie_ingenieur	telecommunicatie ingenieur
telecommunicatie_officier	telecommunicatie officier
telecommunicatie_specialist	telecommunicatie specialist
telecommunicatie_systeem_ingenieur	telecommunicatie systeem ingenieur
telecommunicatie_technicus	telecommunicatie technicus
telefoniste	telefoniste
telegraaf_veld_ingenieur	telegraaf veld ingenieur
televisie_journalist	televisie journalist
televisie_producent	televisie producent
televisie_regisseur	televisie regisseur
televisiepresentator	televisiepresentator
teller	teller
tennis_coach	tennis coach
tentoonstelling_curator	tentoonstelling curator
terminal_beheerder	terminal beheerder
test_ingenieur	test ingenieur
test_ontwerp_ingenieur	test ontwerp ingenieur
test-ingenieur	test-ingenieur
textiel_ontwerper	textiel ontwerper
textuur_artiest	textuur artiest
theater_directeur	theater directeur
therapeut	therapeut
therapeut_op_school	therapeut op school
thuis_stager	thuis stager
thuisverpleegkundige	thuisverpleegkundige
ticket_agent	ticket agent
tijdelijke_boekhouder	tijdelijke boekhouder
tijdelijke_medewerkster	tijdelijke medewerkster
titel_1_leraar	titel 1 leraar
titel_agent	titel agent
titel_examinator	titel examinator
titel_officier	titel officier
toelatingsambassadeur	toelatingsambassadeur
toeristengids	toeristengids
toetsenist	toetsenist
toezichthoudend_speciaal_agent	toezichthoudend speciaal agent
toezichthouder_digitale_media	toezichthouder digitale media
toezichthouder_grootboek	toezichthouder grootboek
toezichthouder_infrastructuur	toezichthouder infrastructuur
toezichthouder_public_relations	toezichthouder public relations
toezichthouder_telecommunicatie	toezichthouder telecommunicatie
tour_coördinator	tour coördinator
trajectbegeleider	trajectbegeleider
transactie_analist	transactie analist
transitie_coördinator	transitie coördinator
transmissie_controller	transmissie controller
transmissie_ingenieur	transmissie ingenieur
transport_begeleider	transport begeleider
trimmer	trimmer
trommelaar	trommelaar
tussentijdse_accountant	tussentijdse accountant
tweede_adjunct-directeur	tweede adjunct-directeur
tweede_assistent	tweede assistent
tweede_assistent-manager	tweede assistent-manager
tweede_officier	tweede officier
tweede_stuurman	tweede stuurman
tweedelijns_support_analist	tweedelijns support analist
tweetalige_directiesecretaresse	tweetalige directiesecretaresse
tweetalige_leraar	tweetalige leraar
ui-ingenieur	ui-ingenieur
ui-ontwerper	ui-ontwerper
uitbestedingsmanager	uitbestedingsmanager
uitgeverij	uitgeverij
uitgeverij_adviseur	uitgeverij adviseur
uitgeverij_manager	uitgeverij manager
uitgeverij_redacteur	uitgeverij redacteur
uitgezonden_journalist	uitgezonden journalist
uitgezonden_koper	uitgezonden koper
uitgezonden_medewerkster	uitgezonden medewerkster
uitgezonden_onderhandelaar	uitgezonden onderhandelaar
uitrol_ingenieur	uitrol ingenieur
uitvoerend_art-director	uitvoerend art-director
uitvoerend_artiest	uitvoerend artiest
uitvoerend_bedrijfsfinanciën	uitvoerend bedrijfsfinanciën
uitvoerend_coach	uitvoerend coach
uitvoerend_creatief_directeur	uitvoerend creatief directeur
uitvoerend_importeur	uitvoerend importeur
uitvoerend_in_residentie	uitvoerend in residentie
uitvoerend_juridisch_secretaresse	uitvoerend juridisch secretaresse
uitvoerend_medisch_directeur	uitvoerend medisch directeur
uitvoerend_patissier	uitvoerend patissier
uitvoerend_producent	uitvoerend producent
uitvoerend_vp	uitvoerend vp
uitvoerende_chef-kok	uitvoerende chef-kok
uitvoerende_macht_importeren	uitvoerende macht importeren
uitvoerende_middelen	uitvoerende middelen
uitvoerende_recruiter	uitvoerende recruiter
uitvoerende_souschef	uitvoerende souschef
uitvoeringsbegeleider	uitvoeringsbegeleider
uitwisseling_beheerder	uitwisseling beheerder
uitzend_assistent	uitzend assistent
uitzending_ontwerper	uitzending ontwerper
uitzendmanager	uitzendmanager
ultrasone_technoloog	ultrasone technoloog
universele_bankier	universele bankier
universitair_docent	universitair docent
universitair_docent_filosofie	universitair docent filosofie
universitair_docent_geneeskunde	universitair docent geneeskunde
universitair_docent_geschiedenis	universitair docent geschiedenis
universitair_docent_management	universitair docent management
universitair_docent_onderwijs	universitair docent onderwijs
universitair_docent_rechten	universitair docent rechten
universitaire_bibliothecaris	universitaire bibliothecaris
universitaire_griffier	universitaire griffier
universiteitsprofessor	universiteitsprofessor
vakantie_planner	vakantie planner
vakdeskundige	vakdeskundige
valuta_handelaar	valuta handelaar
vasculair_technoloog	vasculair technoloog
vaste_wervingsadviseur	vaste wervingsadviseur
vastgoed_accountant	vastgoed accountant
vastgoed_adviseur	vastgoed adviseur
vastgoed_advocaat	vastgoed advocaat
vastgoed_analist	vastgoed analist
vastgoed_medewerkster	vastgoed medewerkster
vastgoedbeheerder	vastgoedbeheerder
vastgoedbeoordelaar	vastgoedbeoordelaar
vastgoedspecialist	vastgoedspecialist
vechtsport_instructeur	vechtsport instructeur
veilingmeester	veilingmeester
veld_geoloog	veld geoloog
veld_verzekeraar	veld verzekeraar
veldondersteuner_technicus	veldondersteuner technicus
veldonderzoeker	veldonderzoeker
veldspecialist_van_het_uitzendbureau	veldspecialist van het uitzendbureau
velduitvoerder_van_het_bureau	velduitvoerder van het bureau
venture_capital_analist	venture capital analist
verdieping_directeur	verdieping directeur
verdieping_lood	verdieping lood
verf_kunstenaar	verf kunstenaar
vergunning_technicus	vergunning technicus
verhuis_specialist	verhuis specialist
verhuurmakelaar	verhuurmakelaar
verkeersleider	verkeersleider
verkeersverslaggever	verkeersverslaggever
verkoop_handelaar	verkoop handelaar
verkoop_medewerkster	verkoop medewerkster
verkoop_planner	verkoop planner
verkoop_recruiter	verkoop recruiter
verkoop_van_aandelenderivaten	verkoop van aandelenderivaten
verkoop_vertegenwoordiger	verkoop vertegenwoordiger
verkoopmakelaar_onroerend_goed	verkoopmakelaar onroerend goed
verkoopmanager_gemeente	verkoopmanager gemeente
verkoopmanager_hypotheken	verkoopmanager hypotheken
verkoopmedewerkster_kleinhandel	verkoopmedewerkster kleinhandel
verkoopmedewerkster_makelaar	verkoopmedewerkster makelaar
verkoopsmanager	verkoopsmanager
verlader	verlader
verlichting_cameraman	verlichting cameraman
vermogensbeheerder	vermogensbeheerder
verpleegkundig_specialist_psychiatrische_ggz	verpleegkundig specialist psychiatrische ggz
verpleegkundige_contactpersoon	verpleegkundige contactpersoon
verpleegkundige_van_het_personeel	verpleegkundige van het personeel
verpleegster	verpleegster
verslaggever	verslaggever
vertaal_coördinator	vertaal coördinator
vertegenwoordiger_public_relations	vertegenwoordiger public relations
vertegenwoordiger_technische_ondersteuning	vertegenwoordiger technische ondersteuning
vertegenwoordiger_van_het_land	vertegenwoordiger van het land
vertegenwoordiger_verzekeringen	vertegenwoordiger verzekeringen
verwerkende_geofysicus	verwerkende geofysicus
verzekeraar_van_consumentenleningen	verzekeraar van consumentenleningen
verzekering_producent	verzekering producent
verzekering_uitvoerend	verzekering uitvoerend
verzekerings_verzekeraar	verzekerings verzekeraar
verzekeringsadviseur	verzekeringsadviseur
verzekeringsagent	verzekeringsagent
verzekeringsrekening_vertegenwoordiger	verzekeringsrekening vertegenwoordiger
verzekeringsspecialist	verzekeringsspecialist
verzend-_en_ontvangstcoördinator	verzend- en ontvangstcoördinator
verzend-_en_ontvangstmanager	verzend- en ontvangstmanager
verzend-_en_ontvangstmedewerker	verzend- en ontvangstmedewerker
verzender	verzender
verzending_lood	verzending lood
verzendingsverantwoordelijke	verzendingsverantwoordelijke
vestigingsmanager	vestigingsmanager
veterinaire_technicus	veterinaire technicus
vice_voorzitter_raad_van_bestuur	vice voorzitter raad van bestuur
vice-kanselier	vice-kanselier
video_bewerker	video bewerker
video_producent	video producent
video-ingenieur	video-ingenieur
video-journalist	video-journalist
videograaf	videograaf
visualizer	visualizer
visueel_ontwerper	visueel ontwerper
visueel_specialist	visueel specialist
visuele_artiest	visuele artiest
visuele_ontwikkelingskunstenaar	visuele ontwikkelingskunstenaar
vlam_artiest	vlam artiest
vlieg_instructeur	vlieg instructeur
vliegende_instructeur	vliegende instructeur
vlieger	vlieger
vloer_makelaar	vloer makelaar
vloer_technieker	vloer technieker
vlucht_test_ingenieur	vlucht test ingenieur
voedingswetenschapper	voedingswetenschapper
voedsel_ingenieur	voedsel ingenieur
voedsel_klerk	voedsel klerk
voetbalcoach	voetbalcoach
voetballer	voetballer
voip-netwerkbeheerder	voip-netwerkbeheerder
voip-technicus	voip-technicus
volgorde_kiezer	volgorde kiezer
voltooiing_ingenieur	voltooiing ingenieur
volwassen_verpleegkundig_specialist	volwassen verpleegkundig specialist
vooraanstaand_lid_van_de_technische_staf	vooraanstaand lid van de technische staf
vooraanstaande_software-ingenieur	vooraanstaande software-ingenieur
voordelen_beheerder	voordelen beheerder
voorlichtingsambtenaar	voorlichtingsambtenaar
voorman	voorman
voorraad_medewerkster	voorraad medewerkster
voortstuwing_ingenieur	voortstuwing ingenieur
vp	vp
vp_bedrijfsontwikkeling	vp bedrijfsontwikkeling
vp_bedrijfsvoering	vp bedrijfsvoering
vp_externe_betrekkingen	vp externe betrekkingen
vp_organisatieontwikkeling	vp organisatieontwikkeling
vp_strategische_initiatieven	vp strategische initiatieven
vp_talentmanagement	vp talentmanagement
vp_van_creatieve_diensten	vp van creatieve diensten
vp_van_de_verkoop_van_institutionele_aandelen	vp van de verkoop van institutionele aandelen
vp_van_eten_en_drinken	vp van eten en drinken
vp_van_global_hr	vp van global hr
vp_van_hypotheken	vp van hypotheken
vp_van_institutionele_verkoop	vp van institutionele verkoop
vp_van_rekrutering	vp van rekrutering
vp_van_talentacquisitie	vp van talentacquisitie
vp_van_werving	vp van werving
vp_van_woningkredieten	vp van woningkredieten
vp_verkenning	vp verkenning
vp_vermogensbeheer	vp vermogensbeheer
vp-strategie	vp-strategie
vracht_makelaar	vracht makelaar
vredesbeambte	vredesbeambte
vrijgezel	vrijgezel
vuur_kapitein	vuur kapitein
vuurwapen_instructeur	vuurwapen instructeur
waardering_analist	waardering analist
wacht_officier	wacht officier
walmart-medewerker	walmart-medewerker
warenhuis_manager	warenhuis manager
web_ingenieur	web ingenieur
web_producent	web producent
web_programmeur	web programmeur
web_ui-ontwikkelaar	web ui-ontwikkelaar
web_uitgever	web uitgever
web-_en_grafisch_vormgever	web- en grafisch vormgever
web-editor	web-editor
webapplicatie_programmeur	webapplicatie programmeur
webdesigner	webdesigner
webjournalist	webjournalist
website_beheerder	website beheerder
website_contentbeheerder	website contentbeheerder
website_ontwerper	website ontwerper
weg_bestuurder	weg bestuurder
wereldwijde_communicatiemanager	wereldwijde communicatiemanager
wereldwijde_logistiek_manager	wereldwijde logistiek manager
wereldwijde_pr-manager	wereldwijde pr-manager
wereldwijde_reismanager	wereldwijde reismanager
werf_voorman	werf voorman
werfleider	werfleider
werktuigbouwkundig_ingenieur	werktuigbouwkundig ingenieur
werktuigbouwkundig_ontwikkelingsingenieur	werktuigbouwkundig ontwikkelingsingenieur
werktuigbouwkundig_technicus	werktuigbouwkundig technicus
werving_adviseur	werving adviseur
werving_analist	werving analist
werving_assistent	werving assistent
werving_medewerker	werving medewerker
werving-_en_selectiemanager	werving- en selectiemanager
wervings-_en_opleidingsmanager	wervings- en opleidingsmanager
wetenschappelijke_recruiter	wetenschappelijke recruiter
wetshandhavingsfunctionaris	wetshandhavingsfunctionaris
wijk_ingenieur	wijk ingenieur
wijk_trainer	wijk trainer
wijkbeheerder_activabescherming	wijkbeheerder activabescherming
wijkverpleegkundige	wijkverpleegkundige
winkelier	winkelier
winkelier_in_de_detailhandel	winkelier in de detailhandel
winkelmedewerker	winkelmedewerker
woordvoerder	woordvoerder
zaakvoerder	zaakvoerder
zaakvoerder_van_het_zakencentrum	zaakvoerder van het zakencentrum
zakelijk_deskundige	zakelijk deskundige
zakelijk_reisbureau	zakelijk reisbureau
zakelijk_reismanager	zakelijk reismanager
zakelijke_chef-kok	zakelijke chef-kok
zakelijke_evenementenplanner	zakelijke evenementenplanner
zakelijke_ontwikkelaar	zakelijke ontwikkelaar
zakelijke_schrijver	zakelijke schrijver
zakelijke_stewardess	zakelijke stewardess
zakelijke_webmaster	zakelijke webmaster
zang_coach	zang coach
zanger	zanger
zeevruchten_klerk	zeevruchten klerk
ziekenhuis_directeur	ziekenhuis directeur
zoek_adviseur	zoek adviseur
zomer_jurist	zomer jurist
zomeranalist_investeringsbankieren	zomeranalist investeringsbankieren
zomerkamp_begeleider	zomerkamp begeleider
zorg_recruiter	zorg recruiter
zwem_coach	zwem coach
zwembad_beheerder	zwembad beheerder
