3d_animator	3d animator
acupuncturist	acupuncturist
adviseur_bedrijfsstrategie	adviseur bedrijfsstrategie
advocaat	advocaat
agronoom	agronoom
analist_investeringsbankieren	analist investeringsbankieren
analist_netwerkbeveiliging	analist netwerkbeveiliging
analist_private_equity	analist private equity
analoog_ontwerper	analoog ontwerper
anesthesist	anesthesist
apotheker	apotheker
archivaris	archivaris
auto_ingenieur	auto ingenieur
automatisering_ingenieur	automatisering ingenieur
bakker	bakker
bankier	bankier
barman	barman
basisschoolleerkracht	basisschoolleerkracht
beleidsadviseur	beleidsadviseur
bemiddelaar	bemiddelaar
binnenhuisarchitect	binnenhuisarchitect
biomedische_ingenieur	biomedische ingenieur
boor_ingenieur	boor ingenieur
brandweerman	brandweerman
brievenbus	brievenbus
burgerlijk_ingenieur	burgerlijk ingenieur
cameraman	cameraman
cateraar	cateraar
chemische_operator	chemische operator
componist	componist
computerreparateur	computerreparateur
conciërge	conciërge
danser	danser
dierenarts	dierenarts
draadloze_ingenieur	draadloze ingenieur
elektronisch_ingenieur	elektronisch ingenieur
exploratie_geoloog	exploratie geoloog
film_regisseur	film regisseur
fiscaal_accountant	fiscaal accountant
fotograaf	fotograaf
frontoffice_medewerker	frontoffice medewerker
galerie_directeur	galerie directeur
geregistreerde_verpleegster	geregistreerde verpleegster
grafisch_ontwerper	grafisch ontwerper
haar_stylist	haar stylist
handelaar_in_aandelen	handelaar in aandelen
handelsmarketing_analist	handelsmarketing analist
hondenkapper	hondenkapper
hondentrainer	hondentrainer
hoogleraar_geschiedenis	hoogleraar geschiedenis
huwelijksplanner	huwelijksplanner
hydrogeoloog	hydrogeoloog
import_export_specialist	import export specialist
inzamelingsactie	inzamelingsactie
ios-ontwikkelaar	ios-ontwikkelaar
java-ontwikkelaar	java-ontwikkelaar
kassa	kassa
kleuterjuf	kleuterjuf
koken	koken
lening_officier	lening officier
levensmiddelen_technoloog	levensmiddelen technoloog
loodgieter	loodgieter
makelaar	makelaar
media_koper	media koper
metallurg	metallurg
mode_ontwerper	mode ontwerper
netwerktechnicus	netwerktechnicus
nieuwslezer	nieuwslezer
omgeving_kunstenaar	omgeving kunstenaar
omroep_ingenieur	omroep ingenieur
oppas	oppas
persoonlijke_fitnesstrainer	persoonlijke fitnesstrainer
piloot	piloot
politie-detective	politie-detective
portefeuille_analist	portefeuille analist
prive_detective	prive detective
procureur	procureur
psychotherapeut	psychotherapeut
radiologisch_technoloog	radiologisch technoloog
reis_agent	reis agent
ruimtevaart_ingenieur	ruimtevaart ingenieur
specialist_logistiek	specialist logistiek
sportcoach	sportcoach
stedenbouwkundig_ontwerper	stedenbouwkundig ontwerper
talent_acquisitie	talent acquisitie
tandarts	tandarts
technicus_voor_desktopondersteuning	technicus voor desktopondersteuning
technische_recruiter	technische recruiter
tekstschrijver	tekstschrijver
telecommunicatie_ingenieur	telecommunicatie ingenieur
textiel_ontwerper	textiel ontwerper
timmerman	timmerman
uitgeverij	uitgeverij
uitvoerende_public_relations	uitvoerende public relations
vertaler	vertaler
vertegenwoordiger_technische_ondersteuning	vertegenwoordiger technische ondersteuning
verzekeringsagent	verzekeringsagent
video_bewerker	video bewerker
visagiste	visagiste
vorkheftruckbestuurder	vorkheftruckbestuurder
vrachtwagenchauffeur	vrachtwagenchauffeur
webontwikkelaar	webontwikkelaar
werktuigbouwkundig_ingenieur	werktuigbouwkundig ingenieur
zanger	zanger
zeeman	zeeman
