2차_지원_분석가	2차 지원 분석가
3D_모델러	3D 모델러
3D_아티스트	3D 아티스트
3D_제너럴리스트	3D 제너럴리스트
3D_캐릭터_애니메이터	3D 캐릭터 애니메이터
3D_환경_아티스트	3D 환경 아티스트
BSC_엔지니어	BSC 엔지니어
HR_그룹장	HR 그룹장
HR_분석가	HR 분석가
HR_비즈니스_파트너	HR 비즈니스 파트너
HR_정보_시스템_분석가	HR 정보 시스템 분석가
HR_직원	HR 직원
HR_채용_담당자	HR 채용 담당자
HR_채용_보조원	HR 채용 보조원
HR_채용_전문가	HR 채용 전문가
HR_채용_코디네이터	HR 채용 코디네이터
HR_책임자	HR 책임자
HR_총괄	HR 총괄
HR_컨설턴트	HR 컨설턴트
HR_코디네이터	HR 코디네이터
HTML5_개발자	HTML5 개발자
IT_기술_채용_담당자	IT 기술 채용 담당자
IT_기술자	IT 기술자
IT_보안_관리자	IT 보안 관리자
IT_보안_분석가	IT 보안 분석가
IT_보안_엔지니어	IT 보안 엔지니어
IT_시스템_엔지니어	IT 시스템 엔지니어
IT_전문가	IT 전문가
IT_제너럴리스트	IT 제너럴리스트
IT_지원_기술자	IT 지원 기술자
IT_지원_전문가	IT 지원 전문가
IT_채용_담당자	IT 채용 담당자
IT_채용_컨설턴트	IT 채용 컨설턴트
IT_컨설턴트	IT 컨설턴트
IT_현장_기술자	IT 현장 기술자
MBA_대학원생	MBA 대학원생
MBA_참가자	MBA 참가자
MBA_후보자	MBA 후보자
PHP_웹_개발자	PHP 웹 개발자
PHP_프로그래머	PHP 프로그래머
UI_디자이너	UI 디자이너
UI_엔지니어	UI 엔지니어
VP_전략_이니셔티브	VP 전략 이니셔티브
VoIP_네트워크_엔지니어	VoIP 네트워크 엔지니어
VoIP_엔지니어	VoIP 엔지니어
iOS_앱_개발자	iOS 앱 개발자
j2ee_개발자	j2ee 개발자
가격_감독자	가격 감독자
가격_조정자	가격 조정자
가까이에_게시하다	가까이에 게시하다
가사_감독자	가사 감독자
가사_관리자	가사 관리자
가사_담당_조국장	가사 담당 조국장
가수	가수
가정_건강_간호사	가정 건강 간호사
가정법_변호사	가정법 변호사
가정부	가정부
가정의	가정의
가족_상담사	가족 상담사
가족_서비스_이사	가족 서비스 이사
가족_지원_노동자	가족 지원 노동자
간청자	간청자
간호_강사	간호 강사
간호부_부국장	간호부 부국장
간호사	간호사
간호사_숙련자	간호사 숙련자
간호사_연락	간호사 연락
간호학생	간호학생
감독	감독
감독_특수_요원	감독 특수 요원
감사	감사
감사원	감사원
감시_장교	감시 장교
강사	강사
개_보행기	개 보행기
개_조련사	개 조련사
개발_기술자	개발 기술자
개발_및_홍보_담당_이사	개발 및 홍보 담당 이사
개발_프로듀서	개발 프로듀서
개발자	개발자
개인_고객_관리자	개인 고객 관리자
개인_고객_서비스	개인 고객 서비스
개인_기부_관리자	개인 기부 관리자
개인_라인_매니저	개인 라인 매니저
개인_모기지_은행원	개인 모기지 은행원
개인_보험_인수자	개인 보험 인수자
개인_연습	개인 연습
개인_요리사	개인 요리사
개인_은행_고문	개인 은행 고문
개인_은행_관리자	개인 은행 관리자
개인_은행_보조원	개인 은행 보조원
개인_은행_분석가	개인 은행 분석가
개인_이벤트_디렉터	개인 이벤트 디렉터
개인_진료를_하는_심리치료사	개인 진료를 하는 심리치료사
개인_트레이너	개인 트레이너
개인_트레이닝_디렉터	개인 트레이닝 디렉터
개인_트레이닝_매니저	개인 트레이닝 매니저
개인용_컴퓨터_기술자	개인용 컴퓨터 기술자
개인용_컴퓨터_수리_기술자	개인용 컴퓨터 수리 기술자
개인용_컴퓨터_전문가	개인용 컴퓨터 전문가
개인은행_대표	개인은행 대표
개집_조수	개집 조수
객실_승무원	객실 승무원
갤러리_매니저	갤러리 매니저
갤러리_어시스턴트	갤러리 어시스턴트
갤러리_준회원	갤러리 준회원
갤러리_코디네이터	갤러리 코디네이터
거래_보조원	거래 보조원
거래_분석가	거래 분석가
거래_전문가	거래 전문가
거래_책임자	거래 책임자
거래소_관리자	거래소 관리자
거주자	거주자
건강_및_피트니스_전문가	건강 및 피트니스 전문가
건강_방문자	건강 방문자
건설_감독	건설 감독
건설_감독관	건설 감독관
건설_인턴	건설 인턴
건설_전_관리자	건설 전 관리자
건설_전_이사	건설 전 이사
건설감독관	건설감독관
건축_디자이너	건축 디자이너
건축_조수	건축 조수
건축_준회원	건축 준회원
건축_학생	건축 학생
건축가	건축가
건축업자	건축업자
건축학_교수	건축학 교수
검색_임원	검색 임원
검색_컨설턴트	검색 컨설턴트
게스트_관계_코디네이터	게스트 관계 코디네이터
게스트_서비스_담당자	게스트 서비스 담당자
게스트_서비스_직원	게스트 서비스 직원
게스트_서비스_코디네이터	게스트 서비스 코디네이터
게스트_아티스트	게스트 아티스트
게임_디렉터	게임 디렉터
게임_디자이너	게임 디자이너
게임_아티스트	게임 아티스트
결제_전문가	결제 전문가
결혼과_가족_치료사	결혼과 가족 치료사
결혼식_및_이벤트_플래너	결혼식 및 이벤트 플래너
겸임강사	겸임강사
겸임교수	겸임교수
경관	경관
경매인	경매인
경영_컨설턴트	경영 컨설턴트
경영_코치	경영 코치
경영주주	경영주주
경영진이_게스트_경험을_주도합니다	경영진이 게스트 경험을 주도합니다
경영학_조교수	경영학 조교수
경제_개발_담당관	경제 개발 담당관
경찰_대장	경찰 대장
경찰_부국장	경찰 부국장
경찰_상사	경찰 상사
경찰_순경	경찰 순경
경찰_조사관	경찰 조사관
경찰_중위	경찰 중위
경찰_탐정	경찰 탐정
경찰관	경찰관
경찰서장	경찰서장
경찰차장	경찰차장
계산원_고객_서비스	계산원 고객 서비스
계약_기계_엔지니어	계약 기계 엔지니어
계약_변호사	계약 변호사
계약_사진작가	계약 사진작가
계약_웹_개발자	계약 웹 개발자
계약_작가	계약 작가
계약_조종사	계약 조종사
계약_지질학자	계약 지질학자
계약_채용_담당자	계약 채용 담당자
계약_카피라이터	계약 카피라이터
계약자	계약자
계절_판매_직원	계절 판매 직원
계정_감독자	계정 감독자
계정_관리자	계정 관리자
계정_모집_관리자	계정 모집 관리자
계정_전략가	계정 전략가
계정_플래너	계정 플래너
고객_관계_관리자	고객 관계 관리자
고객_관계_동료	고객 관계 동료
고객_관리_책임자	고객 관리 책임자
고객_기술_지원_엔지니어	고객 기술 지원 엔지니어
고객_서비스_담당자	고객 서비스 담당자
고객_서비스_이사	고객 서비스 이사
고객_서비스_전문가	고객 서비스 전문가
고객_옹호자	고객 옹호자
고객_지원_기술자	고객 지원 기술자
고객_지원_분석가	고객 지원 분석가
고객_지원_전문가	고객 지원 전문가
고객_회계사	고객 회계사
고급_시스템_엔지니어	고급 시스템 엔지니어
고급_실무_간호사	고급 실무 간호사
고등학교_교사	고등학교 교사
고등학교_수학_선생님	고등학교 수학 선생님
고수	고수
고위_임원	고위 임원
고정_수입_거래자	고정 수입 거래자
고정_수입_이사	고정 수입 이사
공개_연설_아나운서	공개 연설 아나운서
공공_서비스_사서	공공 서비스 사서
공공_정책_관리자	공공 정책 관리자
공급_교사	공급 교사
공급망_책임자	공급망 책임자
공급원	공급원
공기_역학_엔지니어	공기 역학 엔지니어
공립학교_교사	공립학교 교사
공연_예술가	공연 예술가
공인_간호조무사	공인 간호조무사
공인_개인_트레이너	공인 개인 트레이너
공인_모기지_계획_전문가	공인 모기지 계획 전문가
공인_모기지_플래너	공인 모기지 플래너
공인_법률_인턴	공인 법률 인턴
공인_부동산_감정사	공인 부동산 감정사
공인_부동산_중개인	공인 부동산 중개인
공인_약국_기술자	공인 약국 기술자
공인_임상_연구_코디네이터	공인 임상 연구 코디네이터
공인_재무_분석가	공인 재무 분석가
공인_주택_감정사	공인 주택 감정사
공인_회계사	공인 회계사
공정_기계_엔지니어	공정 기계 엔지니어
공정_기술자	공정 기술자
공정_제어_엔지니어	공정 제어 엔지니어
공중_보건_간호사	공중 보건 간호사
공항_운영_감독관	공항 운영 감독관
과자_요리사	과자 요리사
과제_편집자	과제 편집자
과학_모집자	과학 모집자
관계_관리자	관계 관리자
관계_은행원	관계 은행원
관계_임원	관계 임원
관계_책임자	관계 책임자
관광_가이드	관광 가이드
관류_치료사	관류 치료사
관리_감독자	관리 감독자
관리_변호사	관리 변호사
관리_브로커	관리 브로커
관리_파트너	관리 파트너
관리인	관리인
관리자	관리자
관리자_고급_서비스	관리자 고급 서비스
관리자_네트워크_엔지니어링	관리자 네트워크 엔지니어링
관리자_네트워크_운영	관리자 네트워크 운영
관리자_인재_확보	관리자 인재 확보
관리자_전략_계획	관리자 전략 계획
광고_감독자	광고 감독자
광고_계정_관리자	광고 계정 관리자
광고_계정_담당자	광고 계정 담당자
광고_디자이너	광고 디자이너
광고_매니저	광고 매니저
광고_전문가	광고 전문가
광고_책임자	광고 책임자
광고_카피라이터	광고 카피라이터
광고_코디네이터	광고 코디네이터
광고제작코디네이터	광고제작코디네이터
광산_엔지니어	광산 엔지니어
광산_지질학자	광산 지질학자
교감	교감
교대_리드	교대 리드
교량_엔지니어	교량 엔지니어
교사_보좌관	교사 보좌관
교수	교수
교수진_고문	교수진 고문
교실_교사	교실 교사
교실_조교	교실 조교
교육_교수	교육 교수
교육_보조	교육 보조
교육_상담사	교육 상담사
교육_이사	교육 이사
교육_전문가	교육 전문가
교육_치료사	교육 치료사
교육_코치	교육 코치
교육진단사	교육진단사
교육학_조교수	교육학 조교수
교장	교장
교장_선생님	교장 선생님
교정_엔지니어	교정 엔지니어
교정관	교정관
교정자	교정자
교통_감독관	교통 감독관
교통_관리자	교통 관리자
교통_기자	교통 기자
구강악안면외과_전문의	구강악안면외과 전문의
구매자_대리인	구매자 대리인
구성_기술자	구성 기술자
구인_전문가	구인 전문가
구조화_금융_분석가	구조화 금융 분석가
구조화금융_이사	구조화금융 이사
구조화금융부장	구조화금융부장
구축함	구축함
구현_감독자	구현 감독자
구현_엔지니어	구현 엔지니어
구호_관리자	구호 관리자
국가_대표	국가 대표
국가_사업_관리자	국가 사업 관리자
국가_전문가	국가 전문가
국내_특파원	국내 특파원
국선_변호인	국선 변호인
국세청장	국세청장
국제_구매_관리자	국제 구매 관리자
국제_모집자	국제 모집자
국제_무역_전문가	국제 무역 전문가
국제_물류_관리자	국제 물류 관리자
국제_물류_코디네이터	국제 물류 코디네이터
국제_변호사	국제 변호사
국제_비즈니스_개발_컨설턴트	국제 비즈니스 개발 컨설턴트
국제_여행_컨설턴트	국제 여행 컨설턴트
국제_홍보_매니저	국제 홍보 매니저
군단_회원	군단 회원
규제_업무_약사	규제 업무 약사
규제_자문	규제 자문
그래픽_기술자	그래픽 기술자
그래픽_디자인_감독	그래픽 디자인 감독
그래픽_디자인_강사	그래픽 디자인 강사
그래픽_디자인_매니저	그래픽 디자인 매니저
그래픽_디자인_선생님	그래픽 디자인 선생님
그래픽_디자인_아티스트	그래픽 디자인 아티스트
그래픽_디자인_어시스턴트	그래픽 디자인 어시스턴트
그래픽_디자인_인턴	그래픽 디자인 인턴
그래픽_디자인_컨설턴트	그래픽 디자인 컨설턴트
그래픽_디자인_코디네이터	그래픽 디자인 코디네이터
그래픽_디자인_학생	그래픽 디자인 학생
그래픽_서비스_관리자	그래픽 서비스 관리자
그래픽_아티스트	그래픽 아티스트
그래픽_전문가	그래픽 전문가
그래픽_프로덕션_아티스트	그래픽 프로덕션 아티스트
그루머	그루머
그룹_물류_관리자	그룹 물류 관리자
그룹_미디어_디렉터	그룹 미디어 디렉터
그룹_미술_감독	그룹 미술 감독
그룹_법률_고문	그룹 법률 고문
그룹_복사_감독자	그룹 복사 감독자
그룹_엔지니어링_관리자	그룹 엔지니어링 관리자
그룹_인사담당자	그룹 인사담당자
그룹_진행자	그룹 진행자
그룹_출판사	그룹 출판사
그룹_피트니스_강사	그룹 피트니스 강사
그룹기획이사	그룹기획이사
근거리_통신망_관리자	근거리 통신망 관리자
근관치료_전문의	근관치료 전문의
근력_및_컨디셔닝_코치	근력 및 컨디셔닝 코치
근위대	근위대
글로벌_HR_부사장	글로벌 HR 부사장
글로벌_물류_관리자	글로벌 물류 관리자
글로벌_비즈니스_개발_관리자	글로벌 비즈니스 개발 관리자
글로벌_여행_매니저	글로벌 여행 매니저
글로벌_커뮤니케이션_매니저	글로벌 커뮤니케이션 매니저
글로벌_홍보_매니저	글로벌 홍보 매니저
글쎄_엔지니어	글쎄 엔지니어
금고_관리자	금고 관리자
금융_모집자	금융 모집자
금융_서비스_직원	금융 서비스 직원
금융_시장_분석가	금융 시장 분석가
금융_작가	금융 작가
금융_저널리스트	금융 저널리스트
금융_중개인	금융 중개인
금융기관장	금융기관장
금융학_겸임교수	금융학 겸임교수
급여_감독관	급여 감독관
급여_및_복리후생_코디네이터	급여 및 복리후생 코디네이터
급여_세무사	급여 세무사
급여_회계사	급여 회계사
기계_개발_엔지니어	기계 개발 엔지니어
기계_공학_기술자	기계 공학 기술자
기계_공학_컨설턴트	기계 공학 컨설턴트
기계_디자이너	기계 디자이너
기계_설계_관리자	기계 설계 관리자
기계_설계_엔지니어	기계 설계 엔지니어
기계_시스템_엔지니어	기계 시스템 엔지니어
기계_전문가	기계 전문가
기계_제도사	기계 제도사
기계_프로젝트_엔지니어	기계 프로젝트 엔지니어
기계공학_인턴	기계공학 인턴
기계공학과_학생	기계공학과 학생
기고_작가	기고 작가
기관_영업_부사장	기관 영업 부사장
기관_영업_이사	기관 영업 이사
기관_자산_판매_담당_부사장	기관 자산 판매 담당 부사장
기관_판매_상인	기관 판매 상인
기금_개발_이사	기금 개발 이사
기금_개발_코디네이터	기금 개발 코디네이터
기능_작가	기능 작가
기록_보관소_기술자	기록 보관소 기술자
기록_사무관	기록 사무관
기병	기병
기본_사격술_강사	기본 사격술 강사
기부자	기부자
기부자_관계_관리자	기부자 관계 관리자
기부자_관계_코디네이터	기부자 관계 코디네이터
기사_조수	기사 조수
기술	기술
기술_감독관	기술 감독관
기술_고객_지원_담당자	기술 고객 지원 담당자
기술_디자이너	기술 디자이너
기술_리드	기술 리드
기술_번역가	기술 번역가
기술_분석가	기술 분석가
기술_분야_엔지니어	기술 분야 엔지니어
기술_사무실_엔지니어	기술 사무실 엔지니어
기술_설계자	기술 설계자
기술_영업_지원_엔지니어	기술 영업 지원 엔지니어
기술_운영자	기술 운영자
기술_지원_감독자	기술 지원 감독자
기술_지원_기술자	기술 지원 기술자
기술_지원_담당자	기술 지원 담당자
기술_지원_분석가	기술 지원 분석가
기술_지원_엔지니어	기술 지원 엔지니어
기술_지원_전문가	기술 지원 전문가
기술_지원_직원	기술 지원 직원
기술_지원_코디네이터	기술 지원 코디네이터
기술_채용_관리자	기술 채용 관리자
기술_채용_담당자	기술 채용 담당자
기술_코치	기술 코치
기술_테스트_리드	기술 테스트 리드
기술_프로듀서	기술 프로듀서
기술사무실장	기술사무실장
기술자	기술자
기술적_지원	기술적 지원
기술지원팀장	기술지원팀장
기술직원	기술직원
기업_개발_분석가	기업 개발 분석가
기업_개발_직원	기업 개발 직원
기업_고문	기업 고문
기업_물류_관리자	기업 물류 관리자
기업_및_재단_관계_이사	기업 및 재단 관계 이사
기업_법률_고문	기업 법률 고문
기업_법률_보조원	기업 법률 보조원
기업_변호사	기업 변호사
기업_비서_보좌관	기업 비서 보좌관
기업_사서	기업 사서
기업_수석_셰프	기업 수석 셰프
기업_승무원	기업 승무원
기업_신용_분석가	기업 신용 분석가
기업_애플리케이션_엔지니어	기업 애플리케이션 엔지니어
기업_여행_매니저	기업 여행 매니저
기업_여행사	기업 여행사
기업_요리사	기업 요리사
기업_웹마스터	기업 웹마스터
기업_은행_분석가	기업 은행 분석가
기업_이벤트_기획자	기업 이벤트 기획자
기업_재무_분석가	기업 재무 분석가
기업_재무_임원	기업 재무 임원
기업_조사관	기업 조사관
기업_커뮤니케이션_직원	기업 커뮤니케이션 직원
기업_커뮤니케이션_코디네이터	기업 커뮤니케이션 코디네이터
기업_파일럿	기업 파일럿
기업_파트너십_이사	기업 파트너십 이사
기업금융_인턴	기업금융 인턴
기업금융부장	기업금융부장
기업은행_부장	기업은행 부장
기업은행_이사	기업은행 이사
기증자관계담당관	기증자관계담당관
기지_관리자	기지 관리자
기타_선생님	기타 선생님
기타_연주자	기타 연주자
기타리스트	기타리스트
기획기부_이사	기획기부 이사
긴급_파견자	긴급 파견자
꽃_관리자	꽃 관리자
꽃_디자이너	꽃 디자이너
난방_및_에어컨_엔지니어	난방 및 에어컨 엔지니어
남성복_디자이너	남성복 디자이너
내과_레지던트	내과 레지던트
내과_의사	내과 의사
내부_도매상	내부 도매상
내부_수익_대리인	내부 수익 대리인
내부_채용_담당자	내부 채용 담당자
내부_커뮤니케이션_책임자	내부 커뮤니케이션 책임자
내부_커뮤니케이션_코디네이터	내부 커뮤니케이션 코디네이터
네트워크_계획_엔지니어	네트워크 계획 엔지니어
네트워크_관리자	네트워크 관리자
네트워크_구현_관리자	네트워크 구현 관리자
네트워크_기술자	네트워크 기술자
네트워크_디자이너	네트워크 디자이너
네트워크_디자인_매니저	네트워크 디자인 매니저
네트워크_보안_관리자	네트워크 보안 관리자
네트워크_보안_분석가	네트워크 보안 분석가
네트워크_보안_엔지니어	네트워크 보안 엔지니어
네트워크_보안_전문가	네트워크 보안 전문가
네트워크_보안_컨설턴트	네트워크 보안 컨설턴트
네트워크_분석가	네트워크 분석가
네트워크_설계_엔지니어	네트워크 설계 엔지니어
네트워크_설계_컨설턴트	네트워크 설계 컨설턴트
네트워크_설계자	네트워크 설계자
네트워크_성능_엔지니어	네트워크 성능 엔지니어
네트워크_시스템_엔지니어	네트워크 시스템 엔지니어
네트워크_엔지니어	네트워크 엔지니어
네트워크_엔지니어링_컨설턴트	네트워크 엔지니어링 컨설턴트
네트워크_운영_분석가	네트워크 운영 분석가
네트워크_운영_센터_분석가	네트워크 운영 센터 분석가
네트워크_운영_센터_운영자	네트워크 운영 센터 운영자
네트워크_운영_센터_팀장	네트워크 운영 센터 팀장
네트워크_운영_엔지니어	네트워크 운영 엔지니어
네트워크_운영_이사	네트워크 운영 이사
네트워크_운영_책임자	네트워크 운영 책임자
네트워크_인프라_관리자	네트워크 인프라 관리자
네트워크_인프라_엔지니어	네트워크 인프라 엔지니어
네트워크_전문가	네트워크 전문가
네트워크_제공자	네트워크 제공자
네트워크_제어_기술자	네트워크 제어 기술자
네트워크_지원_기술자	네트워크 지원 기술자
네트워크_지원_분석가	네트워크 지원 분석가
네트워크_지원_엔지니어	네트워크 지원 엔지니어
네트워크_책임자	네트워크 책임자
네트워크_컨설턴트	네트워크 컨설턴트
네트워크_통합_엔지니어	네트워크 통합 엔지니어
네트워크_통합업체	네트워크 통합업체
네트워크운영센터장	네트워크운영센터장
노동_및_고용_전문_변호사	노동 및 고용 전문 변호사
노선_개발_관리자	노선 개발 관리자
녹음_엔지니어	녹음 엔지니어
농업_엔지니어	농업 엔지니어
농촌_운송업자	농촌 운송업자
농촌_운송업체_직원	농촌 운송업체 직원
뉴미디어_프로듀서	뉴미디어 프로듀서
뉴스_디렉터	뉴스 디렉터
뉴스_리포터	뉴스 리포터
뉴스_운영_관리자	뉴스 운영 관리자
뉴스_프로듀서	뉴스 프로듀서
뉴스보조국장	뉴스보조국장
니트웨어_디자이너	니트웨어 디자이너
다소	다소
다큐멘터리_영화제작자	다큐멘터리 영화제작자
단체_예약_코디네이터	단체 예약 코디네이터
닻	닻
대대장	대대장
대리	대리
대리_기업_커뮤니케이션	대리 기업 커뮤니케이션
대리_모집	대리 모집
대리교사	대리교사
대리점_관리자	대리점 관리자
대리점_대표	대리점 대표
대리점_분야_전문가	대리점 분야 전문가
대변인	대변인
대외관계_담당_부사장	대외관계 담당 부사장
대장_보좌	대장 보좌
대출_담당자	대출 담당자
대출_사무원	대출 사무원
대출_이사	대출 이사
대출_전문가	대출 전문가
대출_처리자	대출 처리자
대출_코디네이터	대출 코디네이터
대출_클로저	대출 클로저
대학_강사	대학 강사
대학_교수	대학 교수
대학_등록_기관	대학 등록 기관
대학_사서	대학 사서
대학_프로그램_인턴	대학 프로그램 인턴
대학원_건축가	대학원 건축가
대학원_구조_엔지니어	대학원 구조 엔지니어
대학원_기계공학자	대학원 기계공학자
대학원_연구원	대학원 연구원
대학원_토목공학자	대학원 토목공학자
대학원_프로그램_코디네이터	대학원 프로그램 코디네이터
대학원생	대학원생
대학원생_강사	대학원생 강사
대행사_소유자	대행사 소유자
대행사_채용_담당자	대행사 채용 담당자
대행사_현장_임원	대행사 현장 임원
대행사장	대행사장
대화형_개발자	대화형 개발자
대화형_미디어_관리자	대화형 미디어 관리자
대화형_영업_관리자	대화형 영업 관리자
댄스_강사	댄스 강사
댄스_선생님	댄스 선생님
데스크사이드_지원_기술자	데스크사이드 지원 기술자
데스크탑_엔지니어	데스크탑 엔지니어
데스크탑_지원	데스크탑 지원
데스크탑_지원_기술자	데스크탑 지원 기술자
데스크탑_지원_분석가	데스크탑 지원 분석가
데스크탑_지원_엔지니어	데스크탑 지원 엔지니어
데스크탑_지원_인턴	데스크탑 지원 인턴
데스크탑_지원_전문가	데스크탑 지원 전문가
데스크탑_지원팀_리더	데스크탑 지원팀 리더
데스크탑_출판_운영자	데스크탑 출판 운영자
데스크톱_관리자	데스크톱 관리자
데스크톱_출판사	데스크톱 출판사
데이터_네트워크_엔지니어	데이터 네트워크 엔지니어
데이터_네트워크_전문가	데이터 네트워크 전문가
데이터_네트워크_컨설턴트	데이터 네트워크 컨설턴트
데이터_보안_관리자	데이터 보안 관리자
데이터베이스_개발자	데이터베이스 개발자
데이터센터_감독자	데이터센터 감독자
데이터센터_관리자	데이터센터 관리자
데이터센터_분석가	데이터센터 분석가
데이터센터_운영자	데이터센터 운영자
도구_개발자	도구 개발자
도로_운전사	도로 운전사
도서관_미디어_전문가	도서관 미디어 전문가
도시_계획가	도시 계획가
도시_엔지니어	도시 엔지니어
도시_편지_배달원	도시 편지 배달원
도시_편집자	도시 편집자
독서_교사	독서 교사
독서_선생님	독서 선생님
독서_전문가	독서 전문가
독서_코치	독서 코치
독점_거래자	독점 거래자
독점_대리점	독점 대리점
동료_주장	동료 주장
동료를_생산하다	동료를 생산하다
동물_관리_기술자	동물 관리 기술자
동물_보호_동료	동물 보호 동료
동영상_편집기	동영상 편집기
동창_관계_담당관	동창 관계 담당관
동창_관계_매니저	동창 관계 매니저
동창_임원	동창 임원
두_번째_대리	두 번째 대리
두_번째_조감독	두 번째 조감독
두_번째_조수	두 번째 조수
두_번째_항해사	두 번째 항해사
드라마_선생님	드라마 선생님
드라이브_테스트_엔지니어	드라이브 테스트 엔지니어
드릴러	드릴러
드릴링_매니저	드릴링 매니저
드릴링_컨설턴트	드릴링 컨설턴트
등록_관리_이사	등록 관리 이사
등록_이사	등록 이사
등록된_수의사	등록된 수의사
등록된_치과_조수	등록된 치과 조수
등록된_치과위생사	등록된 치과위생사
디자이너	디자이너
디자인_강사	디자인 강사
디자인_건축가	디자인 건축가
디자인_릴리즈_엔지니어	디자인 릴리즈 엔지니어
디자인_및_개발_이사	디자인 및 개발 이사
디자인_및_생산_인턴	디자인 및 생산 인턴
디자인_센터_매니저	디자인 센터 매니저
디자인_스튜디오_매니저	디자인 스튜디오 매니저
디자인_어시스턴트	디자인 어시스턴트
디자인_엔지니어	디자인 엔지니어
디자인_엔지니어링_인턴	디자인 엔지니어링 인턴
디자인_인턴	디자인 인턴
디자인_코디네이터	디자인 코디네이터
디자인_편집자	디자인 편집자
디자인부장	디자인부장
디자인팀장	디자인팀장
디지털_감독자	디지털 감독자
디지털_계정_관리자	디지털 계정 관리자
디지털_계정_이사	디지털 계정 이사
디지털_계정_임원	디지털 계정 임원
디지털_디자이너	디지털 디자이너
디지털_디자인_엔지니어	디지털 디자인 엔지니어
디지털_마케팅_매니저	디지털 마케팅 매니저
디지털_미디어_감독자	디지털 미디어 감독자
디지털_미디어_기획자	디지털 미디어 기획자
디지털_미디어_디자이너	디지털 미디어 디자이너
디지털_미디어_프로듀서	디지털 미디어 프로듀서
디지털_영업_관리자	디지털 영업 관리자
디지털_이미징_기술자	디지털 이미징 기술자
디지털_콘텐츠_관리자	디지털 콘텐츠 관리자
디지털_프로듀서	디지털 프로듀서
디지털_플래너	디지털 플래너
디지털미디어_부문장	디지털미디어 부문장
라디오_기획_엔지니어	라디오 기획 엔지니어
라디오_방송인	라디오 방송인
라디오_엔지니어	라디오 엔지니어
라디오_토크쇼_진행자	라디오 토크쇼 진행자
라디오_프로듀서	라디오 프로듀서
라이프스타일_에디터	라이프스타일 에디터
라인_셰프	라인 셰프
라인_파일럿	라인 파일럿
라인_프로듀서	라인 프로듀서
러시아_언어학자	러시아 언어학자
레버리지_금융_분석가	레버리지 금융 분석가
레스토랑_감독자	레스토랑 감독자
레스토랑_매니저	레스토랑 매니저
레스토랑_서버	레스토랑 서버
레스토랑_요리사	레스토랑 요리사
레스토랑_총지배인	레스토랑 총지배인
레스토랑과_바_매니저	레스토랑과 바 매니저
레이아웃_디자이너	레이아웃 디자이너
레이아웃_디자인_엔지니어	레이아웃 디자인 엔지니어
레이아웃_아티스트	레이아웃 아티스트
레이아웃_엔지니어	레이아웃 엔지니어
레저_영업_이사	레저 영업 이사
롤아웃_엔지니어	롤아웃 엔지니어
뢴트겐_기사	뢴트겐 기사
룸_부문_매니저	룸 부문 매니저
리더십_개발_컨설턴트	리더십 개발 컨설턴트
리셉션_매니저	리셉션 매니저
리터처	리터처
마감_감독자	마감 감독자
마감_전문가	마감 전문가
마스터_목수	마스터 목수
마스터_세금_고문	마스터 세금 고문
마스터_스타일리스트	마스터 스타일리스트
마스터_제어_연산자	마스터 제어 연산자
마이크로소프트_시스템_관리자	마이크로소프트 시스템 관리자
마이크로소프트_시스템_엔지니어	마이크로소프트 시스템 엔지니어
마이크로컴퓨터_전문가	마이크로컴퓨터 전문가
마취_기술자	마취 기술자
마취과_레지던트	마취과 레지던트
마케팅_담당자	마케팅 담당자
마케팅_및_커뮤니케이션_임원	마케팅 및 커뮤니케이션 임원
마케팅_및_커뮤니케이션_직원	마케팅 및 커뮤니케이션 직원
마케팅_및_커뮤니케이션_코디네이터	마케팅 및 커뮤니케이션 코디네이터
마케팅_및_홍보_담당자	마케팅 및 홍보 담당자
마케팅_및_홍보_전문가	마케팅 및 홍보 전문가
마케팅_및_홍보_컨설턴트	마케팅 및 홍보 컨설턴트
마케팅_분석가	마케팅 분석가
마케팅_서비스_코디네이터	마케팅 서비스 코디네이터
마케팅_전략가	마케팅 전략가
마케팅_카피라이터	마케팅 카피라이터
마케팅_커뮤니케이션_전문가	마케팅 커뮤니케이션 전문가
마케팅_컨설턴트	마케팅 컨설턴트
말하는_사람	말하는 사람
매니_징_디렉터	매니 징 디렉터
매니큐어리스트	매니큐어리스트
멀티미디어_디자이너	멀티미디어 디자이너
멀티미디어_인턴	멀티미디어 인턴
멀티미디어_저널리스트	멀티미디어 저널리스트
멀티미디어_프로그래머	멀티미디어 프로그래머
멀티미디어_프로듀서	멀티미디어 프로듀서
메디컬_일러스트레이터	메디컬 일러스트레이터
메일_프로세서	메일 프로세서
메트로_편집자	메트로 편집자
멤버십_서비스_이사	멤버십 서비스 이사
면허가_있는_심리학자	면허가 있는 심리학자
면허가_있는_임상_심리학자	면허가 있는 임상 심리학자
명예_교수	명예 교수
모금_관리자	모금 관리자
모금_이사	모금 이사
모금_책임자	모금 책임자
모금_컨설턴트	모금 컨설턴트
모금_코디네이터	모금 코디네이터
모금담당관	모금담당관
모기지_대리인	모기지 대리인
모기지_대출_기관	모기지 대출 기관
모기지_대출_담당자	모기지 대출 담당자
모기지_대출_부사장	모기지 대출 부사장
모기지_대출_코디네이터	모기지 대출 코디네이터
모기지_동료	모기지 동료
모기지_보험사	모기지 보험사
모기지_브로커	모기지 브로커
모기지_은행가	모기지 은행가
모기지_판매_관리자	모기지 판매 관리자
모닝쇼_공동_진행자	모닝쇼 공동 진행자
모닝쇼_진행자	모닝쇼 진행자
모닝쇼_프로듀서	모닝쇼 프로듀서
모델러	모델러
모듈_리드	모듈 리드
모바일_애플리케이션_개발자	모바일 애플리케이션 개발자
모바일_엔지니어	모바일 엔지니어
모집_임원	모집 임원
모집자	모집자
모집팀장	모집팀장
목록_작성자	목록 작성자
무선_기술자	무선 기술자
무선_네트워크_엔지니어	무선 네트워크 엔지니어
무선_엔지니어	무선 엔지니어
무선_전문가	무선 전문가
무선_제품_관리자	무선 제품 관리자
무선_컨설턴트	무선 컨설턴트
무술_강사	무술 강사
무역_동료	무역 동료
무역_마케팅_감독관	무역 마케팅 감독관
무역_마케팅_보조원	무역 마케팅 보조원
무역_마케팅_코디네이터	무역 마케팅 코디네이터
무역_이사	무역 이사
문관	문관
문서_경영진	문서 경영진
문장가	문장가
물류_감독자	물류 감독자
물류_계정_관리자	물류 계정 관리자
물류_관계자	물류 관계자
물류_관리자	물류 관리자
물류_기획자	물류 기획자
물류_대리점	물류 대리점
물류_보조원	물류 보조원
물류_분석가	물류 분석가
물류_센터	물류 센터
물류_엔지니어	물류 엔지니어
물류_이사	물류 이사
물류_임원	물류 임원
물류_전문가	물류 전문가
물류_책임자	물류 책임자
물류_컨설턴트	물류 컨설턴트
물류_컨트롤러	물류 컨트롤러
물류_코디네이터	물류 코디네이터
물류관리자	물류관리자
물류부장	물류부장
물류센터장	물류센터장
물류팀장	물류팀장
물리적_디자이너	물리적 디자이너
물리적_디자인_매니저	물리적 디자인 매니저
물리적_디자인_엔지니어	물리적 디자인 엔지니어
물리치료_원장	물리치료 원장
뮤추얼_펀드_분석가	뮤추얼 펀드 분석가
뮤추얼_펀드_전문가	뮤추얼 펀드 전문가
미디어_감독자	미디어 감독자
미디어_관계_이사	미디어 관계 이사
미디어_관계자	미디어 관계자
미디어_관리자	미디어 관리자
미디어_기술자	미디어 기술자
미디어_기획_감독	미디어 기획 감독
미디어_기획자	미디어 기획자
미디어_디렉터	미디어 디렉터
미디어_및_커뮤니케이션_관리자	미디어 및 커뮤니케이션 관리자
미디어_사서	미디어 사서
미디어_서비스_이사	미디어 서비스 이사
미디어_연구원	미디어 연구원
미디어_임원	미디어 임원
미디어_전략가	미디어 전략가
미디어_제작_전문가	미디어 제작 전문가
미디어그룹_대표	미디어그룹 대표
미술_교수	미술 교수
미술_사진가	미술 사진가
미술_전문가	미술 전문가
미술_컨설턴트	미술 컨설턴트
미술_평론가	미술 평론가
미술가	미술가
미술부_매니저	미술부 매니저
미술부_코디네이터	미술부 코디네이터
미술상	미술상
미술치료사	미술치료사
미용사	미용사
미용실_매니저	미용실 매니저
미용실_주인	미용실 주인
민사_감독관	민사 감독관
바_감독자	바 감독자
바_매니저	바 매니저
바_승무원	바 승무원
바닥_기술자	바닥 기술자
바닥_리드	바닥 리드
바레_강사	바레 강사
바텐더	바텐더
반주자	반주자
발행자	발행자
방문_강사	방문 강사
방문_조교수	방문 조교수
방사선과_감독관	방사선과 감독관
방사선과_관리자	방사선과 관리자
방사선과_기술자	방사선과 기술자
방사선과_이사	방사선과 이사
방송_감독	방송 감독
방송_관계자	방송 관계자
방송_구매자	방송 구매자
방송_기술자	방송 기술자
방송_기자	방송 기자
방송_디자이너	방송 디자이너
방송_매니저	방송 매니저
방송_보조원	방송 보조원
방송_성격	방송 성격
방송_시스템_엔지니어	방송 시스템 엔지니어
방송_엔지니어	방송 엔지니어
방송_운영_이사	방송 운영 이사
방송_코디네이터	방송 코디네이터
방송_협상가	방송 협상가
방송인	방송인
방송제작국장	방송제작국장
방화벽_엔지니어	방화벽 엔지니어
배거	배거
배경_조사관	배경 조사관
배관_디자이너	배관 디자이너
배관공	배관공
배송_관리자	배송 관리자
배송_리드	배송 리드
배송_및_수령_관리자	배송 및 수령 관리자
배송_및_수령_직원	배송 및 수령 직원
배송_및_수령_코디네이터	배송 및 수령 코디네이터
배수_엔지니어	배수 엔지니어
배치_컨설턴트	배치 컨설턴트
배포_기술자	배포 기술자
배포_엔지니어	배포 엔지니어
배포_팀_리더	배포 팀 리더
백엔드_개발자	백엔드 개발자
밴드_디렉터	밴드 디렉터
밴드_매니저	밴드 매니저
밴드_멤버	밴드 멤버
버스_보이	버스 보이
번역_코디네이터	번역 코디네이터
범죄_수사관	범죄 수사관
법률_개인_비서	법률 개인 비서
법률_고문	법률 고문
법률_대리	법률 대리
법률_및_규정_준수_담당자	법률 및 규정 준수 담당자
법률_비서	법률 비서
법률_상담사	법률 상담사
법률_서기	법률 서기
법률_연구원	법률 연구원
법률_임원	법률 임원
법률_전문가	법률 전문가
법률_채용_컨설턴트	법률 채용 컨설턴트
법률_코디네이터	법률 코디네이터
법률_편집자	법률 편집자
법무관	법무관
법무보좌관	법무보좌관
법무비서관	법무비서관
법무이사	법무이사
법무차관	법무차관
법무차관보	법무차관보
법무팀_인턴	법무팀 인턴
법무팀장	법무팀장
법원_변호사	법원 변호사
법의학_심리학자	법의학 심리학자
법인_보좌관	법인 보좌관
법인세_관리자	법인세 관리자
법인세_컨설턴트	법인세 컨설턴트
법적_동료	법적 동료
법정_변호사	법정 변호사
법집행관	법집행관
법학과_조교수	법학과 조교수
베이시스트	베이시스트
벤처_캐피탈_분석가	벤처 캐피탈 분석가
벤치_기술자	벤치 기술자
벽화가	벽화가
변호사	변호사
변호사_관리	변호사 관리
변호사_보조	변호사 보조
변호인을_청구하다	변호인을 청구하다
병원장	병원장
보드_운영자	보드 운영자
보상_및_혜택_코디네이터	보상 및 혜택 코디네이터
보안_관리자	보안 관리자
보안_담당_부국장	보안 담당 부국장
보안_엔지니어	보안 엔지니어
보안_전문가	보안 전문가
보육_보조원	보육 보조원
보육_서비스_제공자	보육 서비스 제공자
보육교사	보육교사
보육사	보육사
보조_가사_관리자	보조 가사 관리자
보조_개인_은행가	보조 개인 은행가
보조_건축가	보조 건축가
보조_게스트_서비스_관리자	보조 게스트 서비스 관리자
보조_관계_관리자	보조 관계 관리자
보조_교육자	보조 교육자
보조_근력_및_컨디셔닝_코치	보조 근력 및 컨디셔닝 코치
보조_기계_엔지니어	보조 기계 엔지니어
보조_기록관	보조 기록관
보조_기술_디자이너	보조 기술 디자이너
보조_기획자	보조 기획자
보조_도시_엔지니어	보조 도시 엔지니어
보조_디자이너	보조 디자이너
보조_디자인_엔지니어	보조 디자인 엔지니어
보조_마케팅_관리자	보조 마케팅 관리자
보조_바_매니저	보조 바 매니저
보조_비디오_편집자	보조 비디오 편집자
보조_사진가	보조 사진가
보조_상주_엔지니어	보조 상주 엔지니어
보조_수익_관리자	보조 수익 관리자
보조_시스템_분석가	보조 시스템 분석가
보조_시장_관리자	보조 시장 관리자
보조_식품_서비스_이사	보조 식품 서비스 이사
보조_애니메이터	보조 애니메이터
보조_예약_관리자	보조 예약 관리자
보조_요리사	보조 요리사
보조_위치_관리자	보조 위치 관리자
보조_유치원_교사	보조 유치원 교사
보조_제과_요리사	보조 제과 요리사
보조_주방_매니저	보조 주방 매니저
보조_지방_검사	보조 지방 검사
보조_축구_코치	보조 축구 코치
보조_카운티_변호사	보조 카운티 변호사
보조_케이터링_매니저	보조 케이터링 매니저
보조_콘텐츠_관리자	보조 콘텐츠 관리자
보조_터미널_관리자	보조 터미널 관리자
보조_투자_관리자	보조 투자 관리자
보조_펀드매니저	보조 펀드매니저
보조_편집자	보조 편집자
보조_포트폴리오_관리자	보조 포트폴리오 관리자
보조_프런트엔드_관리자	보조 프런트엔드 관리자
보조_프로듀서	보조 프로듀서
보조_프로젝트_엔지니어	보조 프로젝트 엔지니어
보조_회계사	보조 회계사
보조금_관리자	보조금 관리자
보컬_코치	보컬 코치
보험_계좌_담당자	보험 계좌 담당자
보험_대리인	보험 대리인
보험_생산자	보험 생산자
보험_인수자	보험 인수자
보험_임원	보험 임원
보험_전문가	보험 전문가
보험_책임자	보험 책임자
보험_컨설턴트	보험 컨설턴트
보험영업사원	보험영업사원
복사_감독자	복사 감독자
복사_관리자	복사 관리자
복사_책임자	복사 책임자
봉사_상담사	봉사 상담사
부_건설_관리자	부 건설 관리자
부_주방장	부 주방장
부_크리에이티브_디렉터	부 크리에이티브 디렉터
부교사	부교사
부교장_선생님	부교장 선생님
부국선_변호인	부국선 변호인
부기_계원	부기 계원
부기장	부기장
부동산_감정사	부동산 감정사
부동산_대출_담당자	부동산 대출 담당자
부동산_동료	부동산 동료
부동산_변호사	부동산 변호사
부동산_분석가	부동산 분석가
부동산_전문가	부동산 전문가
부동산_중개업자	부동산 중개업자
부동산_중개인	부동산 중개인
부동산_책임자	부동산 책임자
부동산_컨설턴트	부동산 컨설턴트
부동산_팀장	부동산 팀장
부동산_판매_대리인	부동산 판매 대리인
부동산_판매_직원	부동산 판매 직원
부동산_포트폴리오_매니저	부동산 포트폴리오 매니저
부보안관	부보안관
부사관	부사관
부사장	부사장
부사장_사업_개발	부사장 사업 개발
부사장_전략	부사장 전략
부조종사	부조종사
부총장	부총장
부총지배인	부총지배인
부트캠프_강사	부트캠프 강사
부편집장	부편집장
부회장_이사회	부회장 이사회
분류_광고_관리자	분류 광고 관리자
불꽃_예술가	불꽃 예술가
뷰티_어드바이저	뷰티 어드바이저
브랜드_기획자	브랜드 기획자
브랜드_디자이너	브랜드 디자이너
브랜드_디자인_매니저	브랜드 디자인 매니저
브랜드_분석가	브랜드 분석가
브랜드_어시스턴트_매니저	브랜드 어시스턴트 매니저
브로커	브로커
브로커_보조원	브로커 보조원
블로거	블로거
비디오_엔지니어	비디오 엔지니어
비디오_저널리스트	비디오 저널리스트
비디오_프로듀서	비디오 프로듀서
비디오그래퍼	비디오그래퍼
비상_관리_코디네이터	비상 관리 코디네이터
비용_관리자	비용 관리자
비주얼_개발_아티스트	비주얼 개발 아티스트
비주얼_머천다이징_인턴	비주얼 머천다이징 인턴
비주얼_아티스트	비주얼 아티스트
비즈니스_개발자	비즈니스 개발자
비즈니스_교육_교사	비즈니스 교육 교사
비즈니스_뱅킹_전문가	비즈니스 뱅킹 전문가
비즈니스_분석가	비즈니스 분석가
비즈니스_센터_매니저	비즈니스 센터 매니저
비즈니스_작가	비즈니스 작가
비즈니스_전문가	비즈니스 전문가
비즈니스_지원_시스템_엔지니어	비즈니스 지원 시스템 엔지니어
비즈니스_컨설턴트	비즈니스 컨설턴트
비행_강사	비행 강사
비행_운영_관리자	비행 운영 관리자
비행_운영_이사	비행 운영 이사
비행_테스트_엔지니어	비행 테스트 엔지니어
비행사	비행사
빌딩_서비스_엔지니어	빌딩 서비스 엔지니어
빵_굽는_사람	빵 굽는 사람
빵집_관리자	빵집 관리자
빵집_점원	빵집 점원
사건_사무원	사건 사무원
사기_조사관	사기 조사관
사내_번역가	사내 번역가
사립_탐정	사립 탐정
사모펀드_관계자	사모펀드 관계자
사모펀드_분석가	사모펀드 분석가
사모펀드_인턴	사모펀드 인턴
사무_생산_보조	사무 생산 보조
사무실_관리_파트너	사무실 관리 파트너
사법_서기	사법 서기
사법보좌관	사법보좌관
사상자_청구_조정인	사상자 청구 조정인
사서	사서
사업_개발_담당_부국장	사업 개발 담당 부국장
사업_개발_담당_부사장	사업 개발 담당 부사장
사업_개발_동료	사업 개발 동료
사업_개발_리드	사업 개발 리드
사업_개발_매니저	사업 개발 매니저
사업_개발_이사	사업 개발 이사
사업_개발_전문가	사업 개발 전문가
사업_개발_책임자	사업 개발 책임자
사업_개발_컨설턴트	사업 개발 컨설턴트
사업_운영_부사장	사업 운영 부사장
사업_운영_이사	사업 운영 이사
사용자_지원_기술자	사용자 지원 기술자
사용자_지원_전문가	사용자 지원 전문가
사운드_믹서	사운드 믹서
사운드_엔지니어	사운드 엔지니어
사육자	사육자
사이트_엔지니어	사이트 엔지니어
사이트_확보_관리자	사이트 확보 관리자
사진_관리자	사진 관리자
사진_기술자	사진 기술자
사진_스타일리스트	사진 스타일리스트
사진_실험실_기술자	사진 실험실 기술자
사진_전문가	사진 전문가
사진_편집기	사진 편집기
사진가_보조	사진가 보조
사회_사업가	사회 사업가
사회학_강사	사회학 강사
사회학_교수	사회학 교수
살롱_코디네이터	살롱 코디네이터
상등병	상등병
상업_감독관	상업 감독관
상업_대출_보조원	상업 대출 보조원
상업_라인_생산자	상업 라인 생산자
상업_변호사	상업 변호사
상업_보험_대리인	상업 보험 대리인
상업_보험_중개인	상업 보험 중개인
상업_분석가	상업 분석가
상업_생산자	상업 생산자
상업_은행_관계_관리자	상업 은행 관계 관리자
상업_은행가	상업 은행가
상업_조종사	상업 조종사
상업_코디네이터	상업 코디네이터
상업용_부동산_전문가	상업용 부동산 전문가
상업용_부동산_중개인	상업용 부동산 중개인
상업용_부동산_컨설턴트	상업용 부동산 컨설턴트
상인	상인
상주_엔지니어	상주 엔지니어
상주_예술가	상주 예술가
상주_의료_책임자	상주 의료 책임자
상주_임원	상주 임원
상품_분석가	상품 분석가
새_집_컨설턴트	새 집 컨설턴트
새로운_주택_판매_상담사	새로운 주택 판매 상담사
새로운_주택_판매_컨설턴트	새로운 주택 판매 컨설턴트
생과자_요리사	생과자 요리사
생명보험사	생명보험사
생물학_교사	생물학 교사
생산_관리자	생산 관리자
생산_기술자	생산 기술자
생산_비서	생산 비서
생산_약사	생산 약사
생산_운영_이사	생산 운영 이사
생산_인수자	생산 인수자
생산_코디네이터	생산 코디네이터
생산단위_매니저	생산단위 매니저
생산자	생산자
생체의학_장비_기술자	생체의학 장비 기술자
서버_관리자	서버 관리자
서비스_데스크_관리자	서비스 데스크 관리자
서비스_데스크_기술자	서비스 데스크 기술자
서비스_데스크_에이전트	서비스 데스크 에이전트
서비스_데스크_팀_리더	서비스 데스크 팀 리더
서비스_디자이너	서비스 디자이너
서비스_센터_관리자	서비스 센터 관리자
서비스_센터_분석가	서비스 센터 분석가
서비스_지원_전문가	서비스 지원 전문가
서포터	서포터
석유_엔지니어	석유 엔지니어
선물_거래자	선물 거래자
선물_중개인	선물 중개인
선물가게_동료	선물가게 동료
선박_중개인	선박 중개인
선생님	선생님
선생님_영어_외국어	선생님 영어 외국어
선장	선장
선호하는_은행원	선호하는 은행원
설계_및_개발_엔지니어	설계 및 개발 엔지니어
설계_엔지니어	설계 엔지니어
설계_자동화_엔지니어	설계 자동화 엔지니어
섬기는_사람	섬기는 사람
섬유_디자이너	섬유 디자이너
섭외	섭외
성능_개선_코디네이터	성능 개선 코디네이터
성인_전문_간호사	성인 전문 간호사
세금_관리인	세금 관리인
세금_관리자	세금 관리자
세금_기술자	세금 기술자
세금_동료	세금 동료
세금_원금	세금 원금
세금_준수_관리자	세금 준수 관리자
세무_감독관	세무 감독관
세무_대리인	세무 대리인
세무_변호사	세무 변호사
세무_분석가	세무 분석가
세무_전문가	세무 전문가
세무감사관	세무감사관
세무사	세무사
세트_옷장	세트 옷장
세트_제작_보조	세트 제작 보조
섹션_엔지니어	섹션 엔지니어
셰프_드_파티	셰프 드 파티
소매_상인	소매 상인
소매_직원	소매 직원
소매_판매_보조원	소매 판매 보조원
소매_판매원	소매 판매원
소매시장_관리자	소매시장 관리자
소매치기	소매치기
소방관	소방관
소방대위	소방대위
소방대장	소방대장
소방서_부국장	소방서 부국장
소방서장	소방서장
소방수	소방수
소비자_대출_인수자	소비자 대출 인수자
소셜_미디어_관리자	소셜 미디어 관리자
소셜_미디어_디렉터	소셜 미디어 디렉터
소셜_미디어_마케팅_매니저	소셜 미디어 마케팅 매니저
소셜_미디어_마케팅_컨설턴트	소셜 미디어 마케팅 컨설턴트
소셜_미디어_전략가	소셜 미디어 전략가
소셜_미디어_전문가	소셜 미디어 전문가
소송_관계자	소송 관계자
소송_관리자	소송 관리자
소송_변호사	소송 변호사
소송_보조원	소송 보조원
소송_이사	소송 이사
소송_전문가	소송 전문가
소송_지원_분석가	소송 지원 분석가
소송_컨설턴트	소송 컨설턴트
소송_파트너	소송 파트너
소아과_의사	소아과 의사
소아과_전문의	소아과 전문의
소유권_대리인	소유권 대리인
소프트웨어_개발_분석가	소프트웨어 개발 분석가
소프트웨어_개발_엔지니어	소프트웨어 개발 엔지니어
소프트웨어_개발자_인턴	소프트웨어 개발자 인턴
소프트웨어_공학_연수생	소프트웨어 공학 연수생
소프트웨어_분석가	소프트웨어 분석가
소프트웨어_애플리케이션_개발자	소프트웨어 애플리케이션 개발자
소프트웨어_엔지니어	소프트웨어 엔지니어
소프트웨어_엔지니어_팀장	소프트웨어 엔지니어 팀장
소프트웨어_엔지니어링_인턴	소프트웨어 엔지니어링 인턴
소프트웨어_연수생	소프트웨어 연수생
소프트웨어_전문가	소프트웨어 전문가
소프트웨어_지원_기술자	소프트웨어 지원 기술자
소프트웨어_지원_분석가	소프트웨어 지원 분석가
소프트웨어_컨설턴트	소프트웨어 컨설턴트
소프트웨어_품질_보증_엔지니어	소프트웨어 품질 보증 엔지니어
소프트웨어_프로젝트_리드	소프트웨어 프로젝트 리드
소프트웨어_회사	소프트웨어 회사
손님_관계_감독관	손님 관계 감독관
손님_관계_임원	손님 관계 임원
손님_서비스_감독자	손님 서비스 감독자
손님_서비스_담당자	손님 서비스 담당자
손님관계담당관	손님관계담당관
솔루션_개발자	솔루션 개발자
쇼_매니저	쇼 매니저
수령_감독자	수령 감독자
수리_기술자	수리 기술자
수리_엔지니어	수리 엔지니어
수문학자	수문학자
수석_강사	수석 강사
수석_계산원	수석 계산원
수석_고문	수석 고문
수석_관리인	수석 관리인
수석_그래픽_디자이너	수석 그래픽 디자이너
수석_기계_엔지니어	수석 기계 엔지니어
수석_기자	수석 기자
수석_디자이너	수석 디자이너
수석_법률_고문	수석 법률 고문
수석_법률_및_회사_비서	수석 법률 및 회사 비서
수석_변호사	수석 변호사
수석_보안_엔지니어	수석 보안 엔지니어
수석_부주방장	수석 부주방장
수석_비행_교관	수석 비행 교관
수석_사서	수석 사서
수석_상인	수석 상인
수석_설계_엔지니어	수석 설계 엔지니어
수석_셰프	수석 셰프
수석_소프트웨어_엔지니어	수석 소프트웨어 엔지니어
수석_심리학자	수석 심리학자
수석_아트디렉터	수석 아트디렉터
수석_연구원	수석 연구원
수석_웨이터	수석 웨이터
수석_전기_엔지니어	수석 전기 엔지니어
수석_조경사	수석 조경사
수석_조사관	수석 조사관
수석_조종사	수석 조종사
수석_지질학자	수석 지질학자
수석_청지기	수석 청지기
수석_축구_코치	수석 축구 코치
수석_치과_책임자	수석 치과 책임자
수석_코치	수석 코치
수석_큐레이터	수석 큐레이터
수석_크리에이티브_디렉터	수석 크리에이티브 디렉터
수석_토목_기술자	수석 토목 기술자
수석_페이스트리_셰프	수석 페이스트리 셰프
수석_포트폴리오_매니저	수석 포트폴리오 매니저
수석_하드웨어_엔지니어	수석 하드웨어 엔지니어
수석무용수	수석무용수
수영_코치	수영 코치
수영장_관리자	수영장 관리자
수율_관리자	수율 관리자
수의사	수의사
수의사_보조	수의사 보조
수익_대리인	수익 대리인
수입_관리자	수입 관리자
수입_부서	수입 부서
수입_분석가	수입 분석가
수입_사무원	수입 사무원
수입_수출_관리자	수입 수출 관리자
수입_수출_도우미	수입 수출 도우미
수입_수출_코디네이터	수입 수출 코디네이터
수입_임원	수입 임원
수입_전문가	수입 전문가
수입_코디네이터	수입 코디네이터
수중_에어로빅_강사	수중 에어로빅 강사
수출_관리자	수출 관리자
수출_전문가	수출 전문가
수출_지역_관리자	수출 지역 관리자
수출담당관	수출담당관
수출영업대표	수출영업대표
수출입_분석가	수출입 분석가
수출입담당	수출입담당
수출판매담당	수출판매담당
수학_교수	수학 교수
순경	순경
순서_정하기	순서 정하기
순찰_상사	순찰 상사
스위치_엔지니어	스위치 엔지니어
스카다_엔지니어	스카다 엔지니어
스크립트_감독자	스크립트 감독자
스크립트_작가	스크립트 작가
스타일_컨설턴트	스타일 컨설턴트
스튜디오_아티스트	스튜디오 아티스트
스트레스_분석가	스트레스 분석가
스트레스_엔지니어	스트레스 엔지니어
스파_감독자	스파 감독자
스페인어_교사	스페인어 교사
스페인어_번역가	스페인어 번역가
스포츠_강사	스포츠 강사
스포츠_교사	스포츠 교사
스포츠_기자	스포츠 기자
스포츠_디렉터	스포츠 디렉터
스포츠_매니저	스포츠 매니저
스포츠_사진작가	스포츠 사진작가
스포츠_앵커	스포츠 앵커
스포츠_인턴	스포츠 인턴
스포츠_코디네이터	스포츠 코디네이터
스포츠_편집자	스포츠 편집자
스포츠_프로듀서	스포츠 프로듀서
시_부검사	시 부검사
시각_디자이너	시각 디자이너
시각_전문가	시각 전문가
시각_효과_아티스트	시각 효과 아티스트
시각화_장치	시각화 장치
시골뜨기	시골뜨기
시뮬레이션_엔지니어	시뮬레이션 엔지니어
시스코_네트워크_엔지니어	시스코 네트워크 엔지니어
시스템_관리자	시스템 관리자
시스템_네트워크_관리자	시스템 네트워크 관리자
시스템_분석가	시스템 분석가
시스템_설계_엔지니어	시스템 설계 엔지니어
시스템_성능_엔지니어	시스템 성능 엔지니어
시스템_엔지니어	시스템 엔지니어
시스템_엔지니어링_인턴	시스템 엔지니어링 인턴
시스템_지원_감독자	시스템 지원 감독자
시스템_지원_기술자	시스템 지원 기술자
시스템_지원_엔지니어	시스템 지원 엔지니어
시운전_관리자	시운전 관리자
시장_기자	시장 기자
시장_데이터_분석가	시장 데이터 분석가
시장_위험_관리자	시장 위험 관리자
시장_정보_분석가	시장 정보 분석가
시장_정보_이사	시장 정보 이사
시장_조사_분석가	시장 조사 분석가
시추_감독관	시추 감독관
시추_감독자	시추 감독자
시험_인쇄_코디네이터	시험 인쇄 코디네이터
식당_주인	식당 주인
식료품_점원	식료품 점원
식물_야금학자	식물 야금학자
식사_서비스_이사	식사 서비스 이사
식음료_담당_부사장	식음료 담당 부사장
식음료_인턴	식음료 인턴
식이관리사	식이관리사
식자공	식자공
식품_과학자	식품 과학자
식품_및_음료_보조_관리자	식품 및 음료 보조 관리자
식품_및_음료_부문_이사	식품 및 음료 부문 이사
식품_안전_관리자	식품 안전 관리자
식품_엔지니어	식품 엔지니어
신발_디자이너	신발 디자이너
신사업_전문가	신사업 전문가
신생아_전문의	신생아 전문의
신용_감독관	신용 감독관
신용_관리_담당자	신용 관리 담당자
신용_담당자	신용 담당자
신용_대리인	신용 대리인
신용_분석가	신용 분석가
신용_전문가	신용 전문가
신용_조사_분석가	신용 조사 분석가
신호_무결성_엔지니어	신호 무결성 엔지니어
실내_사이클링_강사	실내 사이클링 강사
심리_조수	심리 조수
심리학자	심리학자
심장_전문의	심장 전문의
심장학_펠로우	심장학 펠로우
십장	십장
아날로그_디자이너	아날로그 디자이너
아날로그_디자인_엔지니어	아날로그 디자인 엔지니어
아울렛_매니저	아울렛 매니저
아웃소싱_관리자	아웃소싱 관리자
아침_뉴스_앵커	아침 뉴스 앵커
아카이브_어시스턴트	아카이브 어시스턴트
아카이브_인턴	아카이브 인턴
아쿠아에어로빅_강사	아쿠아에어로빅 강사
아트_디렉터	아트 디렉터
아트_핸들러	아트 핸들러
아트디렉션_인턴	아트디렉션 인턴
아티스트	아티스트
안드로이드_개발자	안드로이드 개발자
안무가	안무가
압류_전문가	압류 전문가
애니메이션_감독	애니메이션 감독
애니메이션_강사	애니메이션 강사
애니메이션_리드	애니메이션 리드
애니메이션_아티스트	애니메이션 아티스트
애니메이션_인턴	애니메이션 인턴
애니메이터	애니메이터
애완견_관리사	애완견 관리사
애플리케이션_개발_팀장	애플리케이션 개발 팀장
애플리케이션_개발자	애플리케이션 개발자
애플리케이션_지원_기술자	애플리케이션 지원 기술자
애플리케이션_테스터	애플리케이션 테스터
액세서리_디자이너	액세서리 디자이너
야간_감사관	야간 감사관
야간_관리자	야간 관리자
야간_보조_매니저	야간 보조 매니저
야금_기술자	야금 기술자
약국_감독자	약국 감독자
약국_거주자	약국 거주자
약국_부국장	약국 부국장
약국_실무_레지던트	약국 실무 레지던트
약국_운영_관리자	약국 운영 관리자
어플리케이션_엔지니어	어플리케이션 엔지니어
언론_관계_직원	언론 관계 직원
언론_및_홍보_관리자	언론 및 홍보 관리자
언론관계담당관	언론관계담당관
언론담당관	언론담당관
언어_교사	언어 교사
언어_컨설턴트	언어 컨설턴트
언어학자	언어학자
에디슨_엔지니어	에디슨 엔지니어
에디슨_엔지니어링_개발_프로그램	에디슨 엔지니어링 개발 프로그램
에스크로_보조원	에스크로 보조원
에이전트_상업	에이전트 상업
엔지니어링_디자이너	엔지니어링 디자이너
엔지니어링_채용_담당자	엔지니어링 채용 담당자
엔터프라이즈_네트워크_엔지니어	엔터프라이즈 네트워크 엔지니어
엔터프라이즈_엔지니어	엔터프라이즈 엔지니어
여관주인	여관주인
여름_법률_서기	여름 법률 서기
여름_캠프_상담사	여름 캠프 상담사
여름학교_선생님	여름학교 선생님
여성복_디자이너	여성복 디자이너
여행_간부	여행 간부
여행_간호사	여행 간호사
여행_매니저	여행 매니저
여행_상담사	여행 상담사
여행_작가	여행 작가
여행_전문가	여행 전문가
여행_편집자	여행 편집자
여행사_매니저	여행사 매니저
역_엔지니어	역 엔지니어
역사_선생님	역사 선생님
역사학과_겸임교수	역사학과 겸임교수
역사학과_조교수	역사학과 조교수
연간_기금_부국장	연간 기금 부국장
연간_기부_관리자	연간 기부 관리자
연간_펀드매니저	연간 펀드매니저
연관짓다	연관짓다
연구_개발_기술자	연구 개발 기술자
연구_개발_엔지니어	연구 개발 엔지니어
연구_변호사	연구 변호사
연구_사서	연구 사서
연구_이사	연구 이사
연구_조교	연구 조교
연구_지질학자	연구 지질학자
연구_코디네이터	연구 코디네이터
연구개발_과학자	연구개발 과학자
연극_감독	연극 감독
연방_세금_관리자	연방 세금 관리자
연방_요원	연방 요원
연예인	연예인
연회_감독	연회 감독
연회_서버	연회 서버
연회_요리사	연회 요리사
연회_코디네이터	연회 코디네이터
연회장	연회장
열렬한_편집자	열렬한 편집자
영상_제작_매니저	영상 제작 매니저
영상제작_디렉터	영상제작 디렉터
영상제작_전문가	영상제작 전문가
영어_미술_선생님	영어 미술 선생님
영어_번역기	영어 번역기
영어_선생님	영어 선생님
영어_조교수	영어 조교수
영어교수	영어교수
영업_관리자	영업 관리자
영업_기획자	영업 기획자
영업_담당자	영업 담당자
영업_및_마케팅_이사	영업 및 마케팅 이사
영업팀원	영업팀원
영화_감독	영화 감독
영화_및_비디오_편집자	영화 및 비디오 편집자
영화_작곡가	영화 작곡가
영화_제작자	영화 제작자
영화_편집자	영화 편집자
영화제작자	영화제작자
예배_감독	예배 감독
예비_경찰관	예비 경찰관
예술감독	예술감독
예약_대행사	예약 대행사
예약_코디네이터	예약 코디네이터
예약_판매_대행	예약 판매 대행
예의_사무원	예의 사무원
오디오_믹서	오디오 믹서
오디오_엔지니어	오디오 엔지니어
오디오_프로듀서	오디오 프로듀서
오르간_연주자	오르간 연주자
오페라_가수	오페라 가수
오픈소스_개발자	오픈소스 개발자
온라인_광고_관리자	온라인 광고 관리자
온라인_마케팅_담당자	온라인 마케팅 담당자
온에어_아나운서	온에어 아나운서
옵션_거래자	옵션 거래자
옷장_스타일리스트	옷장 스타일리스트
옹호_담당관	옹호 담당관
완성_엔지니어	완성 엔지니어
외과_간호사	외과 간호사
외과_교수	외과 교수
외과_의사	외과 의사
외국_동료	외국 동료
외국법_컨설턴트	외국법 컨설턴트
외부_변호사	외부 변호사
외부_심사관	외부 심사관
외부_커뮤니케이션_관리자	외부 커뮤니케이션 관리자
외환_관리자	외환 관리자
요리_강사	요리 강사
요리_매니저	요리 매니저
요리사	요리사
요리하다	요리하다
요식업_종사자	요식업 종사자
우주선_엔지니어	우주선 엔지니어
우체국장	우체국장
우편_조사관	우편 조사관
우편실_사무원	우편실 사무원
운동_코디네이터	운동 코디네이터
운동요법_강사	운동요법 강사
운영_및_물류_관리자	운영 및 물류 관리자
운영_전문가	운영 전문가
운영_주체	운영 주체
운영_책임자	운영 책임자
운영_체제_분석가	운영 체제 분석가
운전사	운전사
원격_지원_엔지니어	원격 지원 엔지니어
월마트_직원	월마트 직원
웨딩_컨설턴트	웨딩 컨설턴트
웨딩_코디네이터	웨딩 코디네이터
웨이터	웨이터
웹_UI_개발자	웹 UI 개발자
웹_개발_관리자	웹 개발 관리자
웹_개발_엔지니어	웹 개발 엔지니어
웹_개발_인턴	웹 개발 인턴
웹_개발_책임자	웹 개발 책임자
웹_개발_팀장	웹 개발 팀장
웹_게시자	웹 게시자
웹_디자이너	웹 디자이너
웹_및_그래픽_디자이너	웹 및 그래픽 디자이너
웹_사이트_디자이너	웹 사이트 디자이너
웹_애플리케이션_개발자	웹 애플리케이션 개발자
웹_애플리케이션_전문가	웹 애플리케이션 전문가
웹_애플리케이션_프로그래머	웹 애플리케이션 프로그래머
웹_엔지니어	웹 엔지니어
웹_저널리스트	웹 저널리스트
웹_커뮤니케이션_전문가	웹 커뮤니케이션 전문가
웹_콘텐츠_작가	웹 콘텐츠 작가
웹_편집기	웹 편집기
웹_프로그래머	웹 프로그래머
웹_프로듀서	웹 프로듀서
웹사이트_관리자	웹사이트 관리자
웹사이트_콘텐츠_관리자	웹사이트 콘텐츠 관리자
위치_관리자	위치 관리자
위치_정찰병	위치 정찰병
위험_관리_인턴	위험 관리 인턴
위험_관리_직원	위험 관리 직원
위험_관리자	위험 관리자
유니버설_뱅커	유니버설 뱅커
유선_현장_엔지니어	유선 현장 엔지니어
유아_교육자	유아 교육자
유아교사	유아교사
유치원_교사	유치원 교사
유치원_원장	유치원 원장
유통_책임자	유통 책임자
유통센터_감독관	유통센터 감독관
유학_고문	유학 고문
유한_파트너	유한 파트너
은행_부장	은행 부장
은행_조사관	은행 조사관
은행_지점장	은행 지점장
은행원	은행원
음반_가수	음반 가수
음성_엔지니어	음성 엔지니어
음식_및_음료_감독자	음식 및 음료 감독자
음식_서비스_디렉터	음식 서비스 디렉터
음식_서비스_매니저	음식 서비스 매니저
음식_점원	음식 점원
음악_강사	음악 강사
음악_인턴	음악 인턴
음악_작곡가	음악 작곡가
음악_전문가	음악 전문가
음악_컨설턴트	음악 컨설턴트
음악_프로듀서	음악 프로듀서
음악가	음악가
음악감독	음악감독
응급_의료_기술자	응급 의료 기술자
응급_의사	응급 의사
응급실_기술자	응급실 기술자
응급의학_의사	응급의학 의사
응용_기술자	응용 기술자
의료_담당_이사	의료 담당 이사
의료_모집자	의료 모집자
의료_보조원	의료 보조원
의료_엔지니어	의료 엔지니어
의료_인턴	의료 인턴
의료정보관리자	의료정보관리자
의류_디자이너	의류 디자이너
의사	의사
의사_보조	의사 보조
의학_교육_이사	의학 교육 이사
의학_연락관	의학 연락관
의학_조교수	의학 조교수
이미징_감독자	이미징 감독자
이미징_서비스_이사	이미징 서비스 이사
이발사	이발사
이벤트_관리_이사	이벤트 관리 이사
이벤트_관리자	이벤트 관리자
이벤트_디자이너	이벤트 디자이너
이벤트_사진작가	이벤트 사진작가
이벤트_임원	이벤트 임원
이벤트_전문가	이벤트 전문가
이벤트_컨설턴트	이벤트 컨설턴트
이벤트_코디네이터	이벤트 코디네이터
이벤트_플래너	이벤트 플래너
이사_조직_효율성	이사 조직 효율성
이전_이사	이전 이사
이주_전문가	이주 전문가
이중_언어_교사	이중 언어 교사
이중_언어를_구사하는_사무총장	이중 언어를 구사하는 사무총장
이탈리아어_선생님	이탈리아어 선생님
인력_관리자	인력 관리자
인력_배치	인력 배치
인력_이사	인력 이사
인력_전문가	인력 전문가
인력_컨설턴트	인력 컨설턴트
인류학_교수	인류학 교수
인사담당자	인사담당자
인사하는_사람	인사하는 사람
인쇄_디자이너	인쇄 디자이너
인쇄_제작_관리자	인쇄 제작 관리자
인쇄_제작_코디네이터	인쇄 제작 코디네이터
인쇄_제작자	인쇄 제작자
인쇄_회로_기판_디자이너	인쇄 회로 기판 디자이너
인수_마케팅_관리자	인수 마케팅 관리자
인수_보조원	인수 보조원
인수_부문_부사장	인수 부문 부사장
인수_이사	인수 이사
인수_컨설턴트	인수 컨설턴트
인재_관리_부사장	인재 관리 부사장
인재_관리자	인재 관리자
인재_이사	인재 이사
인재_확보_관리자	인재 확보 관리자
인재_확보_리드	인재 확보 리드
인재_확보_부문_부사장	인재 확보 부문 부사장
인재_확보_이사	인재 확보 이사
인재_확보_임원	인재 확보 임원
인재_확보_전문가	인재 확보 전문가
인재_확보_채용_담당자	인재 확보 채용 담당자
인재_확보_컨설턴트	인재 확보 컨설턴트
인재개발국장	인재개발국장
인재경영_전문가	인재경영 전문가
인재경영_컨설턴트	인재경영 컨설턴트
인재경영실장	인재경영실장
인재획득_인턴	인재획득 인턴
인적_자본_이사	인적 자본 이사
인증_엔지니어	인증 엔지니어
인터넷_관리자	인터넷 관리자
인터넷_마케팅_코디네이터	인터넷 마케팅 코디네이터
인터랙티브_아트_디렉터	인터랙티브 아트 디렉터
인터랙티브_프로듀서	인터랙티브 프로듀서
인턴	인턴
인테리어_디자이너	인테리어 디자이너
인프라_감독자	인프라 감독자
일러스트레이터	일러스트레이터
일반_계약자	일반 계약자
일반_의사	일반 의사
일반_치과의사	일반 치과의사
일반_현장_엔지니어	일반 현장 엔지니어
일반의	일반의
일본어_번역기	일본어 번역기
읽고_쓰는_능력_전문가	읽고 쓰는 능력 전문가
읽고_쓰는_능력을_가르치는_교사	읽고 쓰는 능력을 가르치는 교사
읽기_쓰기_코치	읽기 쓰기 코치
임대_대리점	임대 대리점
임베디드_소프트웨어_팀장	임베디드 소프트웨어 팀장
임베디드_시스템_엔지니어	임베디드 시스템 엔지니어
임상_감독자	임상 감독자
임상_강사	임상 강사
임상_부교수	임상 부교수
임상_상담사	임상 상담사
임상_심리학자	임상 심리학자
임상_엔지니어	임상 엔지니어
임상_연구_코디네이터	임상 연구 코디네이터
임상_연락	임상 연락
임상_치료사	임상 치료사
임상사회복지사	임상사회복지사
임상약국_매니저	임상약국 매니저
임상약사	임상약사
임상약학_전문가	임상약학 전문가
임상응용_전문가	임상응용 전문가
임상직원_약사	임상직원 약사
임시_직원	임시 직원
임시_회계사	임시 회계사
임원_검색_컨설턴트	임원 검색 컨설턴트
임원_자원	임원 자원
임원_채용_담당자	임원 채용 담당자
입안자	입안자
입학_인턴	입학 인턴
입학_홍보대사	입학 홍보대사
입학처_부학장	입학처 부학장
입학처장	입학처장
자격증을_갖춘_보험_대리인	자격증을 갖춘 보험 대리인
자격증을_갖춘_실무_간호사	자격증을 갖춘 실무 간호사
자격증을_갖춘_임상_사회복지사	자격증을 갖춘 임상 사회복지사
자격증을_갖춘_임상_전문_상담사	자격증을 갖춘 임상 전문 상담사
자격증을_갖춘_전문_상담사	자격증을 갖춘 전문 상담사
자격증을_갖춘_정신_건강_상담사	자격증을 갖춘 정신 건강 상담사
자격증을_갖춘_준_부동산_중개인	자격증을 갖춘 준 부동산 중개인
자격증을_갖춘_침술사	자격증을 갖춘 침술사
자격증을_취득한_부동산_전문가	자격증을 취득한 부동산 전문가
자금_분석가	자금 분석가
자금_제공자	자금 제공자
자기주식_거래자	자기주식 거래자
자동화_개발자	자동화 개발자
자동화_기술자	자동화 기술자
자동화_시스템_엔지니어	자동화 시스템 엔지니어
자동화_전문가	자동화 전문가
자동화_컨설턴트	자동화 컨설턴트
자동화_코디네이터	자동화 코디네이터
자동화_테스트_분석가	자동화 테스트 분석가
자동화팀장	자동화팀장
자문_시스템_분석가	자문 시스템 분석가
자문_판매_전문가	자문 판매 전문가
자문위원	자문위원
자바_개발자	자바 개발자
자바_개발자_계약	자바 개발자 계약
자바_건축가	자바 건축가
자바_기술_리드	자바 기술 리드
자바_소프트웨어_엔지니어	자바 소프트웨어 엔지니어
자바_애플리케이션_개발자	자바 애플리케이션 개발자
자바_웹_개발자	자바 웹 개발자
자바_컨설턴트	자바 컨설턴트
자바_팀_리드	자바 팀 리드
자바/j2ee_개발자	자바/j2ee 개발자
자본시장_분석가	자본시장 분석가
자산_관리_책임자	자산 관리 책임자
자산_관리자	자산 관리자
자산관리_부사장	자산관리 부사장
자산운용실장	자산운용실장
자산책임관리자	자산책임관리자
자원_전문가	자원 전문가
자원_조달_책임자	자원 조달 책임자
자원관리_관리자	자원관리 관리자
자재_취급자	자재 취급자
작가	작가
작곡가	작곡가
작업_감독	작업 감독
장비_유지_보수_기술자	장비 유지 보수 기술자
장소_관리자	장소 관리자
장식_컨설턴트	장식 컨설턴트
장식하다	장식하다
재고_관리_감독자	재고 관리 감독자
재고_관리자	재고 관리자
재녹음_믹서	재녹음 믹서
재단_관리자	재단 관리자
재무_관리_프로그램_인턴	재무 관리 프로그램 인턴
재무_대리인	재무 대리인
재무_분석가	재무 분석가
재무부_직원	재무부 직원
재보험_중개인	재보험 중개인
재봉_강사	재봉 강사
재산_청구_조정인	재산 청구 조정인
재산세_관리자	재산세 관리자
재산회계사	재산회계사
재판_변호사	재판 변호사
저명한_기술_직원	저명한 기술 직원
저명한_소프트웨어_엔지니어	저명한 소프트웨어 엔지니어
저수지_지질학자	저수지 지질학자
전국_물류_관리자	전국 물류 관리자
전국_인사담당자	전국 인사담당자
전국_채용_담당자	전국 채용 담당자
전기_공학	전기 공학
전기_공학_관리자	전기 공학 관리자
전기_공학_이사	전기 공학 이사
전기_기계_엔지니어	전기 기계 엔지니어
전기_및_계측_엔지니어	전기 및 계측 엔지니어
전기_및_전자_엔지니어	전기 및 전자 엔지니어
전기_엔지니어	전기 엔지니어
전기_테스트_엔지니어	전기 테스트 엔지니어
전기_프로젝트_엔지니어	전기 프로젝트 엔지니어
전기부장	전기부장
전략_감독자	전략 감독자
전략_개발_이사	전략 개발 이사
전략_개발_책임자	전략 개발 책임자
전략_기획_관리자	전략 기획 관리자
전략_기획_분석가	전략 기획 분석가
전략_및_운영_관리자	전략 및 운영 관리자
전략_및_운영_이사	전략 및 운영 이사
전략_비즈니스_컨설턴트	전략 비즈니스 컨설턴트
전략_컨설턴트	전략 컨설턴트
전략적_커뮤니케이션	전략적 커뮤니케이션
전문_가수	전문 가수
전문_댄서	전문 댄서
전문_드라이버	전문 드라이버
전문_메이크업_아티스트	전문 메이크업 아티스트
전문_배우	전문 배우
전문_부동산_중개인	전문 부동산 중개인
전문_사진가	전문 사진가
전문_엔지니어	전문 엔지니어
전문_예술가	전문 예술가
전문_음악가	전문 음악가
전문_직원	전문 직원
전문_회계사	전문 회계사
전송_엔지니어	전송 엔지니어
전송_컨트롤러	전송 컨트롤러
전시_큐레이터	전시 큐레이터
전임_교수진	전임 교수진
전자_개발_엔지니어	전자 개발 엔지니어
전자_디자이너	전자 디자이너
전자_설계_엔지니어	전자 설계 엔지니어
전자_시스템_엔지니어	전자 시스템 엔지니어
전자_전문가	전자 전문가
전자_판매_직원	전자 판매 직원
전화_교환원	전화 교환원
전화_통신_엔지니어	전화 통신 엔지니어
전환_코디네이터	전환 코디네이터
점원	점원
점원을_생산하다	점원을 생산하다
접수_감독자	접수 감독자
정규_채용_컨설턴트	정규 채용 컨설턴트
정보_보안_관리자	정보 보안 관리자
정보_보안_분석가	정보 보안 분석가
정보_보안_엔지니어	정보 보안 엔지니어
정보_시스템_분석가	정보 시스템 분석가
정보보증_담당자	정보보증 담당자
정신_건강_상담사	정신 건강 상담사
정신_건강_컨설턴트	정신 건강 컨설턴트
정신_분석가	정신 분석가
정신과_정신_건강_전문_간호사	정신과 정신 건강 전문 간호사
정책_분석가	정책 분석가
정책_전문가	정책 전문가
정책_책임자	정책 책임자
정책_코디네이터	정책 코디네이터
정책담당관	정책담당관
정치학_교수	정치학 교수
제도_기술자	제도 기술자
제목_1_선생님	제목 1 선생님
제목_심사관	제목 심사관
제어_시스템_디자이너	제어 시스템 디자이너
제어_시스템_엔지니어	제어 시스템 엔지니어
제어_시스템_전문가	제어 시스템 전문가
제작자	제작자
제조_설계_엔지니어	제조 설계 엔지니어
제품_개발_기술자	제품 개발 기술자
제품_개발_동료	제품 개발 동료
제품_개발_보조원	제품 개발 보조원
제품_개발자	제품 개발자
제품_기술자	제품 기술자
제품_디자이너	제품 디자이너
제품_디자인_및_개발_엔지니어	제품 디자인 및 개발 엔지니어
제품_디자인_컨설턴트	제품 디자인 컨설턴트
제품_마케팅_분석가	제품 마케팅 분석가
제품_엔지니어	제품 엔지니어
제품_엔지니어링_감독자	제품 엔지니어링 감독자
제품_전략가	제품 전략가
제품_지원_기술자	제품 지원 기술자
제품_챔피언	제품 챔피언
제품_컨트롤러	제품 컨트롤러
제품_포트폴리오_관리자	제품 포트폴리오 관리자
제휴_브로커	제휴 브로커
조각가	조각가
조경	조경
조경_건축_인턴	조경 건축 인턴
조경_디자이너	조경 디자이너
조교수	조교수
조명_카메라맨	조명 카메라맨
조사_전문가	조사 전문가
조사관	조사관
조사국장	조사국장
조사자	조사자
조언	조언
조정_강사	조정 강사
조직_개발_담당_부사장	조직 개발 담당 부사장
조직_개발_컨설턴트	조직 개발 컨설턴트
졸업생_채용_관리자	졸업생 채용 관리자
주_기병	주 기병
주_및_지방세_관리자	주 및 지방세 관리자
주_장관	주 장관
주간_캠프_상담사	주간 캠프 상담사
주거용_부동산_관리자	주거용 부동산 관리자
주거용_부동산_중개인	주거용 부동산 중개인
주문_선택기	주문 선택기
주방_감독관	주방 감독관
주방_매니저	주방 매니저
주방_보조	주방 보조
주방_직원	주방 직원
주방장	주방장
주식_동료	주식 동료
주식_딜러	주식 딜러
주식_리서치_애널리스트	주식 리서치 애널리스트
주식_리서치_이사	주식 리서치 이사
주식_분석가	주식 분석가
주식_연구_인턴	주식 연구 인턴
주식_연구_책임자	주식 연구 책임자
주식_연구원	주식 연구원
주식_옵션_거래자	주식 옵션 거래자
주식_전략가	주식 전략가
주식_전문가	주식 전문가
주식_파생상품_브로커	주식 파생상품 브로커
주식_파생상품_트레이더	주식 파생상품 트레이더
주식_파생상품_판매	주식 파생상품 판매
주식_판매_상인	주식 판매 상인
주식_포트폴리오_매니저	주식 포트폴리오 매니저
주요_거주자	주요 거주자
주요_계정_관리자	주요 계정 관리자
주요_선물_관리자	주요 선물 관리자
주요_수문지질학자	주요 수문지질학자
주요_은퇴	주요 은퇴
주요_은행가	주요 은행가
주요_정책_책임자	주요 정책 책임자
주요_지질학자	주요 지질학자
주요_채용_담당자	주요 채용 담당자
주요_통신원	주요 통신원
주요_회계사	주요 회계사
주인	주인
주주	주주
주치의	주치의
주택_대출_담당자	주택 대출 담당자
주택_대출_부문_부사장	주택 대출 부문 부사장
주택_융자_컨설턴트	주택 융자 컨설턴트
주택담보대출_발신자	주택담보대출 발신자
주택담보대출_전문가	주택담보대출 전문가
주택담보대출_컨설턴트	주택담보대출 컨설턴트
중간_건축가	중간 건축가
중간_시장_계정_관리자	중간 시장 계정 관리자
중간_장교	중간 장교
중간실장	중간실장
중개인_판매_직원	중개인 판매 직원
중급_회계사	중급 회계사
중등_과학_교사	중등 과학 교사
중등_영어_선생님	중등 영어 선생님
중등교사	중등교사
중사	중사
중앙감독	중앙감독
중재인	중재인
중학교_선생님	중학교 선생님
중학교_수학_선생님	중학교 수학 선생님
증여자	증여자
지구_자산_보호_관리자	지구 자산 보호 관리자
지구_트레이너	지구 트레이너
지구과학자	지구과학자
지금_서비스_개발자	지금 서비스 개발자
지급_계정_관리자	지급 계정 관리자
지방_판사	지방 판사
지방검사	지방검사
지분_파트너	지분 파트너
지분매각	지분매각
지상_운영_관리자	지상 운영 관리자
지역_간호사	지역 간호사
지역_건설_관리자	지역 건설 관리자
지역_교통_관리자	지역 교통 관리자
지역_기술_전문가	지역 기술 전문가
지역_물류_관리자	지역 물류 관리자
지역_변호사	지역 변호사
지역_부동산_관리자	지역 부동산 관리자
지역_생산_관리자	지역 생산 관리자
지역_손실_예방_이사	지역 손실 예방 이사
지역_수익_관리자	지역 수익 관리자
지역_수출_관리자	지역 수출 관리자
지역_시스템_엔지니어	지역 시스템 엔지니어
지역_엔지니어	지역 엔지니어
지역_영업_엔지니어	지역 영업 엔지니어
지역_조사관	지역 조사관
지역_지원_전문가	지역 지원 전문가
지역_채용_관리자	지역 채용 관리자
지역_총책임자	지역 총책임자
지역_컬렉션_관리자	지역 컬렉션 관리자
지역_코치	지역 코치
지역사회_관계_보조원	지역사회 관계 보조원
지원_기술자	지원 기술자
지원_센터_분석가	지원 센터 분석가
지적_재산_엔지니어	지적 재산 엔지니어
지적재산권_변호사	지적재산권 변호사
지적재산권_전문가	지적재산권 전문가
지점_운영_감독자	지점 운영 감독자
지점장	지점장
지정_브로커	지정 브로커
지지하다	지지하다
지질_기술자	지질 기술자
지질공학자	지질공학자
지질학자	지질학자
직무_관리자	직무 관리자
직업_보건_간호사	직업 보건 간호사
직원_간호사	직원 간호사
직원_개발자	직원 개발자
직원_기술_지원_엔지니어	직원 기술 지원 엔지니어
직원_기술_프로그램_관리자	직원 기술 프로그램 관리자
직원_기술자	직원 기술자
직원_디자인_엔지니어	직원 디자인 엔지니어
직원_마취과_의사	직원 마취과 의사
직원_변호사	직원 변호사
직원_사진사	직원 사진사
직원_상담	직원 상담
직원_세무사	직원 세무사
직원_애플리케이션_엔지니어	직원 애플리케이션 엔지니어
직원_연구_엔지니어	직원 연구 엔지니어
직원_연구원	직원 연구원
직원_의사	직원 의사
직원_전기_엔지니어	직원 전기 엔지니어
직원_정보_시스템_분석가	직원 정보 시스템 분석가
직원_지구_물리학자	직원 지구 물리학자
직원_지질학자	직원 지질학자
직원_하드웨어_엔지니어	직원 하드웨어 엔지니어
직원_회계사	직원 회계사
직함_장교	직함 장교
진단_엔지니어	진단 엔지니어
진료소_감독자	진료소 감독자
짐을_싣는_사람	짐을 싣는 사람
집_감독관	집 감독관
집_앞_매니저	집 앞 매니저
집중_치료_간호사	집중 치료 간호사
집중주의자	집중주의자
차관	차관
차장	차장
참사관	참사관
창고_관리자	창고 관리자
창고_및_물류_관리자	창고 및 물류 관리자
창고_및_유통_관리자	창고 및 유통 관리자
창고_운영_관리자	창고 운영 관리자
창고_운영자	창고 운영자
창고_전문가	창고 전문가
창고_직원	창고 직원
창고팀장	창고팀장
창립_파트너	창립 파트너
창의적인_개발자	창의적인 개발자
창의적인_그래픽_디자이너	창의적인 그래픽 디자이너
창의적인_리드	창의적인 리드
창의적인_예술가	창의적인 예술가
창의적인_인턴	창의적인 인턴
창의적인_작가	창의적인 작가
창의적인_카피라이터	창의적인 카피라이터
창의적인_프로젝트_매니저	창의적인 프로젝트 매니저
채권_분석가	채권 분석가
채권_전문가	채권 전문가
채권_포트폴리오_매니저	채권 포트폴리오 매니저
채용_감독관	채용 감독관
채용_계정_관리자	채용 계정 관리자
채용_관리자	채용 관리자
채용_담당_부사장	채용 담당 부사장
채용_담당자	채용 담당자
채용_및_교육_관리자	채용 및 교육 관리자
채용_및_선발_관리자	채용 및 선발 관리자
채용_보조원	채용 보조원
채용_분석가	채용 분석가
채용_운영_관리자	채용 운영 관리자
채용_준회원	채용 준회원
채용_책임자	채용 책임자
채용_프로젝트_매니저	채용 프로젝트 매니저
채집가	채집가
처리_지구_물리학_자	처리 지구 물리학 자
철학_교수	철학 교수
철학과_조교수	철학과 조교수
첫_번째_라인_지원	첫 번째 라인 지원
첫_번째_보조_카메라	첫 번째 보조 카메라
첫_번째_보조_편집자	첫 번째 보조 편집자
첫_번째_엔지니어	첫 번째 엔지니어
첫_번째_조감독	첫 번째 조감독
청구_대리인	청구 대리인
청문관	청문관
청중_개발_이사	청중 개발 이사
청지기	청지기
초대_교사	초대 교사
초등교사	초등교사
초등학교_교사	초등학교 교사
초등학교_교장	초등학교 교장
초등학교_상담사	초등학교 상담사
초등학교_선생님	초등학교 선생님
초음파_기술자	초음파 기술자
총계정원장_감독자	총계정원장 감독자
총괄_아트_디렉터	총괄 아트 디렉터
총기_강사	총기 강사
총지배인	총지배인
총지배인의_개인_비서	총지배인의 개인 비서
촬영_감독	촬영 감독
촬영감독	촬영감독
최고_경영자	최고 경영자
최고_대출_책임자	최고 대출 책임자
최고_마케팅_및_커뮤니케이션_책임자	최고 마케팅 및 커뮤니케이션 책임자
최고_사업_개발_책임자	최고 사업 개발 책임자
최고_신용_책임자	최고 신용 책임자
최고_운영_책임자	최고 운영 책임자
최고_위험_책임자	최고 위험 책임자
최고_의료_책임자	최고 의료 책임자
최고_인수_책임자	최고 인수 책임자
최고_투자_책임자	최고 투자 책임자
최종_사용자_지원_전문가	최종 사용자 지원 전문가
추진_엔지니어	추진 엔지니어
추천_대리인	추천 대리인
축구_선수	축구 선수
축구_코치	축구 코치
출납원	출납원
출석_사무원	출석 사무원
출판_관리자	출판 관리자
출판_보조원	출판 보조원
출판_이사	출판 이사
출판_컨설턴트	출판 컨설턴트
출판_코디네이터	출판 코디네이터
출판_편집자	출판 편집자
출판물_관리자	출판물 관리자
출판물_디자이너	출판물 디자이너
출판부장	출판부장
취업_전문가	취업 전문가
치과_간호사	치과 간호사
치료사	치료사
치어리딩_강사	치어리딩 강사
치열교정의	치열교정의
카메라_어시스턴트	카메라 어시스턴트
카메라_오퍼레이터	카메라 오퍼레이터
카메라맨	카메라맨
카운터_직원	카운터 직원
카페_매니저	카페 매니저
카피디렉터	카피디렉터
카피라이터	카피라이터
칵테일_서버	칵테일 서버
칵테일_웨이트리스	칵테일 웨이트리스
칼럼니스트	칼럼니스트
캐릭터_디자이너	캐릭터 디자이너
캐릭터_리거	캐릭터 리거
캐릭터_모델러	캐릭터 모델러
캐릭터_아티스트	캐릭터 아티스트
캐릭터_애니메이터	캐릭터 애니메이터
캐릭터_테크니컬_디렉터	캐릭터 테크니컬 디렉터
캐스팅_디렉터	캐스팅 디렉터
캐스팅_어소시에이트	캐스팅 어소시에이트
캐스팅_프로듀서	캐스팅 프로듀서
커뮤니케이션_관리자	커뮤니케이션 관리자
커뮤니케이션_담당_부국장	커뮤니케이션 담당 부국장
커뮤니케이션_디자이너	커뮤니케이션 디자이너
커뮤니케이션_리드	커뮤니케이션 리드
커뮤니케이션_전문가	커뮤니케이션 전문가
커뮤니케이션_컨설턴트	커뮤니케이션 컨설턴트
커뮤니케이션_코디네이터	커뮤니케이션 코디네이터
커뮤니티_영업_관리자	커뮤니티 영업 관리자
커미셔닝_편집자	커미셔닝 편집자
컨벤션_코디네이터	컨벤션 코디네이터
컨설턴트	컨설턴트
컨설턴트_모집	컨설턴트 모집
컨설팅_매니저	컨설팅 매니저
컨설팅_심리학자	컨설팅 심리학자
컨설팅_엔지니어	컨설팅 엔지니어
컨설팅_지질학자	컨설팅 지질학자
컨설팅_편집자	컨설팅 편집자
컨셉_개발자	컨셉 개발자
컨셉_디자이너	컨셉 디자이너
컨셉_아티스트	컨셉 아티스트
컨퍼런스_및_이벤트_코디네이터	컨퍼런스 및 이벤트 코디네이터
컨퍼런스_센터_매니저	컨퍼런스 센터 매니저
컬러_전문가	컬러 전문가
컬렉션_동료	컬렉션 동료
컬렉션_디렉터	컬렉션 디렉터
컬렉션_사무원	컬렉션 사무원
컬렉션_인턴	컬렉션 인턴
컴퓨터_과학_교사	컴퓨터 과학 교사
컴퓨터_과학_학생	컴퓨터 과학 학생
컴퓨터_그래픽_아티스트	컴퓨터 그래픽 아티스트
컴퓨터_기술자	컴퓨터 기술자
컴퓨터_네트워크_기술자	컴퓨터 네트워크 기술자
컴퓨터_네트워크_엔지니어	컴퓨터 네트워크 엔지니어
컴퓨터_네트워크_전문가	컴퓨터 네트워크 전문가
컴퓨터_서비스_기술자	컴퓨터 서비스 기술자
컴퓨터_시스템_기술자	컴퓨터 시스템 기술자
컴퓨터_실험실_기술자	컴퓨터 실험실 기술자
컴퓨터_애니메이터	컴퓨터 애니메이터
컴퓨터_지원_기술자	컴퓨터 지원 기술자
컴퓨터_지원_분석가	컴퓨터 지원 분석가
컴퓨터_판매_직원	컴퓨터 판매 직원
컴퓨터_하드웨어_기술자	컴퓨터 하드웨어 기술자
컴퓨터_하드웨어_엔지니어	컴퓨터 하드웨어 엔지니어
케이터링	케이터링
케이터링_감독자	케이터링 감독자
케이터링_요리사	케이터링 요리사
케이터링_이벤트_매니저	케이터링 이벤트 매니저
케이터링_코디네이터	케이터링 코디네이터
케이터링_판매_이사	케이터링 판매 이사
코스_요리사	코스 요리사
코어_네트워크_엔지니어	코어 네트워크 엔지니어
콘텐츠_감독자	콘텐츠 감독자
콘텐츠_개발자	콘텐츠 개발자
콘텐츠_관리자	콘텐츠 관리자
콘텐츠_마케팅_매니저	콘텐츠 마케팅 매니저
콘텐츠_분석가	콘텐츠 분석가
콘텐츠_작가	콘텐츠 작가
콘텐츠_전략가	콘텐츠 전략가
콘텐츠_제작자	콘텐츠 제작자
콘텐츠_책임자	콘텐츠 책임자
크로스핏_강사	크로스핏 강사
크리에이티브_디렉터	크리에이티브 디렉터
크리에이티브_디자인_매니저	크리에이티브 디자인 매니저
크리에이티브_매니저	크리에이티브 매니저
크리에이티브_서비스_감독자	크리에이티브 서비스 감독자
크리에이티브_서비스_관리자	크리에이티브 서비스 관리자
크리에이티브_서비스_부사장	크리에이티브 서비스 부사장
크리에이티브_서비스_인턴	크리에이티브 서비스 인턴
크리에이티브_서비스_프로듀서	크리에이티브 서비스 프로듀서
크리에이티브_프로듀서	크리에이티브 프로듀서
클라이언트_지원_기술자	클라이언트 지원 기술자
클라이언트_지원_분석가	클라이언트 지원 분석가
클라이언트_측_개발자	클라이언트 측 개발자
클러스터_리드	클러스터 리드
키보드_연주자	키보드 연주자
키홀더	키홀더
탐사_부사장	탐사 부사장
태닝_컨설턴트	태닝 컨설턴트
탤런트_프로듀서	탤런트 프로듀서
터미널_관리자	터미널 관리자
테니스_코치	테니스 코치
테스트_설계_엔지니어	테스트 설계 엔지니어
테스트_엔지니어	테스트 엔지니어
테스트_자동화_전문가	테스트 자동화 전문가
테스트_자동화_컨설턴트	테스트 자동화 컨설턴트
테스트_중인_소프트웨어_개발_엔지니어	테스트 중인 소프트웨어 개발 엔지니어
테이프_운영자	테이프 운영자
테크니컬_아트_디렉터	테크니컬 아트 디렉터
테크니컬_아티스트	테크니컬 아티스트
테크니컬_애니메이터	테크니컬 애니메이터
텍스처_아티스트	텍스처 아티스트
텔레비전_감독	텔레비전 감독
텔레비전_기자	텔레비전 기자
텔레비전_뉴스_기자	텔레비전 뉴스 기자
텔레비전_뉴스_프로듀서	텔레비전 뉴스 프로듀서
텔레비전_발표자	텔레비전 발표자
텔레비전_프로듀서	텔레비전 프로듀서
토목_기안가	토목 기안가
토목_디자이너	토목 디자이너
토목_설계_엔지니어	토목 설계 엔지니어
토목공학_기술자	토목공학 기술자
토목공학_인턴	토목공학 인턴
토크쇼_호스트	토크쇼 호스트
통신_감독관	통신 감독관
통신_기술자	통신 기술자
통신_담당관	통신 담당관
통신_보조원	통신 보조원
통신_시스템_엔지니어	통신 시스템 엔지니어
통신_엔지니어	통신 엔지니어
통신_전문가	통신 전문가
통신_책임자	통신 책임자
통신_컨설턴트	통신 컨설턴트
통신_코디네이터	통신 코디네이터
통신_프로젝트_엔지니어	통신 프로젝트 엔지니어
통신팀장	통신팀장
통합_마케팅_관리자	통합 마케팅 관리자
통화_거래자	통화 거래자
투어_디렉터	투어 디렉터
투어_코디네이터	투어 코디네이터
투자_분석가	투자 분석가
투자_성과_분석가	투자 성과 분석가
투자_연구_분석가	투자 연구 분석가
투자_운영_관리자	투자 운영 관리자
투자_은행_분석가	투자 은행 분석가
투자_은행_여름_분석가	투자 은행 여름 분석가
투자_은행_인턴	투자 은행 인턴
투자_은행_직원	투자 은행 직원
투자_전략가	투자 전략가
투자_전문가	투자 전문가
투자_책임자	투자 책임자
투자자_관계_관계자	투자자 관계 관계자
특별_변호사	특별 변호사
특별_서비스_이사	특별 서비스 이사
특별_수사관	특별 수사관
특별_이벤트_기획자	특별 이벤트 기획자
특별_이벤트_디렉터	특별 이벤트 디렉터
특별_청구_대표	특별 청구 대표
특수_교육_감독관	특수 교육 감독관
특수_교육자	특수 교육자
특수_요원	특수 요원
특수교육_교사	특수교육 교사
특수교육_보조원	특수교육 보조원
특수교육_조교	특수교육 조교
티켓_판매원	티켓 판매원
팀_리더	팀 리더
팀_리드_프론트_오피스	팀 리드 프론트 오피스
파견_감독자	파견 감독자
파견_관리자	파견 관리자
파견자	파견자
파산_전문가	파산 전문가
파생상품_거래자	파생상품 거래자
파생상품_브로커	파생상품 브로커
파생상품_전문가	파생상품 전문가
파워트레인_엔지니어	파워트레인 엔지니어
파트너	파트너
파트너십_코디네이터	파트너십 코디네이터
파트타임_판매_직원	파트타임 판매 직원
판매_모집자	판매 모집자
판매_및_무역_책임자	판매 및 무역 책임자
판매_사원	판매 사원
판매업자	판매업자
판사	판사
패션_디자이너	패션 디자이너
패션_디자인_인턴	패션 디자인 인턴
패션_사진작가	패션 사진작가
패션_스타일리스트	패션 스타일리스트
패션_어시스턴트	패션 어시스턴트
패션_컨설턴트	패션 컨설턴트
패션_코디네이터	패션 코디네이터
패키지_엔지니어	패키지 엔지니어
패턴_제작자	패턴 제작자
퍼포먼스_코치	퍼포먼스 코치
펀드_매니저	펀드 매니저
펀드_분석가	펀드 분석가
펌웨어_설계_엔지니어	펌웨어 설계 엔지니어
페인트_아티스트	페인트 아티스트
편집_감독	편집 감독
편집_보조원	편집 보조원
편집_작가	편집 작가
편집_컨설턴트	편집 컨설턴트
편집_코디네이터	편집 코디네이터
편집_프로덕션_매니저	편집 프로덕션 매니저
편집_프로젝트_매니저	편집 프로젝트 매니저
편집부장	편집부장
편집자	편집자
편집장	편집장
평가_관계자	평가 관계자
평가_분석가	평가 분석가
평화_장교	평화 장교
포스트_프로덕션_디렉터	포스트 프로덕션 디렉터
포스트_프로덕션_매니저	포스트 프로덕션 매니저
포스트_프로덕션_어시스턴트	포스트 프로덕션 어시스턴트
포스트_프로덕션_인턴	포스트 프로덕션 인턴
포스트_프로덕션_책임자	포스트 프로덕션 책임자
포스트_프로덕션_코디네이터	포스트 프로덕션 코디네이터
포스트_프로덕션_편집자	포스트 프로덕션 편집자
포스트_프로듀서	포스트 프로듀서
포장_엔지니어	포장 엔지니어
포트폴리오_관리_분석가	포트폴리오 관리 분석가
포트폴리오_관리자	포트폴리오 관리자
포트폴리오_동료	포트폴리오 동료
포트폴리오_디렉터	포트폴리오 디렉터
푸드_서버	푸드 서버
풀스택_엔지니어	풀스택 엔지니어
품질_관리_운영자	품질 관리 운영자
품질_보증_기술자	품질 보증 기술자
품질_보증_자동화_엔지니어	품질 보증 자동화 엔지니어
풍미주의자	풍미주의자
프라이빗_뱅킹_관계_관리자	프라이빗 뱅킹 관계 관리자
프라이빗_뱅킹_담당자	프라이빗 뱅킹 담당자
프라이빗_뱅킹_매니저	프라이빗 뱅킹 매니저
프라이빗_뱅킹_분석가	프라이빗 뱅킹 분석가
프라이빗_뱅킹_책임자	프라이빗 뱅킹 책임자
프로_운동선수	프로 운동선수
프로_축구_선수	프로 축구 선수
프로그래밍_분석가	프로그래밍 분석가
프로그램_프로듀서	프로그램 프로듀서
프로덕션_아티스트	프로덕션 아티스트
프로모션_프로듀서	프로모션 프로듀서
프로세스_관리자	프로세스 관리자
프로세스_설계_엔지니어	프로세스 설계 엔지니어
프로세스_엔지니어	프로세스 엔지니어
프로세스_엔지니어링_전문가	프로세스 엔지니어링 전문가
프로세스_자동화_엔지니어	프로세스 자동화 엔지니어
프로세스_전문가	프로세스 전문가
프로세스_컨설턴트	프로세스 컨설턴트
프로젝트_감독	프로젝트 감독
프로젝트_감독관	프로젝트 감독관
프로젝트_견적자	프로젝트 견적자
프로젝트_기록관	프로젝트 기록관
프로젝트_디자이너	프로젝트 디자이너
프로젝트_수문지질학자	프로젝트 수문지질학자
프로젝트_엔지니어	프로젝트 엔지니어
프로젝트_조수	프로젝트 조수
프로젝트_조정_관리자	프로젝트 조정 관리자
프로젝트_지질학자	프로젝트 지질학자
프로젝트_책임자	프로젝트 책임자
프로젝트_파이낸싱_책임자	프로젝트 파이낸싱 책임자
프로젝트_편집자	프로젝트 편집자
프론트_데스크_대표	프론트 데스크 대표
프론트_데스크_매니저	프론트 데스크 매니저
프론트_데스크_보조_매니저	프론트 데스크 보조 매니저
프론트_오피스_감독자	프론트 오피스 감독자
프론트_오피스_동료	프론트 오피스 동료
프론트_오피스_매니저	프론트 오피스 매니저
프론트_오피스_에이전트	프론트 오피스 에이전트
프론트_오피스_인턴	프론트 오피스 인턴
프론트_오피스_임원	프론트 오피스 임원
프론트_카운터_직원	프론트 카운터 직원
프론트엔드_감독자	프론트엔드 감독자
프리랜서	프리랜서
플래시_애니메이터	플래시 애니메이터
플랜트_공정_엔지니어	플랜트 공정 엔지니어
플레이어	플레이어
플로어_디렉터	플로어 디렉터
플로어_브로커	플로어 브로커
플로어_직원	플로어 직원
피아노_기술자	피아노 기술자
피칭_강사	피칭 강사
피트니스_디렉터	피트니스 디렉터
피트니스_매니저	피트니스 매니저
피트니스_전문가	피트니스 전문가
피트니스_컨설턴트	피트니스 컨설턴트
피트니스_코디네이터	피트니스 코디네이터
피트니스_코치	피트니스 코치
피팅룸_동료	피팅룸 동료
하드웨어_개발_엔지니어	하드웨어 개발 엔지니어
하드웨어_개발_이사	하드웨어 개발 이사
하드웨어_개발자	하드웨어 개발자
하드웨어_기술자	하드웨어 기술자
하드웨어_디자이너	하드웨어 디자이너
하드웨어_설계_엔지니어	하드웨어 설계 엔지니어
하드웨어_시스템_엔지니어	하드웨어 시스템 엔지니어
하드웨어_엔지니어	하드웨어 엔지니어
하드웨어_전문가	하드웨어 전문가
하드웨어_지원_엔지니어	하드웨어 지원 엔지니어
하드웨어팀장	하드웨어팀장
하룻밤_스토커	하룻밤 스토커
하주	하주
학교_간호사	학교 간호사
학교_기반_치료사	학교 기반 치료사
학교_도서관_미디어_전문가	학교 도서관 미디어 전문가
학부_입학처_조교수	학부 입학처 조교수
학생_교사	학생 교사
학생_기자	학생 기자
학생_배치_코디네이터	학생 배치 코디네이터
학생_자원봉사	학생 자원봉사
학술_전문가	학술 전문가
학습_지원_교사	학습 지원 교사
학업_프로그램_코디네이터	학업 프로그램 코디네이터
학장	학장
항공_엔지니어	항공 엔지니어
항공사_선장	항공사 선장
항공전자기술자	항공전자기술자
항만_엔지니어	항만 엔지니어
해산물_점원	해산물 점원
해상_장교	해상 장교
해양_감독관	해양 감독관
해양_운영_관리자	해양 운영 관리자
해양_장교	해양 장교
해양_컨설턴트	해양 컨설턴트
핵심_네트워크_관리자	핵심 네트워크 관리자
핵심_엔지니어	핵심 엔지니어
핵의학_기술자	핵의학 기술자
행동_건강_기술자	행동 건강 기술자
행사_기획_보조	행사 기획 보조
행정_분석가	행정 분석가
행정법_판사	행정법 판사
허가_기술자	허가 기술자
허가받은_결혼_및_가족_치료사	허가받은 결혼 및 가족 치료사
허가받은_모기지_브로커	허가받은 모기지 브로커
허가받은_판매_대리점	허가받은 판매 대리점
헤드_바텐더	헤드 바텐더
헤드_서버	헤드 서버
헤어_디자이너	헤어 디자이너
헤어_및_메이크업_아티스트	헤어 및 메이크업 아티스트
헤지펀드_애널리스트	헤지펀드 애널리스트
헬스_트레이너	헬스 트레이너
헬프_데스크_감독자	헬프 데스크 감독자
헬프_데스크_관리자	헬프 데스크 관리자
헬프_데스크_기술자	헬프 데스크 기술자
헬프_데스크_엔지니어	헬프 데스크 엔지니어
헬프_데스크_코디네이터	헬프 데스크 코디네이터
헬프데스크_분석가	헬프데스크 분석가
헬프데스크_지원_기술자	헬프데스크 지원 기술자
헬프데스크_지원_분석가	헬프데스크 지원 분석가
혁신_엔지니어	혁신 엔지니어
현금담당자	현금담당자
현장_감독	현장 감독
현장_감독관	현장 감독관
현장_기술자	현장 기술자
현장_서비스_코디네이터	현장 서비스 코디네이터
현장_엔지니어링_관리자	현장 엔지니어링 관리자
현장_운영_기술자	현장 운영 기술자
현장_운영_엔지니어	현장 운영 엔지니어
현장_인수자	현장 인수자
현장_조사관	현장 조사관
현장_지원_기술자	현장 지원 기술자
현장_지원_분석가	현장 지원 분석가
현장_지질학자	현장 지질학자
현장_토목_기술자	현장 토목 기술자
현지_영업_관리자	현지 영업 관리자
현지_영업_보조	현지 영업 보조
현지화_전문가	현지화 전문가
현지화_프로그램_매니저	현지화 프로그램 매니저
혈관_기술자	혈관 기술자
형사_변호인	형사 변호인
혜택_관리자	혜택 관리자
혼합_신호_설계_엔지니어	혼합 신호 설계 엔지니어
혼합학자	혼합학자
홈_스테이저	홈 스테이저
홈시어터_전문가	홈시어터 전문가
홍보_감독관	홍보 감독관
홍보_계정_임원	홍보 계정 임원
홍보_관리자	홍보 관리자
홍보_담당관	홍보 담당관
홍보_담당자	홍보 담당자
홍보_및_커뮤니케이션_컨설턴트	홍보 및 커뮤니케이션 컨설턴트
홍보_및_커뮤니케이션_코디네이터	홍보 및 커뮤니케이션 코디네이터
홍보_이사	홍보 이사
홍보_전문가	홍보 전문가
홍보_준회원	홍보 준회원
홍보_책임자	홍보 책임자
홍보_컨설턴트	홍보 컨설턴트
홍보_코디네이터	홍보 코디네이터
홍보대표	홍보대표
홍보부장	홍보부장
화가	화가
화물_브로커	화물 브로커
화학_공학_기술자	화학 공학 기술자
환경_과학자	환경 과학자
환경_그래픽_디자이너	환경 그래픽 디자이너
환경_기술자	환경 기술자
환경_보호_전문가	환경 보호 전문가
환경_엔지니어	환경 엔지니어
환경_지질학자	환경 지질학자
환경_프로그램_매니저	환경 프로그램 매니저
환경_프로젝트_관리자	환경 프로젝트 관리자
환대_관리자	환대 관리자
환대_코디네이터	환대 코디네이터
황동_강사	황동 강사
회계_강사	회계 강사
회계_담당_부사장	회계 담당 부사장
회계_담당자	회계 담당자
회계_이사	회계 이사
회계_직원	회계 직원
회계사	회계사
회로_설계_엔지니어	회로 설계 엔지니어
회로_설계자	회로 설계자
회사_변호사	회사 변호사
회사_운전사	회사 운전사
회원_서비스_준회원	회원 서비스 준회원
회원_컨설턴트	회원 컨설턴트
회의_관리자	회의 관리자
회의_기획자	회의 기획자
회의_보조원	회의 보조원
회의_서비스_관리자	회의 서비스 관리자
회의_서비스_코디네이터	회의 서비스 코디네이터
후반작업_감독	후반작업 감독
훈련_대장	훈련 대장
훈련_및_배치_담당관	훈련 및 배치 담당관
훌륭한_예술가	훌륭한 예술가
휴가_플래너	휴가 플래너
