3D_애니메이터	3D 애니메이터
iOS_개발자	iOS 개발자
가수	가수
간호사	간호사
개_조련사	개 조련사
개인_피트니스_트레이너	개인 피트니스 트레이너
갤러리_디렉터	갤러리 디렉터
경찰_탐정	경찰 탐정
그래픽_디자이너	그래픽 디자이너
기계_엔지니어	기계 엔지니어
기록관	기록관
기술_지원_담당자	기술 지원 담당자
기술_채용_담당자	기술 채용 담당자
네트워크_보안_분석가	네트워크 보안 분석가
네트워크_엔지니어	네트워크 엔지니어
농업_경제학자	농업 경제학자
뉴스_앵커	뉴스 앵커
대출_담당자	대출 담당자
데스크탑_지원_기술자	데스크탑 지원 기술자
도시_디자이너	도시 디자이너
동영상_편집기	동영상 편집기
드릴링_엔지니어	드릴링 엔지니어
마취과_의사	마취과 의사
메이크업_아티스트	메이크업 아티스트
모금행사	모금행사
목수	목수
무선_엔지니어	무선 엔지니어
무역_마케팅_분석가	무역 마케팅 분석가
물류_전문가	물류 전문가
미디어_구매자	미디어 구매자
미용사	미용사
바텐더	바텐더
발행자	발행자
방사선_기술자	방사선 기술자
방송_엔지니어	방송 엔지니어
배관공	배관공
변호사	변호사
보험_중개인	보험 중개인
부동산_중개인	부동산 중개인
비즈니스_전략_컨설턴트	비즈니스 전략 컨설턴트
빵_굽는_사람	빵 굽는 사람
사립_탐정	사립 탐정
사모펀드_분석가	사모펀드 분석가
사진작가	사진작가
생물_의학_엔지니어	생물 의학 엔지니어
선원	선원
섬유_디자이너	섬유 디자이너
세무사	세무사
소방관	소방관
수문지질학자	수문지질학자
수의사	수의사
수입_수출_전문가	수입 수출 전문가
스포츠_코치	스포츠 코치
식품_기술자	식품 기술자
실내_장식가	실내 장식가
심리치료사	심리치료사
아날로그_디자인_엔지니어	아날로그 디자인 엔지니어
애견_미용사	애견 미용사
야금가	야금가
여자_이름	여자 이름
여행사	여행사
역사_교수	역사 교수
역자	역자
영화_감독	영화 감독
요리하다	요리하다
웨딩_플래너	웨딩 플래너
웹_개발자	웹 개발자
유치원_교사	유치원 교사
은행가	은행가
인재_확보	인재 확보
자동차_엔지니어	자동차 엔지니어
자동화_엔지니어	자동화 엔지니어
자바_개발자	자바 개발자
작곡가	작곡가
전기_엔지니어	전기 엔지니어
정책_고문	정책 고문
제약사	제약사
주식_거래자	주식 거래자
중재인	중재인
지게차_운전자	지게차 운전자
초등학교_선생님	초등학교 선생님
출납원	출납원
춤추는_사람	춤추는 사람
치과_의사	치과 의사
침술사	침술사
카메라맨	카메라맨
카피라이터	카피라이터
컴퓨터_수리_기술자	컴퓨터 수리 기술자
케이터링	케이터링
탐사_지질학자	탐사 지질학자
토목_기술자	토목 기술자
통신_엔지니어	통신 엔지니어
투자_은행_분석가	투자 은행 분석가
트럭_운전사	트럭 운전사
패션_디자이너	패션 디자이너
편지_운반원	편지 운반원
포트폴리오_분석가	포트폴리오 분석가
프론트_데스크_감독자	프론트 데스크 감독자
항공_우주_엔지니어	항공 우주 엔지니어
항공기_조종사	항공기 조종사
홍보담당_임원	홍보담당 임원
화학_연산자	화학 연산자
환경_예술가	환경 예술가
후견인	후견인
